ENTIDAD,MUNICIPIO,POBTOT,POB_AFRO,POB_AFRO_F,POB_AFRO_M
1,1,2564,18,14,4
1,1,889,4,3,1
1,1,2003,48,26,22
1,1,1636,70,36,34
1,1,808,31,13,18
1,1,793,8,3,5
1,1,810,11,5,6
1,1,1244,9,4,5
1,1,1285,24,16,8
1,1,1117,7,1,6
1,1,1210,3,0,3
1,1,796,7,3,4
1,1,841,5,1,4
1,1,994,11,4,7
1,1,1068,8,2,6
1,1,855,1,0,1
1,1,1026,71,38,33
1,1,1068,19,7,12
1,1,1144,0,0,0
1,1,1204,19,14,5
1,1,1468,12,10,2
1,1,785,9,4,5
1,1,962,31,13,18
1,1,708,17,11,6
1,1,917,48,25,23
1,1,1149,8,5,3
1,1,565,12,4,8
1,1,392,1,1,0
1,1,979,8,4,4
1,1,769,0,0,0
1,1,950,23,11,12
1,1,1341,6,1,5
1,1,931,7,3,4
1,1,824,8,6,2
1,1,2758,100,55,45
1,1,903,0,0,0
1,1,1110,1,0,1
1,1,1441,8,2,6
1,1,812,0,0,0
1,1,1252,10,5,5
1,1,7153,162,75,87
1,1,1543,15,5,10
1,1,2179,36,16,20
1,1,4721,34,15,19
1,1,1564,6,3,3
1,1,1855,90,46,44
1,1,4135,58,33,25
1,1,2450,56,30,26
1,1,1558,6,4,2
1,1,1913,32,17,15
1,1,1144,19,11,8
1,1,1207,4,1,3
1,1,1519,24,13,11
1,1,1212,18,10,8
1,1,1077,7,3,4
1,1,1037,2,0,2
1,1,883,14,5,9
1,1,653,7,3,4
1,1,788,1,1,0
1,1,1075,6,3,3
1,1,815,24,17,7
1,1,816,9,5,4
1,1,613,16,10,6
1,1,958,2,2,0
1,1,615,0,0,0
1,1,841,1,0,1
1,1,560,6,3,3
1,1,713,1,0,1
1,1,960,8,5,3
1,1,699,3,3,0
1,1,987,20,11,9
1,1,494,1,0,1
1,1,893,9,6,3
1,1,461,5,4,1
1,1,620,3,2,1
1,1,481,0,0,0
1,1,558,15,8,7
1,1,826,12,5,7
1,1,746,1,1,0
1,1,10847,234,120,114
1,1,15424,472,229,243
1,1,31611,385,185,200
1,1,2575,7,3,4
1,1,6354,144,69,75
1,1,18344,327,161,166
1,1,2646,41,22,19
1,1,1534,5,3,2
1,1,1533,13,6,7
1,1,4425,63,26,37
1,1,1123,39,19,20
1,1,896,9,2,7
1,1,1404,12,3,9
1,1,716,0,0,0
1,1,1049,2,1,1
1,1,3394,14,8,6
1,1,1137,65,32,33
1,1,2422,12,2,10
1,1,1233,2,1,1
1,1,2320,51,24,27
1,1,1131,2,0,2
1,1,951,3,0,3
1,1,548,4,3,1
1,1,680,2,2,0
1,1,1236,3,2,1
1,1,1251,8,3,5
1,1,997,14,6,8
1,1,1230,8,1,7
1,1,467,2,0,2
1,1,1107,3,2,1
1,1,1379,13,7,6
1,1,1186,1,1,0
1,1,969,4,1,3
1,1,1278,7,4,3
1,1,11402,322,174,148
1,1,1754,4,2,2
1,1,8045,54,25,29
1,1,5577,29,12,17
1,1,780,4,2,2
1,1,607,4,1,3
1,1,1182,11,6,5
1,1,698,1,1,0
1,1,496,5,2,3
1,1,1189,12,6,6
1,1,2508,15,4,11
1,1,1422,1,1,0
1,1,957,3,1,2
1,1,1064,2,1,1
1,1,1480,3,2,1
1,1,1041,2,0,2
1,1,1016,1,0,1
1,1,1202,94,46,48
1,1,840,82,46,36
1,1,1363,12,6,6
1,1,2061,63,29,34
1,1,789,51,24,27
1,1,1675,23,7,16
1,1,969,9,3,6
1,1,972,25,11,14
1,1,1081,124,71,53
1,1,833,44,22,22
1,1,822,5,2,3
1,1,986,166,85,81
1,1,824,5,2,3
1,1,1171,6,5,1
1,1,1078,15,8,7
1,1,1599,26,15,11
1,1,4803,27,9,18
1,1,992,26,12,14
1,1,1114,86,42,44
1,1,3595,24,10,14
1,1,1131,7,4,3
1,1,1982,11,6,5
1,1,14773,149,71,78
1,1,17027,125,61,64
1,1,1032,3,1,2
1,1,598,5,1,4
1,1,662,2,0,2
1,1,1327,16,7,9
1,1,7543,99,48,51
1,1,1015,3,3,0
1,1,815,3,1,2
1,1,7924,47,26,21
1,1,1720,37,19,18
1,1,774,18,11,7
1,1,3213,661,351,310
1,1,2142,12,4,8
1,1,4005,24,7,17
1,1,680,20,12,8
1,1,823,11,8,3
1,1,476,4,2,2
1,1,1038,16,9,7
1,1,880,7,4,3
1,1,367,5,3,2
1,1,751,3,0,3
1,1,666,11,3,8
1,1,792,4,3,1
1,1,498,12,5,7
1,1,757,26,15,11
1,1,637,14,5,9
1,1,469,25,16,9
1,1,958,13,7,6
1,1,346,95,50,45
1,1,460,66,36,30
1,1,696,31,17,14
1,1,1100,142,71,71
1,1,1221,203,116,87
1,1,1781,10,6,4
1,1,736,3,1,2
1,1,1095,7,4,3
1,1,1056,26,10,16
1,1,1917,24,13,11
1,1,977,18,8,10
1,1,701,9,5,4
1,1,669,1,0,1
1,1,641,4,1,3
1,1,560,0,0,0
1,1,1033,24,12,12
1,1,852,11,8,3
1,1,1013,10,5,5
1,1,715,5,2,3
1,1,1279,7,4,3
1,1,1087,5,3,2
1,1,799,2,1,1
1,1,1235,22,10,12
1,1,1284,8,5,3
1,1,1059,6,3,3
1,1,1052,14,6,8
1,1,689,2,2,0
1,1,749,18,11,7
1,1,842,16,8,8
1,1,912,35,19,16
1,1,884,3,2,1
1,1,874,0,0,0
1,1,908,3,1,2
1,1,1678,10,5,5
1,1,729,6,2,4
1,1,1332,23,11,12
1,1,941,27,13,14
1,1,1680,40,18,22
1,1,802,5,2,3
1,1,1220,12,5,7
1,1,1017,12,6,6
1,1,970,3,2,1
1,1,878,18,12,6
1,1,826,0,0,0
1,1,801,6,3,3
1,1,1445,10,6,4
1,1,1554,6,3,3
1,1,1142,1,0,1
1,1,1086,0,0,0
1,1,934,1,1,0
1,1,742,12,7,5
1,1,1525,7,4,3
1,1,931,1,0,1
1,1,870,27,14,13
1,1,994,0,0,0
1,1,751,0,0,0
1,1,832,10,7,3
1,1,868,15,9,6
1,1,1506,26,14,12
1,1,1552,12,5,7
1,1,1111,4,1,3
1,1,1135,1,0,1
1,1,1172,2,2,0
1,1,950,7,5,2
1,1,1622,0,0,0
1,1,997,12,6,6
1,1,1225,11,6,5
1,1,1332,1,0,1
1,1,1050,3,1,2
1,1,972,3,0,3
1,1,1016,10,7,3
1,1,1364,15,9,6
1,1,5364,23,9,14
1,1,1644,47,22,25
1,1,529,5,2,3
1,1,2278,129,57,72
1,1,1241,18,11,7
1,1,754,1,0,1
1,1,961,5,3,2
1,1,1090,2,0,2
1,1,1045,15,6,9
1,1,816,2,0,2
1,1,1595,6,2,4
1,1,809,8,5,3
1,1,890,6,4,2
1,1,11762,70,26,44
1,1,974,3,3,0
1,1,852,0,0,0
1,1,755,23,12,11
1,1,734,3,2,1
1,1,802,0,0,0
1,1,1017,15,9,6
1,1,758,29,18,11
1,1,716,26,14,12
1,1,589,9,4,5
1,1,640,1,1,0
1,1,706,7,5,2
1,1,1323,8,3,5
1,1,678,26,20,6
1,1,1140,17,11,6
1,1,641,5,2,3
1,1,610,1,1,0
1,1,543,0,0,0
1,1,790,9,4,5
1,1,754,4,1,3
1,1,667,5,3,2
1,1,1255,1,1,0
1,1,1196,24,15,9
1,1,1230,3,2,1
1,1,1025,5,0,5
1,1,1158,10,6,4
1,1,1015,0,0,0
1,1,940,2,0,2
1,1,1303,33,19,14
1,1,1309,5,1,4
1,1,1192,2,1,1
1,1,7636,137,75,62
1,1,2865,29,15,14
1,1,3138,115,57,58
1,1,1365,4,2,2
1,1,1409,10,5,5
1,1,1194,12,5,7
1,1,1302,4,3,1
1,1,1021,12,7,5
1,1,1122,2,0,2
1,1,1224,429,222,207
1,1,1169,20,10,10
1,1,1245,9,4,5
1,1,1516,1,0,1
1,1,1314,651,326,325
1,1,5475,4,0,4
1,1,4614,9,2,7
1,1,4058,3,1,2
1,1,8662,76,35,41
1,1,2824,4,3,1
1,1,17162,270,135,135
1,1,11295,194,89,105
1,1,2161,4,1,3
1,1,15507,153,81,72
1,1,8387,74,38,36
1,1,3449,41,16,25
1,1,1252,46,27,19
1,1,3416,6,2,4
1,1,7197,216,89,127
1,1,3376,39,21,18
1,1,2989,5,1,4
1,1,2880,2,2,0
1,1,1047,0,0,0
1,1,1493,2,1,1
1,1,1441,1,1,0
1,2,2712,8,1,7
1,2,2539,80,39,41
1,2,2831,3,0,3
1,2,3122,0,0,0
1,2,2552,1,0,1
1,2,4855,18,12,6
1,2,3866,11,8,3
1,2,3096,21,9,12
1,2,2601,10,7,3
1,2,3791,9,6,3
1,2,2542,4,2,2
1,2,3480,11,5,6
1,2,3795,27,17,10
1,2,2142,3,0,3
1,2,3494,16,10,6
1,2,2257,3,0,3
1,2,1926,1,0,1
1,3,2038,5,3,2
1,3,3476,5,3,2
1,3,2014,28,12,16
1,3,4762,19,9,10
1,3,1209,5,1,4
1,3,842,0,0,0
1,3,1948,31,15,16
1,3,2608,31,13,18
1,3,2551,18,11,7
1,3,507,1,0,1
1,3,339,11,5,6
1,3,828,3,0,3
1,3,2125,10,3,7
1,3,522,1,0,1
1,3,1446,6,3,3
1,3,1467,9,3,6
1,3,1307,3,1,2
1,3,2555,2,1,1
1,3,1249,0,0,0
1,3,2649,52,23,29
1,3,2831,4,1,3
1,3,1826,3,0,3
1,3,535,0,0,0
1,3,1572,0,0,0
1,3,2376,3,0,3
1,3,1493,1,1,0
1,3,1881,1,1,0
1,3,3356,5,2,3
1,3,2320,2,0,2
1,3,1819,5,0,5
1,3,1889,2,1,1
1,4,4390,396,214,182
1,4,3070,1221,622,599
1,4,2304,12,5,7
1,4,3443,83,42,41
1,4,3777,443,220,223
1,5,12564,145,64,81
1,5,4946,23,14,9
1,5,7703,143,74,69
1,5,1789,14,5,9
1,5,8471,145,69,76
1,5,13733,146,67,79
1,5,1453,36,20,16
1,5,2287,40,16,24
1,5,2169,5,2,3
1,5,4908,39,24,15
1,5,1387,31,10,21
1,5,6505,17,7,10
1,10,1183,6,3,3
1,5,13939,529,265,264
1,5,6412,455,225,230
1,5,1719,9,3,6
1,5,466,3,3,0
1,5,1255,0,0,0
1,5,3523,3,2,1
1,5,12380,65,36,29
1,5,4552,423,209,214
1,5,18699,290,156,134
1,5,3935,26,14,12
1,6,8436,34,22,12
1,6,1990,45,23,22
1,6,1727,5,1,4
1,6,1572,1,1,0
1,6,1759,1,0,1
1,6,1123,87,48,39
1,6,7224,85,41,44
1,6,1266,4,2,2
1,6,1649,1,1,0
1,6,4898,7,4,3
1,6,1005,2,1,1
1,6,2073,22,5,17
1,6,1903,8,5,3
1,6,4482,68,36,32
1,6,3196,7,5,2
1,6,2070,58,29,29
1,7,1033,7,4,3
1,7,4625,28,18,10
1,7,1125,2,1,1
1,7,786,0,0,0
1,7,1121,16,6,10
1,7,7580,39,18,21
1,7,3840,24,9,15
1,7,750,3,3,0
1,7,2675,4,3,1
1,7,7727,48,26,22
1,7,1213,5,4,1
1,7,3006,3,2,1
1,7,2565,1,1,0
1,7,1457,0,0,0
1,7,3188,135,79,56
1,7,3076,4,1,3
1,7,3609,0,0,0
1,7,2034,8,4,4
1,7,2899,0,0,0
1,7,1813,5,3,2
1,7,1236,8,3,5
1,8,1639,17,6,11
1,8,2242,31,18,13
1,8,1723,17,10,7
1,8,488,0,0,0
1,8,516,1,0,1
1,8,1261,522,277,245
1,8,1688,2,0,2
1,9,2539,2,2,0
1,9,2706,5,4,1
1,9,2280,13,6,7
1,9,1915,14,6,8
1,9,2577,3,1,2
1,9,962,0,0,0
1,9,1358,3,1,2
1,9,3089,14,10,4
1,9,1310,9,2,7
1,9,3900,20,12,8
1,10,1494,35,19,16
1,10,1747,14,9,5
1,10,1628,13,5,8
1,10,13946,73,34,39
1,10,1769,4,2,2
1,10,2245,4,2,2
1,10,12615,142,68,74
1,10,7668,30,8,22
1,10,19852,168,83,85
1,11,3670,1,1,0
1,11,2712,6,4,2
1,11,1694,2,1,1
1,11,3514,2,2,0
1,11,1287,13,7,6
1,11,1267,16,9,7
1,11,2943,91,43,48
1,11,3732,22,9,13
1,6,301,6,1,5
1,1,1073,4,0,4
1,1,855,0,0,0
1,1,1102,4,3,1
1,1,1252,3,2,1
1,1,2560,12,7,5
1,1,1531,17,10,7
1,1,1966,2,1,1
1,1,3468,38,16,22
1,1,1240,4,1,3
1,1,1222,3,1,2
1,1,1100,3,1,2
1,1,993,1,1,0
1,1,1188,2,2,0
1,1,1116,1,1,0
1,1,978,0,0,0
1,1,1237,5,1,4
1,1,1071,6,4,2
1,1,1020,2,1,1
1,1,1031,16,8,8
1,1,1337,1,1,0
1,1,3306,3,0,3
1,1,1117,4,3,1
1,1,1084,3,0,3
1,1,728,2,0,2
1,1,584,7,3,4
1,1,832,8,4,4
1,1,987,65,29,36
1,1,1085,92,48,44
1,1,825,108,54,54
1,1,816,216,111,105
1,1,684,16,9,7
1,1,812,92,45,47
1,1,826,1,0,1
1,1,991,3,2,1
1,1,1006,1,1,0
1,1,1093,13,6,7
1,1,1111,4,1,3
1,1,1020,0,0,0
1,1,1014,15,4,11
1,1,1420,19,9,10
1,1,1013,2,1,1
1,1,3844,18,11,7
1,1,1368,8,6,2
1,1,1342,1,0,1
1,1,1433,13,7,6
1,1,1562,38,22,16
1,1,1605,12,4,8
1,1,1688,3,2,1
1,1,1380,16,6,10
1,1,1038,26,9,17
1,1,1226,21,7,14
1,1,1257,17,8,9
1,1,1275,18,8,10
1,1,1279,26,12,14
1,1,1430,2,1,1
1,1,1385,4,3,1
1,1,1737,2,1,1
1,1,1735,1,1,0
1,1,1918,12,5,7
1,1,1121,12,6,6
1,1,4576,71,39,32
1,1,1122,12,5,7
1,1,1279,18,10,8
1,1,1039,10,3,7
1,1,1123,25,15,10
1,1,1148,10,4,6
1,1,12675,454,233,221
1,1,1071,58,27,31
1,1,1082,30,10,20
1,1,1095,9,5,4
1,1,1112,31,12,19
1,1,1505,12,8,4
1,1,522,2,1,1
1,1,1078,6,3,3
1,1,1056,18,7,11
1,1,982,10,2,8
1,1,848,2,2,0
1,1,953,5,2,3
1,1,1083,7,3,4
1,1,890,1,1,0
1,1,930,1,0,1
1,1,858,9,6,3
1,1,753,5,4,1
1,1,13528,220,102,118
1,1,2587,18,12,6
1,1,1335,10,5,5
1,1,2549,4,1,3
1,1,1409,6,4,2
1,1,1925,0,0,0
1,1,1187,3,2,1
1,1,1167,4,2,2
1,1,1372,5,1,4
1,1,1386,2,1,1
1,1,1486,6,3,3
1,1,1408,8,2,6
1,1,1369,0,0,0
1,1,1444,0,0,0
1,1,1449,8,4,4
1,1,1611,3,1,2
1,1,1601,11,8,3
1,1,20627,149,76,73
1,1,1639,6,3,3
1,1,971,12,5,7
1,1,1001,7,2,5
1,1,1168,2,0,2
1,1,14866,271,146,125
1,1,2589,49,25,24
1,1,4515,176,93,83
1,1,2451,12,7,5
1,1,1706,3,2,1
1,1,1300,11,8,3
1,1,1259,30,16,14
1,1,3310,14,7,7
1,1,3144,23,15,8
1,1,2495,6,3,3
1,1,1922,17,4,13
1,1,1120,5,2,3
1,1,1461,6,3,3
1,1,1036,18,8,10
1,1,2344,5,1,4
1,1,4076,32,11,21
1,1,3324,50,30,20
1,1,3263,23,6,17
1,1,5085,50,22,28
1,1,4610,60,30,30
1,1,4175,7,1,6
1,1,2249,14,6,8
1,1,1096,0,0,0
1,1,4144,34,15,19
1,1,3410,25,11,14
1,1,2222,62,37,25
1,1,3236,116,65,51
1,1,5215,135,63,72
1,1,2805,46,25,21
1,1,2485,32,13,19
1,1,4171,108,57,51
1,1,3646,194,94,100
1,1,5404,159,71,88
1,1,2968,165,76,89
1,1,2697,131,62,69
1,1,1642,8,4,4
1,1,816,19,9,10
1,1,2502,89,38,51
2,1,3271,33,16,17
2,1,1533,3,0,3
2,1,1812,15,10,5
2,1,1848,37,17,20
2,1,464,6,4,2
2,1,2259,19,12,7
2,1,678,6,3,3
2,1,1757,21,13,8
2,1,1079,42,24,18
2,1,1109,6,4,2
2,1,2799,30,11,19
2,1,7245,61,33,28
2,1,24013,240,130,110
2,1,1648,10,6,4
2,1,1661,25,12,13
2,1,3554,7,4,3
2,1,2371,24,10,14
2,1,1376,3,1,2
2,1,1845,22,15,7
2,1,868,5,3,2
2,1,848,20,10,10
2,1,1570,15,7,8
2,1,1309,10,3,7
2,1,1032,2,1,1
2,1,993,22,9,13
2,1,1342,1,1,0
2,1,668,7,3,4
2,1,1084,7,4,3
2,1,1447,8,4,4
2,1,914,3,2,1
2,1,2122,21,8,13
2,1,2206,7,2,5
2,1,1583,5,3,2
2,1,3230,15,3,12
2,1,3944,21,13,8
2,1,4072,59,33,26
2,1,2277,10,3,7
2,1,1890,29,12,17
2,1,1816,13,9,4
2,1,1264,6,0,6
2,1,1227,20,6,14
2,1,892,3,1,2
2,1,816,4,0,4
2,1,690,6,2,4
2,1,619,6,3,3
2,1,681,26,10,16
2,1,1851,1,0,1
2,1,193,0,0,0
2,1,335,1,0,1
2,1,460,8,2,6
2,1,762,9,3,6
2,1,503,6,2,4
2,1,912,2,2,0
2,1,715,10,5,5
2,1,1545,18,7,11
2,1,1224,10,5,5
2,1,1352,87,44,43
2,1,1681,8,2,6
2,1,1801,14,10,4
2,1,2704,18,9,9
2,1,2787,53,27,26
2,1,992,4,4,0
2,1,1001,156,85,71
2,1,1365,215,116,99
2,1,823,67,33,34
2,1,833,7,4,3
2,1,792,13,8,5
2,1,765,2,2,0
2,1,748,15,9,6
2,1,917,10,2,8
2,1,1372,21,8,13
2,1,740,2,0,2
2,1,932,21,14,7
2,1,1137,26,15,11
2,1,1177,18,12,6
2,1,1026,22,13,9
2,1,854,6,2,4
2,1,1128,8,4,4
2,1,1047,5,2,3
2,1,882,1,1,0
2,1,729,19,12,7
2,1,1301,14,7,7
2,1,1059,10,4,6
2,1,891,11,6,5
2,1,1392,10,3,7
2,1,1518,20,6,14
2,1,2616,25,11,14
2,1,1190,22,11,11
2,1,1122,25,13,12
2,1,867,9,2,7
2,1,1125,22,14,8
2,1,1102,39,20,19
2,1,1566,26,15,11
2,1,2024,187,98,89
2,1,2054,25,12,13
2,1,1375,20,9,11
2,1,2379,34,14,20
2,1,1381,45,22,23
2,1,1237,13,5,8
2,1,1011,0,0,0
2,1,1305,11,4,7
2,1,1284,7,3,4
2,1,1569,21,8,13
2,1,1577,26,13,13
2,1,2159,10,6,4
2,1,1693,17,8,9
2,1,4317,17,8,9
2,1,1493,20,9,11
2,1,975,14,7,7
2,1,950,8,4,4
2,1,1279,9,6,3
2,1,1633,16,5,11
2,1,2348,64,29,35
2,1,3449,41,14,27
2,1,1966,14,7,7
2,1,1659,7,2,5
2,1,1187,2,2,0
2,1,1308,22,12,10
2,1,2014,52,21,31
2,1,1139,8,3,5
2,1,2404,23,10,13
2,1,1181,22,11,11
2,1,1064,6,3,3
2,1,2106,24,6,18
2,1,1839,27,5,22
2,1,2334,54,24,30
2,1,2361,98,38,60
2,1,1671,16,6,10
2,1,3254,49,23,26
2,1,1221,9,4,5
2,1,2737,35,14,21
2,1,1012,5,3,2
2,1,1174,12,5,7
2,1,2265,26,9,17
2,1,2274,36,18,18
2,1,2253,11,9,2
2,1,8491,174,79,95
2,1,919,8,4,4
2,1,767,17,7,10
2,1,1640,10,4,6
2,1,1570,4,3,1
2,1,1486,20,11,9
2,1,2526,3,1,2
2,1,3608,39,19,20
2,1,1263,11,7,4
2,1,2827,50,13,37
2,1,2628,52,22,30
2,1,4609,34,18,16
2,1,2239,36,24,12
2,1,584,9,4,5
2,1,1441,12,5,7
2,1,1369,29,15,14
2,1,3640,70,38,32
2,1,1160,68,36,32
2,1,1196,17,6,11
2,1,1691,16,6,10
2,1,1840,20,5,15
2,1,597,85,33,52
2,1,651,24,12,12
2,1,605,33,14,19
2,1,1891,12,7,5
2,1,566,1,1,0
2,1,2745,521,275,246
2,1,2751,27,7,20
2,1,823,2,1,1
2,1,3727,6,3,3
2,1,29029,515,245,270
2,1,2993,39,19,20
2,1,415,0,0,0
2,1,2935,88,31,57
2,1,16236,250,111,139
2,1,1752,31,17,14
2,1,8832,52,21,31
2,1,916,49,20,29
2,1,766,13,2,11
2,1,1870,27,15,12
2,1,1239,11,4,7
2,1,2024,3,0,3
2,1,479,1,1,0
2,1,8797,12,3,9
2,1,8967,93,48,45
2,1,9798,350,165,185
2,1,4602,18,11,7
2,1,13003,138,57,81
2,1,4072,160,70,90
2,1,2829,155,76,79
2,1,10652,270,137,133
2,1,507,7,3,4
2,1,8549,175,79,96
2,1,9316,162,78,84
2,1,1710,4,1,3
2,1,5519,22,3,19
2,1,573,0,0,0
2,1,3221,30,10,20
2,1,304,3,1,2
2,1,588,560,260,300
2,1,842,3,1,2
2,1,1163,1103,521,582
2,1,154,137,48,89
2,1,768,0,0,0
2,1,929,4,3,1
2,1,1511,18,10,8
2,1,9927,167,79,88
2,1,1252,180,93,87
2,2,873,17,7,10
2,2,559,8,2,6
2,2,484,4,2,2
2,2,628,7,3,4
2,2,472,7,1,6
2,2,725,34,5,29
2,2,243,11,4,7
2,2,311,67,26,41
2,2,262,103,51,52
2,2,158,8,1,7
2,2,612,19,8,11
2,2,638,11,4,7
2,2,689,1,0,1
2,2,820,1,0,1
2,2,862,5,4,1
2,2,546,1,1,0
2,2,344,5,0,5
2,2,668,48,12,36
2,2,413,5,0,5
2,2,512,13,5,8
2,2,728,17,6,11
2,2,586,4,3,1
2,2,599,3,0,3
2,2,465,2,0,2
2,2,634,7,3,4
2,2,539,17,8,9
2,2,730,20,8,12
2,2,585,25,7,18
2,2,539,21,7,14
2,2,623,18,12,6
2,2,932,5,2,3
2,2,911,4,2,2
2,2,813,0,0,0
2,2,627,5,5,0
2,2,1161,11,7,4
2,2,3758,13,6,7
2,2,1096,134,58,76
2,2,670,10,2,8
2,2,484,5,2,3
2,2,448,15,4,11
2,2,598,9,5,4
2,2,730,23,7,16
2,2,577,10,8,2
2,2,818,432,206,226
2,2,830,144,64,80
2,2,705,54,24,30
2,2,947,8,2,6
2,2,542,6,1,5
2,2,551,12,8,4
2,2,777,9,5,4
2,2,583,28,12,16
2,2,644,4,2,2
2,2,544,9,4,5
2,2,1169,3,1,2
2,2,229,11,6,5
2,2,623,10,4,6
2,2,841,11,8,3
2,2,219,0,0,0
2,2,901,5,2,3
2,2,1432,9,4,5
2,2,1112,5,3,2
2,2,742,2,1,1
2,2,715,3,1,2
2,2,754,1,1,0
2,2,822,5,3,2
2,2,711,8,5,3
2,2,884,11,4,7
2,2,443,0,0,0
2,2,905,15,8,7
2,2,711,3,1,2
2,2,731,9,5,4
2,2,870,7,2,5
2,2,814,12,5,7
2,2,762,9,6,3
2,2,732,3,2,1
2,2,951,13,9,4
2,2,765,11,6,5
2,2,417,8,3,5
2,2,685,1,1,0
2,2,281,0,0,0
2,2,909,4,2,2
2,2,979,7,3,4
2,2,1852,12,9,3
2,2,699,34,17,17
2,2,370,11,6,5
2,2,538,1,1,0
2,2,1043,20,9,11
2,2,788,9,4,5
2,2,1047,1,1,0
2,2,586,9,3,6
2,2,701,3,1,2
2,2,689,3,1,2
2,2,744,7,2,5
2,2,1281,1,0,1
2,2,2112,52,24,28
2,2,1045,13,4,9
2,2,924,4,3,1
2,2,1055,15,9,6
2,2,579,6,3,3
2,2,1047,13,6,7
2,2,598,5,3,2
2,2,933,42,20,22
2,2,1037,59,30,29
2,2,1199,2,1,1
2,2,1204,1,1,0
2,2,992,4,0,4
2,2,859,37,18,19
2,2,739,0,0,0
2,2,1268,11,6,5
2,2,1024,9,6,3
2,2,898,4,2,2
2,2,806,6,4,2
2,2,1147,4,2,2
2,2,1377,15,8,7
2,2,763,46,25,21
2,2,1684,19,8,11
2,2,2097,11,3,8
2,2,1017,3,1,2
2,2,1320,11,4,7
2,2,1449,13,5,8
2,2,2524,9,3,6
2,2,1221,35,16,19
2,2,4354,77,34,43
2,2,1380,23,12,11
2,2,1510,8,4,4
2,2,493,1,0,1
2,2,779,1,1,0
2,2,1192,6,4,2
2,2,4068,47,19,28
2,2,1447,31,16,15
2,2,1510,10,6,4
2,2,1793,26,13,13
2,2,791,59,28,31
2,2,820,11,4,7
2,2,687,49,26,23
2,2,11900,142,73,69
2,2,1805,14,5,9
2,2,1602,10,4,6
2,2,971,1,0,1
2,2,1875,4,2,2
2,2,2342,32,20,12
2,2,1197,6,1,5
2,2,988,12,8,4
2,2,954,1,0,1
2,2,1317,14,8,6
2,2,6763,64,34,30
2,2,6774,69,31,38
2,2,1635,20,12,8
2,2,1322,9,4,5
2,2,1146,9,5,4
2,2,2019,7,2,5
2,2,1238,15,7,8
2,2,976,8,5,3
2,2,1429,8,3,5
2,2,1060,5,3,2
2,2,6120,87,40,47
2,2,1459,86,46,40
2,2,1597,16,6,10
2,2,1121,10,7,3
2,2,817,4,2,2
2,2,443,2,0,2
2,2,992,6,0,6
2,2,557,4,2,2
2,2,720,2,1,1
2,2,750,2,1,1
2,2,1821,11,4,7
2,2,1431,12,8,4
2,2,2687,22,8,14
2,2,1044,5,3,2
2,2,1105,4,3,1
2,2,765,2,0,2
2,2,1764,5,1,4
2,2,2585,11,5,6
2,2,867,8,3,5
2,2,1550,39,19,20
2,2,1247,11,7,4
2,2,788,5,1,4
2,2,1354,11,6,5
2,2,903,1,0,1
2,2,751,3,2,1
2,2,526,2,1,1
2,2,1471,2,1,1
2,2,1050,6,2,4
2,2,978,9,2,7
2,2,1075,7,3,4
2,2,1681,35,15,20
2,2,1093,26,13,13
2,2,21359,126,63,63
2,2,1278,1,1,0
2,2,1196,1,0,1
2,2,1055,9,3,6
2,2,838,7,4,3
2,2,1442,15,6,9
2,2,595,2,1,1
2,2,661,11,3,8
2,2,1447,16,12,4
2,2,894,14,9,5
2,2,665,2,1,1
2,2,1589,14,8,6
2,2,712,17,9,8
2,2,1214,6,5,1
2,2,796,3,3,0
2,2,630,10,4,6
2,2,1780,20,15,5
2,2,967,11,4,7
2,2,781,5,4,1
2,2,714,2,0,2
2,2,1785,26,16,10
2,2,726,20,10,10
2,2,729,4,4,0
2,2,763,6,0,6
2,2,1382,11,2,9
2,2,1323,22,11,11
2,2,791,5,2,3
2,2,1684,11,7,4
2,2,1067,4,4,0
2,2,951,2,1,1
2,2,1304,29,15,14
2,2,698,4,0,4
2,2,937,5,1,4
2,2,1199,17,8,9
2,2,1391,12,3,9
2,2,1067,2,1,1
2,2,1270,7,3,4
2,2,1266,2,1,1
2,2,1192,4,1,3
2,2,574,3,2,1
2,2,1217,10,5,5
2,2,1582,3,1,2
2,2,1067,16,9,7
2,2,1229,28,13,15
2,2,1423,15,5,10
2,2,1218,5,3,2
2,2,15683,117,54,63
2,2,1162,16,4,12
2,2,1294,11,4,7
2,2,831,5,3,2
2,2,1640,66,31,35
2,2,1258,18,8,10
2,2,1160,4,2,2
2,2,675,2,1,1
2,2,839,7,2,5
2,2,821,2,1,1
2,2,1226,15,6,9
2,2,3275,32,15,17
2,2,2380,16,4,12
2,2,1019,18,10,8
2,2,711,1,0,1
2,2,1728,11,7,4
2,2,543,1,0,1
2,2,951,0,0,0
2,2,586,1,0,1
2,2,1836,14,6,8
2,2,866,8,1,7
2,2,1056,2,1,1
2,2,982,7,4,3
2,2,2191,163,78,85
2,2,1120,11,4,7
2,2,9158,87,49,38
2,2,21112,253,123,130
2,2,1134,4,0,4
2,2,3083,51,25,26
2,2,874,18,8,10
2,2,2175,39,16,23
2,2,1177,6,4,2
2,2,1689,8,5,3
2,2,1046,24,11,13
2,2,1493,9,5,4
2,2,1462,185,92,93
2,2,4516,152,79,73
2,2,2312,7,4,3
2,2,1595,74,46,28
2,2,510,8,4,4
2,2,756,0,0,0
2,2,910,6,2,4
2,2,1340,23,13,10
2,2,1061,21,11,10
2,2,14431,232,139,93
2,2,1087,1,0,1
2,2,838,2,0,2
2,2,1244,4,3,1
2,2,1765,18,5,13
2,2,1661,33,17,16
2,2,996,29,15,14
2,2,1399,2,1,1
2,2,5836,42,23,19
2,2,771,5,2,3
2,2,1743,36,17,19
2,2,1276,14,5,9
2,2,949,4,3,1
2,2,21431,222,93,129
2,2,9957,39,20,19
2,2,744,0,0,0
2,2,1093,9,5,4
2,2,1053,9,4,5
2,2,735,2,0,2
2,2,804,0,0,0
2,2,775,6,3,3
2,2,778,8,2,6
2,2,1011,5,3,2
2,2,893,4,3,1
2,2,850,53,30,23
2,2,1105,6,3,3
2,2,974,3,1,2
2,2,4736,41,16,25
2,2,692,27,8,19
2,2,4230,20,9,11
2,2,3233,32,17,15
2,2,3675,9,4,5
2,2,1925,20,11,9
2,2,7992,42,17,25
2,2,11094,64,25,39
2,2,1129,33,18,15
2,2,1159,20,9,11
2,2,1070,1,0,1
2,2,841,2,1,1
2,2,1844,13,8,5
2,2,1162,1,1,0
2,2,1165,9,6,3
2,2,1066,3,1,2
2,2,1440,14,3,11
2,2,1367,16,7,9
2,2,3366,53,18,35
2,2,445,4,1,3
2,2,868,2,0,2
2,2,728,3,1,2
2,2,18919,324,147,177
2,2,842,2,2,0
2,2,9637,100,53,47
2,2,3681,21,8,13
2,2,3219,24,13,11
2,2,2350,10,2,8
2,2,20051,154,71,83
2,2,4641,23,14,9
2,2,906,5,4,1
2,2,2362,17,4,13
2,2,588,3,1,2
2,2,1327,19,9,10
2,2,1757,6,4,2
2,2,2139,2,0,2
2,2,2038,5,1,4
2,2,2558,12,6,6
2,2,1911,21,10,11
2,2,3379,16,5,11
2,2,2320,3,3,0
2,2,680,3,1,2
2,2,3195,23,10,13
2,2,1213,6,5,1
2,2,1235,2,1,1
2,2,1570,7,6,1
2,2,2289,22,10,12
2,2,1153,7,3,4
2,2,985,7,4,3
2,2,10372,91,33,58
2,2,2729,58,22,36
2,2,1654,47,23,24
2,2,506,2,2,0
2,2,7903,105,51,54
2,2,4348,53,26,27
2,2,1600,9,6,3
2,2,2020,5,1,4
2,2,3233,46,27,19
2,2,743,0,0,0
2,2,1868,0,0,0
2,2,1879,0,0,0
2,2,1221,2,1,1
2,2,699,10,4,6
2,2,1519,3,1,2
2,2,999,1,0,1
2,2,1353,2,0,2
2,2,1227,0,0,0
2,2,756,1,0,1
2,2,874,1,1,0
2,2,60,0,0,0
2,2,1490,5,0,5
2,2,1342,14,9,5
2,2,2952,69,4,65
2,2,834,3,1,2
2,2,1906,17,9,8
2,2,1308,12,6,6
2,2,8553,56,20,36
2,2,13213,118,50,68
2,2,3263,18,8,10
2,2,1695,4,2,2
2,2,1087,5,4,1
2,2,2877,18,9,9
2,2,1021,6,1,5
2,2,1737,9,3,6
2,2,1600,1,0,1
2,2,2350,15,8,7
2,2,949,1,0,1
2,2,1195,5,2,3
2,2,1062,4,3,1
2,2,1299,3,3,0
2,2,1516,1,0,1
2,2,735,1,1,0
2,2,3111,14,3,11
2,2,1280,0,0,0
2,2,624,0,0,0
2,2,2602,10,6,4
2,2,746,0,0,0
2,2,2074,5,3,2
2,2,1361,1,1,0
2,2,990,1,1,0
2,2,1158,5,2,3
2,2,869,2,1,1
2,2,3214,10,3,7
2,2,1707,24,9,15
2,2,2145,5,1,4
2,2,1634,2,2,0
2,2,1385,0,0,0
2,2,2178,86,15,71
2,2,2472,4,1,3
2,2,3440,8,3,5
2,2,1811,1,1,0
2,2,1487,4,3,1
2,2,883,1,0,1
2,2,1144,6,1,5
2,2,450,1,0,1
2,2,2990,8,5,3
2,2,1824,26,17,9
2,2,1110,12,6,6
2,2,810,4,2,2
2,2,563,0,0,0
2,2,737,4,2,2
2,2,1073,3,3,0
2,2,2105,6,3,3
2,2,968,2,1,1
2,2,2914,19,6,13
2,2,3192,23,14,9
2,2,854,7,2,5
2,2,5793,43,13,30
2,2,819,0,0,0
2,2,821,1,1,0
2,2,1170,6,3,3
2,2,711,4,2,2
2,2,756,0,0,0
2,2,1128,2,0,2
2,2,881,2,1,1
2,2,1381,16,13,3
2,2,1120,4,1,3
2,2,1912,6,3,3
2,2,1911,5,1,4
2,2,1151,3,0,3
2,2,1636,1,1,0
2,2,873,0,0,0
2,2,772,2,0,2
2,2,2101,1,1,0
2,2,2520,9,2,7
2,2,1614,16,10,6
2,2,826,0,0,0
2,2,1048,2,1,1
2,2,1549,103,44,59
2,2,382,0,0,0
2,2,470,4,2,2
2,2,407,2,0,2
2,2,646,0,0,0
2,2,1160,4,0,4
2,2,931,4,3,1
2,2,1626,4,1,3
2,2,1596,7,2,5
2,2,667,1,0,1
2,2,8202,43,17,26
2,2,2716,25,8,17
2,2,2822,19,8,11
2,2,731,11,6,5
2,2,3987,61,34,27
2,2,515,1,0,1
2,2,723,5,2,3
2,2,1089,26,14,12
2,2,479,1,1,0
2,2,487,2,1,1
2,2,670,6,2,4
2,2,718,4,1,3
2,2,14858,143,65,78
2,2,16439,150,81,69
2,2,1345,3,1,2
2,3,2013,25,12,13
2,3,1370,12,6,6
2,3,2218,15,8,7
2,3,1251,24,10,14
2,3,711,11,5,6
2,3,727,6,6,0
2,3,938,17,9,8
2,3,1536,11,5,6
2,3,10006,118,56,62
2,3,1826,7,3,4
2,3,1317,15,7,8
2,3,1733,21,10,11
2,3,1691,9,2,7
2,3,1134,6,3,3
2,3,1332,14,8,6
2,3,1792,8,4,4
2,3,2182,42,16,26
2,3,3837,73,42,31
2,3,1506,35,13,22
2,3,1737,20,5,15
2,3,4661,26,13,13
2,3,4676,19,8,11
2,3,2322,3,1,2
2,3,1740,27,12,15
2,3,1683,12,6,6
2,3,1246,5,2,3
2,3,1034,4,1,3
2,3,16428,128,66,62
2,3,6337,81,40,41
2,3,780,90,38,52
2,3,1684,772,401,371
2,3,773,14,6,8
2,3,1021,22,9,13
2,3,2083,13,9,4
2,3,1776,20,12,8
2,3,5647,7,1,6
2,3,503,1,0,1
2,3,590,6,5,1
2,3,1063,8,2,6
2,4,2901,57,31,26
2,4,1275,6,3,3
2,4,1572,30,14,16
2,4,1131,57,25,32
2,4,1596,48,30,18
2,4,1378,21,7,14
2,4,1288,10,4,6
2,4,1572,42,16,26
2,4,817,6,2,4
2,4,697,12,5,7
2,4,895,23,13,10
2,4,1142,15,6,9
2,4,631,5,3,2
2,4,854,20,8,12
2,4,1084,72,18,54
2,4,779,87,28,59
2,4,1262,47,11,36
2,4,541,10,5,5
2,4,728,18,9,9
2,4,845,16,7,9
2,4,824,43,12,31
2,4,913,29,16,13
2,4,967,2,0,2
2,4,1227,30,18,12
2,4,775,13,7,6
2,4,774,3,2,1
2,4,1297,6,4,2
2,4,1960,14,7,7
2,4,1064,13,5,8
2,4,3393,109,49,60
2,4,1131,11,3,8
2,4,3188,9,3,6
2,4,1151,15,6,9
2,4,1064,0,0,0
2,4,959,5,2,3
2,4,596,4,2,2
2,4,1054,25,12,13
2,4,1309,27,13,14
2,4,602,2,0,2
2,4,726,19,6,13
2,4,735,9,1,8
2,4,847,13,6,7
2,4,907,26,11,15
2,4,553,17,9,8
2,4,558,29,9,20
2,4,550,30,11,19
2,4,348,15,3,12
2,4,505,28,10,18
2,4,859,57,22,35
2,4,573,22,9,13
2,4,875,44,21,23
2,4,945,14,5,9
2,4,933,16,5,11
2,4,785,8,4,4
2,4,1294,13,6,7
2,4,1082,26,8,18
2,4,735,15,7,8
2,4,914,6,2,4
2,4,750,1,1,0
2,4,1091,61,32,29
2,4,1192,12,8,4
2,4,1031,5,1,4
2,4,2285,37,20,17
2,4,3477,30,16,14
2,4,759,12,2,10
2,4,1946,21,8,13
2,4,799,0,0,0
2,4,1251,11,6,5
2,4,1125,13,6,7
2,4,1093,8,4,4
2,4,881,11,5,6
2,4,652,5,4,1
2,4,1469,19,11,8
2,4,1256,27,15,12
2,4,440,19,6,13
2,4,644,5,3,2
2,4,1439,14,8,6
2,4,642,30,14,16
2,4,618,32,8,24
2,4,744,11,5,6
2,4,805,26,10,16
2,4,728,15,7,8
2,4,835,15,6,9
2,4,671,2,1,1
2,4,736,8,3,5
2,4,1512,53,28,25
2,4,1251,16,8,8
2,4,1410,32,20,12
2,4,915,1,0,1
2,4,1034,7,4,3
2,4,1629,13,2,11
2,4,826,5,2,3
2,4,1989,19,9,10
2,4,912,8,3,5
2,4,2083,20,9,11
2,4,3070,6,1,5
2,4,3129,12,4,8
2,4,1341,23,10,13
2,4,996,6,3,3
2,4,638,1,0,1
2,4,877,27,14,13
2,4,969,24,10,14
2,4,932,11,3,8
2,4,846,6,3,3
2,4,1038,8,5,3
2,4,657,8,5,3
2,4,2103,5,1,4
2,4,5943,40,18,22
2,4,2591,57,30,27
2,4,982,1,1,0
2,4,1343,31,19,12
2,4,977,14,7,7
2,4,1257,10,7,3
2,4,1147,2,2,0
2,4,2071,15,6,9
2,4,1670,42,22,20
2,4,1682,17,10,7
2,4,2326,20,8,12
2,4,6287,74,32,42
2,4,4371,12,5,7
2,4,3579,10,3,7
2,4,4754,58,26,32
2,4,11479,127,61,66
2,4,1389,4,1,3
2,4,713,14,6,8
2,4,826,1,0,1
2,4,506,1,0,1
2,4,426,5,4,1
2,4,632,18,9,9
2,4,607,1,1,0
2,4,608,4,0,4
2,4,817,13,7,6
2,4,1023,54,14,40
2,4,402,0,0,0
2,4,1631,46,19,27
2,4,708,27,10,17
2,4,957,14,7,7
2,4,465,15,2,13
2,4,850,20,10,10
2,4,825,60,18,42
2,4,577,26,11,15
2,4,242,2,1,1
2,4,383,0,0,0
2,4,181,0,0,0
2,4,615,26,6,20
2,4,860,8,4,4
2,4,1165,18,9,9
2,4,836,18,6,12
2,4,2354,26,12,14
2,4,538,4,1,3
2,4,1000,3,2,1
2,4,371,9,5,4
2,4,661,11,4,7
2,4,395,5,1,4
2,4,282,0,0,0
2,4,566,19,7,12
2,4,470,7,2,5
2,4,813,13,7,6
2,4,1127,23,8,15
2,4,1010,11,5,6
2,4,972,33,8,25
2,4,904,28,12,16
2,4,1660,31,12,19
2,4,479,21,8,13
2,4,1415,59,25,34
2,4,2287,69,30,39
2,4,1475,39,17,22
2,4,2061,53,23,30
2,4,832,32,19,13
2,4,589,8,6,2
2,4,607,4,2,2
2,4,773,18,9,9
2,4,665,7,3,4
2,4,485,9,4,5
2,4,943,10,5,5
2,4,1015,25,13,12
2,4,713,11,2,9
2,4,729,27,10,17
2,4,849,21,9,12
2,4,500,4,2,2
2,4,1177,26,7,19
2,4,981,14,4,10
2,4,566,55,24,31
2,4,1255,12,5,7
2,4,608,5,1,4
2,4,407,2,1,1
2,4,1163,7,2,5
2,4,871,41,17,24
2,4,785,4,2,2
2,4,1198,18,6,12
2,4,3522,22,11,11
2,4,1629,42,18,24
2,4,6423,177,88,89
2,4,578,10,5,5
2,4,2073,9,6,3
2,4,1590,33,11,22
2,4,682,8,3,5
2,4,717,9,2,7
2,4,963,13,6,7
2,4,1744,36,14,22
2,4,953,36,24,12
2,4,942,12,7,5
2,4,694,5,1,4
2,4,1034,4,1,3
2,4,1160,18,7,11
2,4,805,14,5,9
2,4,1902,15,7,8
2,4,1388,128,68,60
2,4,758,31,15,16
2,4,1102,163,76,87
2,4,378,58,27,31
2,4,1221,5,3,2
2,4,896,6,2,4
2,4,578,0,0,0
2,4,1471,8,3,5
2,4,1182,44,19,25
2,4,1897,104,47,57
2,4,1027,4,3,1
2,4,1374,6,5,1
2,4,1016,13,4,9
2,4,1179,10,3,7
2,4,1642,42,19,23
2,4,1615,18,7,11
2,4,919,62,31,31
2,4,1529,34,16,18
2,4,1391,8,5,3
2,4,1574,15,8,7
2,4,676,7,5,2
2,4,1122,11,5,6
2,4,1078,3,1,2
2,4,1238,10,5,5
2,4,457,3,1,2
2,4,1428,16,9,7
2,4,848,0,0,0
2,4,918,9,7,2
2,4,1686,19,9,10
2,4,5106,35,19,16
2,4,6061,118,69,49
2,4,1598,84,39,45
2,4,1617,12,6,6
2,4,2879,30,7,23
2,4,2973,27,13,14
2,4,2689,29,16,13
2,4,2635,32,12,20
2,4,1316,12,5,7
2,4,1546,60,32,28
2,4,912,10,6,4
2,4,1133,3,3,0
2,4,919,5,2,3
2,4,1151,2,1,1
2,4,1039,4,1,3
2,4,1149,7,3,4
2,4,1850,27,14,13
2,4,641,28,14,14
2,4,1029,0,0,0
2,4,569,10,6,4
2,4,1247,5,3,2
2,4,1767,15,9,6
2,4,1762,29,9,20
2,4,1138,3,1,2
2,4,1572,4,1,3
2,4,711,3,1,2
2,4,1200,46,29,17
2,4,2656,108,55,53
2,4,1494,23,13,10
2,4,2085,9,4,5
2,4,964,15,9,6
2,4,1402,8,2,6
2,4,692,15,7,8
2,4,1361,13,7,6
2,4,611,10,4,6
2,4,1035,3,2,1
2,4,472,3,1,2
2,4,1012,5,1,4
2,4,456,16,9,7
2,4,3227,45,22,23
2,4,655,5,2,3
2,4,1672,10,4,6
2,4,788,2,0,2
2,4,1032,68,33,35
2,4,1377,22,13,9
2,4,823,33,23,10
2,4,715,2,1,1
2,4,410,5,1,4
2,4,803,5,4,1
2,4,739,14,7,7
2,4,648,9,5,4
2,4,726,4,3,1
2,4,923,5,2,3
2,4,725,11,5,6
2,4,815,4,1,3
2,4,719,7,4,3
2,4,714,35,15,20
2,4,591,3,0,3
2,4,2564,49,13,36
2,4,4178,243,116,127
2,4,839,10,6,4
2,4,1660,23,15,8
2,4,2386,27,13,14
2,4,758,18,8,10
2,4,1084,7,3,4
2,4,1639,50,29,21
2,4,864,7,1,6
2,4,1407,12,5,7
2,4,1341,37,21,16
2,4,1013,12,6,6
2,4,1275,17,5,12
2,4,1029,27,7,20
2,4,4915,116,65,51
2,4,1445,9,3,6
2,4,1043,13,9,4
2,4,1949,20,7,13
2,4,2229,16,8,8
2,4,10743,72,29,43
2,4,17384,161,78,83
2,4,1133,15,8,7
2,4,2179,40,20,20
2,4,1302,18,9,9
2,4,1604,22,7,15
2,4,936,17,8,9
2,4,1235,16,9,7
2,4,1005,31,16,15
2,4,1300,20,5,15
2,4,1190,10,4,6
2,4,1134,36,16,20
2,4,664,8,5,3
2,4,1114,19,11,8
2,4,1007,40,19,21
2,4,962,38,16,22
2,4,767,5,2,3
2,4,952,20,5,15
2,4,937,21,7,14
2,4,486,4,1,3
2,4,955,20,8,12
2,4,2074,16,9,7
2,4,1923,30,15,15
2,4,1228,12,7,5
2,4,1222,30,13,17
2,4,971,11,4,7
2,4,1595,14,4,10
2,4,3037,31,16,15
2,4,1239,25,15,10
2,4,1817,111,58,53
2,4,1315,34,20,14
2,4,787,2,1,1
2,4,699,12,7,5
2,4,760,10,1,9
2,4,1182,31,12,19
2,4,797,21,10,11
2,4,1263,42,20,22
2,4,1029,14,4,10
2,4,704,8,3,5
2,4,1139,5,2,3
2,4,1053,9,3,6
2,4,1208,31,15,16
2,4,1355,12,6,6
2,4,1115,1,1,0
2,4,2442,11,7,4
2,4,1749,37,24,13
2,4,1196,18,9,9
2,4,1136,34,14,20
2,4,4757,40,16,24
2,4,2537,18,8,10
2,4,1646,11,5,6
2,4,1885,47,23,24
2,4,6173,105,48,57
2,4,1642,8,2,6
2,4,4530,26,14,12
2,4,2256,36,13,23
2,4,2102,33,14,19
2,4,1182,11,6,5
2,4,1363,5,3,2
2,4,1104,27,14,13
2,4,1153,28,16,12
2,4,1436,20,9,11
2,4,1038,13,5,8
2,4,827,42,21,21
2,4,862,8,4,4
2,4,1120,10,2,8
2,4,745,4,3,1
2,4,2353,44,15,29
2,4,805,15,6,9
2,4,1365,60,30,30
2,4,3738,85,42,43
2,4,896,16,8,8
2,4,3392,76,30,46
2,4,8881,91,41,50
2,4,4677,29,14,15
2,4,2077,43,23,20
2,4,10767,83,43,40
2,4,2122,11,4,7
2,4,2537,35,19,16
2,4,4894,656,312,344
2,4,2079,41,24,17
2,4,407,2,1,1
2,4,2637,37,15,22
2,4,1456,23,12,11
2,4,876,11,4,7
2,4,641,13,5,8
2,4,1419,20,8,12
2,4,742,18,10,8
2,4,5711,38,21,17
2,4,1783,58,30,28
2,4,1374,14,5,9
2,4,5775,210,88,122
2,4,1556,27,12,15
2,4,1413,11,6,5
2,4,3990,18,11,7
2,4,1820,17,9,8
2,4,2578,17,7,10
2,4,1342,0,0,0
2,4,2375,53,30,23
2,4,412,5,2,3
2,4,3233,49,27,22
2,4,10280,581,299,282
2,4,4799,101,49,52
2,4,10164,99,34,65
2,4,2340,13,7,6
2,4,4144,43,22,21
2,4,2209,23,8,15
2,4,3725,9,4,5
2,4,2240,15,7,8
2,4,1985,101,58,43
2,4,1115,54,26,28
2,4,2124,24,14,10
2,4,5249,82,41,41
2,4,3010,52,26,26
2,4,894,4,1,3
2,4,2272,54,28,26
2,4,2084,23,11,12
2,4,2860,10,4,6
2,4,5136,37,22,15
2,4,1359,15,7,8
2,4,3479,41,22,19
2,4,996,9,4,5
2,4,1826,42,21,21
2,4,2086,59,28,31
2,4,4111,51,24,27
2,4,907,19,7,12
2,4,3259,109,39,70
2,4,1638,33,9,24
2,4,1404,9,5,4
2,4,1783,26,13,13
2,4,1174,17,5,12
2,4,1391,387,185,202
2,4,2326,185,88,97
2,4,2468,319,147,172
2,4,2051,14,7,7
2,4,4076,40,21,19
2,4,3505,66,32,34
2,4,1854,51,17,34
2,4,2830,101,39,62
2,4,2828,85,41,44
2,4,2573,178,97,81
2,4,1345,6,3,3
2,5,11569,220,97,123
2,4,1963,14,5,9
2,4,1604,7,3,4
2,4,2997,29,8,21
2,4,1330,8,5,3
2,4,2456,29,15,14
2,4,3165,29,15,14
2,4,3136,78,36,42
2,4,3058,21,12,9
2,4,1723,10,7,3
2,4,14106,143,71,72
2,4,1221,8,3,5
2,4,555,0,0,0
2,4,899,7,4,3
2,4,3361,32,11,21
2,4,2249,132,66,66
2,4,1456,13,5,8
2,4,1808,9,4,5
2,4,1268,13,4,9
2,4,3929,47,16,31
2,4,1735,54,28,26
2,4,1798,158,60,98
2,4,1922,435,217,218
2,4,3615,161,78,83
2,4,2422,17,5,12
2,4,1977,16,8,8
2,4,2250,19,8,11
2,4,1406,34,15,19
2,4,1679,37,14,23
2,4,2611,34,16,18
2,4,1196,18,11,7
2,4,1199,12,5,7
2,4,1454,9,4,5
2,4,1784,13,7,6
2,4,14083,59,29,30
2,4,1170,8,5,3
2,4,1235,18,9,9
2,4,5620,184,93,91
2,4,1451,41,17,24
2,4,8884,101,57,44
2,4,3349,30,14,16
2,4,4133,54,29,25
2,4,5137,19,7,12
2,4,1727,7,4,3
2,4,1649,16,5,11
2,4,3976,51,25,26
2,4,914,7,4,3
2,4,2222,8,2,6
2,4,2683,51,21,30
2,4,1531,3,1,2
2,4,1878,38,21,17
2,4,1421,3,2,1
2,4,2762,39,21,18
2,4,2640,34,15,19
2,4,1333,60,33,27
2,4,2051,20,10,10
2,4,2923,43,15,28
2,4,2876,39,20,19
2,4,1957,28,15,13
2,4,2316,157,80,77
2,4,2562,15,5,10
2,4,1491,6,3,3
2,5,5258,98,55,43
2,5,2741,7,3,4
2,5,7466,47,28,19
2,5,7373,48,22,26
2,5,10724,91,44,47
2,5,4051,104,50,54
2,5,3614,32,20,12
2,5,2383,45,19,26
2,5,686,51,20,31
2,5,762,30,14,16
2,5,1652,34,17,17
2,5,1139,52,26,26
2,5,5438,215,110,105
2,5,1855,130,64,66
2,5,1466,52,31,21
2,4,1669,12,6,6
2,4,1432,11,5,6
2,4,2450,39,21,18
2,4,2066,26,17,9
2,4,899,6,2,4
2,4,5556,21,12,9
2,4,3903,41,18,23
2,4,3160,31,18,13
2,4,3260,4,1,3
2,4,5074,39,20,19
2,4,10918,199,88,111
2,5,1234,22,12,10
2,5,3735,16,4,12
2,5,13021,1404,660,744
2,5,16707,267,125,142
2,5,5040,152,58,94
2,4,756,18,11,7
2,4,3929,21,11,10
2,4,768,3,1,2
2,4,3846,23,11,12
2,4,1539,13,4,9
2,4,1224,8,4,4
2,4,966,12,5,7
2,4,845,23,14,9
2,4,710,14,7,7
2,4,1047,50,28,22
2,4,1711,54,24,30
2,4,1042,8,2,6
2,4,1052,15,8,7
2,4,1127,13,4,9
2,4,1097,1,0,1
2,4,1166,10,4,6
2,4,897,23,12,11
2,4,799,5,1,4
2,4,921,22,10,12
2,4,2658,5,1,4
2,4,2287,20,7,13
2,4,2241,43,21,22
2,4,5419,26,13,13
2,4,861,2,1,1
2,4,1225,18,12,6
2,4,1687,14,6,8
2,4,1708,20,10,10
2,4,2457,210,92,118
2,4,4652,441,221,220
2,4,5970,64,38,26
2,4,1410,31,14,17
2,4,2750,352,178,174
2,4,1456,8,2,6
2,4,958,0,0,0
2,4,844,0,0,0
2,4,891,7,5,2
2,4,946,24,14,10
2,4,7190,95,42,53
2,4,2370,60,37,23
2,4,1313,40,14,26
2,4,1077,35,15,20
2,4,1284,21,13,8
2,4,1796,18,12,6
2,4,511,5,3,2
2,4,1943,38,21,17
2,4,822,6,3,3
2,4,1613,4,1,3
2,4,2306,87,33,54
2,4,1873,33,20,13
2,4,3456,70,38,32
2,4,5595,36,19,17
2,4,3719,45,19,26
2,4,4075,53,26,27
2,4,907,7,4,3
2,4,6452,80,41,39
2,4,759,6,4,2
2,4,1539,13,8,5
2,4,1717,19,10,9
2,4,1931,76,42,34
2,4,1090,7,1,6
2,4,1136,10,6,4
2,4,1126,16,4,12
2,5,2947,50,22,28
2,5,758,11,6,5
2,5,3250,55,26,29
2,5,1065,41,21,20
2,5,6681,236,121,115
2,5,4218,38,18,20
2,4,959,13,7,6
2,4,792,16,9,7
2,4,1792,57,21,36
2,4,1221,5,1,4
2,4,1054,5,1,4
2,4,903,29,12,17
2,4,1233,15,4,11
2,4,688,2,0,2
2,4,912,3,1,2
2,4,1197,1,1,0
2,4,986,3,1,2
2,4,1403,8,5,3
2,4,1189,4,1,3
2,4,1830,62,31,31
2,4,631,17,7,10
2,4,2771,32,15,17
2,4,465,49,23,26
2,4,5210,56,27,29
2,4,1265,4,3,1
2,4,1688,35,16,19
2,4,1805,10,5,5
2,4,1176,10,2,8
2,4,1058,11,5,6
2,4,1021,20,14,6
2,4,912,17,7,10
2,4,1261,21,14,7
2,4,1163,13,4,9
2,4,1260,6,3,3
2,4,1176,28,14,14
2,4,935,7,4,3
2,4,1316,2,0,2
2,4,1155,24,14,10
2,4,1115,26,14,12
2,4,1012,18,12,6
2,4,1309,37,19,18
2,4,1193,12,4,8
2,4,1525,15,4,11
2,4,728,4,2,2
2,4,1249,22,8,14
2,4,1049,42,27,15
2,4,1203,20,12,8
2,4,1732,11,3,8
2,4,2506,126,50,76
2,4,2068,91,39,52
2,4,2195,13,7,6
2,4,1963,25,10,15
2,4,2669,14,5,9
2,4,1806,25,13,12
2,4,1989,13,6,7
2,4,1778,3,0,3
2,4,1333,19,10,9
2,4,995,79,37,42
2,4,1811,20,6,14
2,4,1951,2,1,1
2,4,1262,22,8,14
2,4,2053,2,0,2
2,4,3889,36,18,18
2,4,2058,8,6,2
2,4,1278,14,8,6
2,4,2192,40,19,21
2,4,1711,15,7,8
2,4,1219,25,11,14
2,4,1655,10,5,5
2,4,1214,19,12,7
2,4,1322,20,11,9
2,4,1518,24,9,15
2,4,1705,40,22,18
2,4,1356,39,18,21
2,4,2315,45,27,18
2,4,1399,10,6,4
2,4,1751,22,13,9
2,4,1128,14,4,10
2,4,892,5,4,1
2,4,1251,3,2,1
2,4,1124,5,5,0
2,4,4652,81,35,46
2,4,1531,1,0,1
2,4,2213,30,14,16
2,4,1935,2,1,1
2,4,1716,5,3,2
2,4,1421,8,2,6
2,4,2127,92,42,50
2,4,1389,8,2,6
2,4,1094,7,2,5
2,4,1077,9,3,6
2,4,921,10,4,6
2,4,1090,26,9,17
2,4,1051,8,6,2
2,4,1050,18,11,7
2,4,847,9,2,7
2,4,919,3,1,2
2,4,1307,4,2,2
2,4,878,16,6,10
2,4,576,6,3,3
2,4,1046,14,3,11
2,4,821,6,3,3
2,4,839,2,0,2
2,4,703,1,0,1
2,4,1465,2,0,2
2,4,1150,7,3,4
2,4,1420,13,5,8
2,4,984,14,5,9
2,4,840,4,2,2
2,4,607,7,2,5
2,4,765,3,2,1
2,4,1101,8,1,7
2,4,802,4,1,3
2,4,1399,5,3,2
2,4,182,4,3,1
2,4,2129,21,10,11
2,4,1472,26,15,11
2,4,1090,17,10,7
2,4,6421,112,62,50
2,4,1038,13,9,4
2,4,990,11,5,6
2,4,1534,8,3,5
2,4,969,24,13,11
2,4,1450,5,2,3
2,4,1176,30,14,16
2,4,1137,3,3,0
2,4,1289,1,1,0
2,4,604,32,17,15
2,4,1617,12,3,9
2,4,958,11,6,5
2,4,4626,69,35,34
2,4,25836,223,100,123
2,4,11995,171,74,97
2,4,1441,38,23,15
2,4,1035,56,28,28
2,4,1351,26,17,9
2,4,1253,12,8,4
2,4,2208,48,27,21
2,4,1442,7,3,4
2,4,805,35,21,14
2,4,833,95,49,46
2,4,908,1,1,0
2,4,474,1,1,0
2,4,967,4,4,0
2,4,1114,6,4,2
2,4,829,0,0,0
2,4,556,1,1,0
2,4,774,2,2,0
2,4,817,87,36,51
2,4,1061,4,3,1
2,4,775,5,3,2
2,4,2848,23,14,9
2,4,1330,250,124,126
2,4,1171,7,2,5
2,4,1950,33,18,15
2,4,4548,150,63,87
2,4,3685,37,20,17
2,4,1972,16,8,8
2,4,1832,46,18,28
2,4,1453,8,4,4
2,4,1615,5,3,2
2,4,2385,25,11,14
2,4,2041,4,2,2
2,4,1374,5,3,2
2,4,2374,19,11,8
2,4,1406,9,5,4
2,4,1083,10,5,5
2,4,818,2,1,1
2,4,666,19,13,6
2,4,796,7,5,2
2,4,1146,15,7,8
2,4,1321,7,5,2
2,4,942,0,0,0
2,4,1152,12,5,7
2,4,1091,0,0,0
2,4,967,5,2,3
2,4,879,2,0,2
2,4,799,7,4,3
2,4,922,0,0,0
2,4,679,2,2,0
2,4,860,3,0,3
2,4,719,2,0,2
2,4,901,7,1,6
2,4,675,8,3,5
2,4,657,2,0,2
2,4,868,4,2,2
2,4,945,1,0,1
2,4,1216,1,0,1
2,4,613,5,1,4
2,4,754,3,1,2
2,4,778,1,1,0
2,4,710,57,27,30
2,4,613,4,0,4
2,4,796,47,22,25
2,4,832,21,8,13
2,4,705,19,9,10
2,4,826,1,0,1
2,4,958,25,13,12
2,4,698,2,0,2
2,4,904,4,2,2
2,4,930,14,9,5
2,4,871,29,18,11
2,4,614,0,0,0
2,4,1017,67,37,30
2,4,589,3,2,1
2,4,1088,17,9,8
2,4,466,13,4,9
2,4,680,16,8,8
2,4,1091,21,9,12
2,4,700,10,3,7
2,4,983,18,10,8
2,4,673,5,3,2
2,4,962,14,6,8
2,4,1066,15,9,6
2,4,706,1,0,1
2,4,870,0,0,0
2,4,1305,10,4,6
2,4,1136,4,0,4
2,4,2493,25,11,14
2,4,1403,10,5,5
2,4,867,4,2,2
2,4,678,13,5,8
2,4,497,0,0,0
2,4,1414,11,5,6
2,4,985,22,9,13
2,4,1352,8,5,3
2,4,998,13,6,7
2,4,1180,22,8,14
2,4,891,5,2,3
2,4,929,48,26,22
2,4,902,15,9,6
2,4,814,8,5,3
2,4,1365,12,5,7
2,4,1195,8,4,4
2,4,1084,4,2,2
2,4,1295,19,6,13
2,4,1125,27,15,12
2,4,1412,21,14,7
2,4,773,18,9,9
2,4,1027,18,9,9
2,4,1088,36,24,12
2,4,1108,5,1,4
2,4,484,4,1,3
2,4,845,15,9,6
2,4,1277,7,3,4
2,4,1228,5,3,2
2,4,746,9,3,6
2,4,2089,63,35,28
2,4,1095,220,113,107
2,4,399,1,0,1
2,4,915,98,54,44
2,4,1762,27,12,15
2,4,2399,28,8,20
2,4,1104,13,7,6
2,4,454,0,0,0
2,4,337,1,1,0
2,4,5722,58,27,31
2,4,1165,17,8,9
2,4,1448,14,7,7
2,4,1104,20,10,10
2,4,1928,17,9,8
2,4,1348,10,4,6
2,4,1538,15,10,5
2,4,1694,17,6,11
2,4,3030,45,22,23
2,4,2120,33,19,14
2,4,1769,8,5,3
2,4,1555,34,19,15
2,4,1140,5,3,2
2,4,1099,51,18,33
2,4,968,9,4,5
2,4,1624,21,4,17
2,4,976,14,8,6
2,4,1196,77,33,44
2,2,2350,112,52,60
2,2,858,0,0,0
2,2,2037,48,20,28
2,2,1699,5,0,5
2,2,1007,3,2,1
2,2,1889,35,15,20
2,2,1778,11,1,10
2,2,1406,4,2,2
2,2,1930,28,11,17
2,2,2186,5,3,2
2,2,1801,12,5,7
2,2,2083,40,22,18
2,2,1573,3,0,3
2,2,1467,2,1,1
2,2,1529,6,2,4
2,2,2107,9,4,5
2,2,2162,11,4,7
2,2,1724,11,3,8
2,2,1491,10,6,4
2,2,1191,3,1,2
2,2,1511,15,6,9
2,2,1597,24,14,10
2,2,1500,19,9,10
2,2,1882,18,9,9
2,2,1529,17,7,10
2,2,1744,96,43,53
2,2,1364,6,2,4
2,2,1346,20,11,9
2,2,1368,22,9,13
2,2,1901,30,17,13
2,2,1659,10,5,5
2,2,1046,37,21,16
2,2,2146,44,22,22
2,2,1704,8,4,4
2,2,1811,8,5,3
2,2,3864,14,8,6
2,4,1830,28,11,17
2,4,878,22,6,16
2,4,867,2,1,1
2,4,1241,6,5,1
2,4,869,4,1,3
2,4,1104,24,11,13
2,4,746,4,3,1
2,4,1043,10,7,3
2,4,561,15,11,4
2,4,876,1,1,0
2,4,938,26,13,13
2,4,1384,16,7,9
2,4,772,5,1,4
2,4,622,2,2,0
2,4,1054,6,4,2
2,4,1238,23,8,15
2,4,1408,13,6,7
2,4,981,7,4,3
2,4,1212,20,6,14
2,4,942,4,2,2
2,4,695,16,7,9
2,4,980,10,4,6
2,4,893,6,3,3
2,4,570,6,2,4
2,4,2051,19,6,13
2,4,498,22,9,13
2,4,668,28,16,12
2,4,896,1,0,1
2,4,482,5,3,2
2,4,1354,18,9,9
2,4,1236,11,7,4
2,4,332,0,0,0
2,4,609,22,6,16
2,4,883,7,3,4
2,4,1038,5,2,3
2,4,1098,3,1,2
2,4,711,12,5,7
2,4,441,9,4,5
2,4,1184,36,19,17
2,4,717,1,0,1
2,4,812,4,1,3
2,4,776,14,4,10
2,4,1366,12,5,7
2,4,949,35,16,19
2,4,605,2,0,2
2,4,727,2,1,1
2,4,481,17,7,10
2,4,1170,15,8,7
2,4,918,7,3,4
2,4,1317,11,4,7
2,4,661,0,0,0
2,4,466,2,2,0
2,4,860,5,2,3
2,4,841,2,1,1
2,4,996,5,1,4
2,4,1124,16,7,9
2,4,1280,2,1,1
2,4,1138,6,4,2
2,4,721,12,5,7
2,4,1074,11,4,7
2,4,3987,38,11,27
2,4,1820,104,53,51
2,4,936,2,0,2
2,4,1441,13,8,5
2,4,736,16,9,7
2,4,548,39,19,20
2,4,1055,1,0,1
2,4,848,32,16,16
2,4,1039,841,417,424
2,4,629,0,0,0
2,4,851,3,3,0
2,4,1472,10,5,5
2,4,1088,30,13,17
2,4,540,4,3,1
2,4,575,28,10,18
2,4,449,7,1,6
2,4,782,15,8,7
2,4,667,7,4,3
2,4,768,31,11,20
2,4,647,6,2,4
2,4,352,4,2,2
2,4,824,2,1,1
2,4,142,3,1,2
2,4,1195,28,13,15
2,4,772,20,10,10
2,4,808,38,22,16
2,4,1063,7,2,5
2,4,855,16,7,9
2,4,409,14,7,7
2,4,888,16,7,9
2,4,576,6,4,2
2,4,770,12,5,7
2,4,649,23,13,10
2,4,465,2,0,2
2,4,1448,2,0,2
2,4,680,11,6,5
2,4,1716,1,1,0
2,4,29235,379,182,197
2,4,570,6,2,4
2,4,1534,7,3,4
2,4,1128,4,1,3
2,4,507,16,4,12
2,4,2972,401,203,198
2,4,494,6,2,4
2,4,1127,3,2,1
2,4,2220,150,77,73
2,4,1329,9,4,5
2,4,1797,13,9,4
2,4,49997,1530,720,810
2,4,1090,36,17,19
2,4,343,4,2,2
2,4,952,0,0,0
2,4,4154,45,18,27
2,4,1837,33,14,19
2,4,3388,29,9,20
2,4,694,3,2,1
2,4,712,2,1,1
2,4,807,8,5,3
2,4,3039,32,18,14
2,4,661,5,2,3
2,4,1661,313,155,158
2,4,1566,18,7,11
2,4,7606,98,42,56
2,4,685,7,3,4
2,4,760,4,1,3
2,4,755,411,211,200
2,4,6192,61,24,37
2,4,570,111,61,50
2,4,585,2,1,1
2,2,20828,202,91,111
2,2,735,12,6,6
2,2,1274,12,4,8
2,2,1534,37,20,17
2,2,946,13,4,9
2,2,739,5,2,3
2,2,1390,6,2,4
2,2,716,18,10,8
2,2,822,5,1,4
2,2,298,1,1,0
2,2,837,6,2,4
2,2,786,23,11,12
2,2,1053,4,1,3
2,2,747,6,2,4
2,2,651,12,4,8
2,2,672,2,1,1
2,2,930,38,24,14
2,2,762,1,1,0
2,2,1181,21,12,9
2,2,832,0,0,0
2,2,858,0,0,0
2,2,988,55,27,28
2,2,982,0,0,0
2,2,552,4,2,2
2,2,1227,9,3,6
2,2,963,3,2,1
2,2,905,6,0,6
2,2,1072,14,8,6
2,2,910,3,2,1
2,2,1008,0,0,0
2,2,751,2,2,0
2,2,857,2,1,1
2,2,934,1,0,1
2,2,1278,12,7,5
2,2,979,10,4,6
2,2,1168,15,7,8
2,2,918,9,4,5
2,2,1088,5,1,4
2,2,840,6,3,3
2,2,3739,28,14,14
2,1,1374,23,10,13
2,1,1814,112,52,60
2,1,1150,9,6,3
2,1,1480,30,16,14
2,1,2383,44,22,22
2,1,1577,12,7,5
2,1,1286,46,20,26
2,1,1360,86,42,44
2,1,1658,39,23,16
2,1,1444,20,13,7
2,1,1607,112,45,67
2,1,1126,29,15,14
2,1,1123,6,1,5
2,1,1448,21,5,16
2,1,1143,13,4,9
2,1,1790,8,3,5
2,1,731,46,25,21
2,1,1079,8,2,6
2,1,508,5,3,2
2,1,699,5,2,3
2,1,607,0,0,0
2,4,2046,8,5,3
2,4,5754,150,77,73
2,4,1627,16,4,12
2,4,912,4,0,4
2,4,745,5,4,1
2,4,2376,90,45,45
2,4,685,5,2,3
2,4,3303,33,11,22
2,4,1605,7,4,3
2,4,674,5,2,3
2,4,1007,22,9,13
2,4,706,9,4,5
2,4,908,9,5,4
2,4,741,0,0,0
2,4,730,16,5,11
2,4,775,1,1,0
2,4,721,13,7,6
2,4,511,3,1,2
2,4,825,6,3,3
2,4,870,0,0,0
2,4,437,7,4,3
2,4,883,8,2,6
2,4,745,3,2,1
2,4,1968,28,11,17
2,4,654,2,2,0
2,4,827,2,1,1
2,4,997,10,5,5
2,4,797,2,0,2
2,4,533,3,1,2
2,4,684,4,1,3
2,4,1160,0,0,0
2,4,937,6,4,2
2,4,1031,6,1,5
2,4,790,1,1,0
2,4,943,3,1,2
2,4,1463,4,3,1
2,4,728,5,2,3
2,4,656,7,3,4
2,4,1900,35,18,17
2,4,1379,37,15,22
2,4,727,14,6,8
2,4,938,14,5,9
2,4,909,13,2,11
2,4,484,3,2,1
2,4,210,0,0,0
2,4,438,0,0,0
2,4,628,0,0,0
2,4,652,5,3,2
2,4,701,1,1,0
2,4,708,3,2,1
2,4,76,0,0,0
2,4,939,3,1,2
2,4,310,1,1,0
2,4,739,3,1,2
2,4,903,8,3,5
2,4,590,5,3,2
2,4,406,1,0,1
2,4,0,0,0,0
2,4,728,1,1,0
2,4,579,2,0,2
2,4,490,2,0,2
2,4,521,2,2,0
2,4,571,4,2,2
2,4,542,11,5,6
2,4,482,11,7,4
2,4,509,17,9,8
2,4,595,19,7,12
2,4,1180,2,1,1
2,4,795,17,6,11
2,4,1312,23,9,14
2,4,7492,86,40,46
2,4,2169,65,32,33
2,4,1451,33,17,16
2,4,1841,31,15,16
2,4,1315,81,41,40
2,2,1344,3,2,1
2,2,2872,18,11,7
2,2,902,0,0,0
2,2,1203,2,0,2
2,2,3288,8,3,5
2,2,3213,14,8,6
2,2,2955,4,2,2
2,2,1878,18,13,5
2,2,2791,13,10,3
2,2,3237,8,3,5
2,2,1758,9,7,2
2,2,1327,6,2,4
2,2,1835,7,3,4
2,2,2005,14,9,5
2,2,2049,23,9,14
2,2,2113,11,3,8
2,2,1502,12,8,4
2,2,2579,9,4,5
2,2,1742,13,5,8
2,2,1695,1,1,0
2,2,2162,5,2,3
2,2,1191,2,0,2
2,2,1896,21,4,17
2,2,1763,5,1,4
2,2,1470,8,3,5
2,2,2748,31,13,18
2,2,1410,0,0,0
2,3,424,0,0,0
2,3,490,1,1,0
2,3,9,0,0,0
2,3,259,1,1,0
2,1,5,0,0,0
2,2,1,-6,-6,-6
2,1,3369,48,24,24
2,1,3562,42,23,19
2,1,3887,79,39,40
2,1,3857,922,466,456
2,1,3281,10,3,7
2,1,4157,70,34,36
2,1,2350,34,17,17
2,1,2828,55,27,28
2,1,2922,27,10,17
2,1,1636,13,4,9
2,1,3766,154,74,80
2,1,3105,134,75,59
2,1,2548,20,9,11
2,1,4242,85,42,43
2,1,2946,62,30,32
2,4,1414,10,4,6
2,4,4496,9,3,6
2,4,3412,21,5,16
2,4,2686,18,6,12
2,4,2429,41,20,21
2,4,2889,115,61,54
2,4,2104,25,13,12
2,4,3048,50,23,27
2,4,2200,28,7,21
2,4,4236,74,8,66
2,4,3189,41,17,24
2,4,3392,51,26,25
2,4,3782,378,182,196
2,4,5146,200,104,96
2,4,1661,76,36,40
2,4,3054,57,23,34
2,4,4151,49,25,24
2,4,777,15,7,8
2,4,2552,45,15,30
2,4,959,86,43,43
2,4,1698,9,6,3
2,4,930,50,22,28
2,4,2568,25,13,12
2,4,4365,59,29,30
2,4,4680,77,31,46
2,4,5282,197,92,105
2,4,6942,82,40,42
2,4,2872,383,202,181
2,4,2573,54,27,27
2,4,5467,131,65,66
2,4,2431,53,25,28
2,4,2158,64,27,37
2,4,860,0,0,0
2,4,1447,14,4,10
2,4,3013,32,14,18
2,4,2403,18,11,7
2,4,2134,5,4,1
2,4,5389,83,41,42
2,4,1320,5,3,2
2,4,3222,52,25,27
2,4,692,1,1,0
2,4,1891,66,28,38
2,4,3314,159,82,77
2,1,1732,6,3,3
2,1,3373,72,40,32
2,1,869,11,8,3
2,1,3189,13,8,5
2,4,2775,11,4,7
2,4,1516,6,5,1
2,4,2160,13,6,7
2,4,5534,71,30,41
2,4,2372,44,25,19
2,4,4760,88,48,40
2,3,1767,8,6,2
2,3,3096,26,14,12
2,3,3752,46,20,26
2,3,1735,12,5,7
2,4,4601,199,97,102
2,4,2460,6,5,1
2,4,3797,33,16,17
2,4,2694,2,1,1
2,4,3964,27,11,16
2,4,1419,5,2,3
3,1,936,17,10,7
3,1,746,5,3,2
3,1,2408,26,11,15
3,1,611,3,2,1
3,1,1021,10,2,8
3,1,946,16,9,7
3,1,1545,5,3,2
3,1,436,4,2,2
3,1,405,4,2,2
3,1,804,0,0,0
3,1,493,1,1,0
3,1,332,6,1,5
3,1,1420,15,4,11
3,1,2328,30,19,11
3,1,637,6,3,3
3,1,1222,8,4,4
3,1,568,8,4,4
3,1,1662,17,7,10
3,1,1152,12,6,6
3,1,1552,12,6,6
3,1,1313,21,9,12
3,1,3345,28,14,14
3,1,981,21,9,12
3,1,1033,39,16,23
3,1,1047,12,3,9
3,1,1152,32,16,16
3,1,1330,3,1,2
3,1,4917,27,12,15
3,1,2457,30,14,16
3,1,2465,13,10,3
3,1,1215,5,2,3
3,1,1536,28,11,17
3,1,374,15,8,7
3,1,929,106,48,58
3,1,213,0,0,0
3,1,287,0,0,0
3,1,297,0,0,0
3,1,463,37,15,22
3,1,142,0,0,0
3,1,907,33,15,18
3,1,1280,49,19,30
3,1,1674,1,1,0
3,1,1038,1,0,1
3,1,934,2,1,1
3,1,1027,7,3,4
3,1,929,3,2,1
3,1,1640,3,3,0
3,1,1551,4,2,2
3,1,91,0,0,0
3,1,189,0,0,0
3,1,326,5,1,4
3,1,545,1,0,1
3,1,277,2,0,2
3,1,1351,23,12,11
3,1,429,0,0,0
3,1,840,1,1,0
3,1,820,7,5,2
3,1,567,2,1,1
3,1,1679,11,6,5
3,1,1370,3,1,2
3,1,2907,10,2,8
3,1,55,0,0,0
3,1,27,0,0,0
3,1,96,0,0,0
3,1,604,2,0,2
3,1,401,2,2,0
3,1,525,0,0,0
3,1,646,2,1,1
3,1,152,0,0,0
3,1,523,0,0,0
3,1,740,5,2,3
3,1,137,1,0,1
3,2,2058,12,5,7
3,2,1856,4,4,0
3,2,1098,4,2,2
3,2,1652,3,1,2
3,2,1012,6,3,3
3,2,1404,7,3,4
3,2,411,3,1,2
3,2,938,3,2,1
3,2,4107,9,1,8
3,2,367,1,1,0
3,2,1692,6,2,4
3,2,138,1,0,1
3,2,319,3,2,1
3,2,1503,15,2,13
3,2,953,2,1,1
3,2,594,10,5,5
3,2,1278,40,18,22
3,2,522,3,1,2
3,2,599,2,1,1
3,2,5330,63,32,31
3,2,1078,26,10,16
3,2,1754,53,28,25
3,2,1551,15,9,6
3,2,2762,40,21,19
3,2,501,11,4,7
3,2,172,5,4,1
3,2,2477,54,25,29
3,2,835,3,1,2
3,2,15086,684,325,359
3,2,268,3,1,2
3,2,339,3,0,3
3,2,1385,25,11,14
3,2,685,1,0,1
3,2,298,1,0,1
3,2,397,4,1,3
3,2,524,2,1,1
3,2,719,2,1,1
3,2,1017,6,3,3
3,2,241,0,0,0
3,2,1457,1,1,0
3,2,575,0,0,0
3,2,632,11,8,3
3,2,580,2,1,1
3,2,984,4,2,2
3,3,1629,18,10,8
3,3,891,71,34,37
3,3,986,12,8,4
3,3,1153,46,26,20
3,3,533,16,8,8
3,3,790,61,30,31
3,3,804,11,5,6
3,3,777,0,0,0
3,3,1189,17,9,8
3,3,436,1,0,1
3,3,717,4,2,2
3,3,473,4,0,4
3,3,521,3,2,1
3,3,422,1,1,0
3,3,1222,28,14,14
3,3,797,10,5,5
3,3,822,4,2,2
3,3,567,3,3,0
3,3,548,7,4,3
3,3,534,20,8,12
3,3,940,81,37,44
3,3,1378,28,15,13
3,3,2659,16,6,10
3,3,1927,22,12,10
3,3,761,28,14,14
3,3,672,6,3,3
3,3,756,11,4,7
3,3,527,9,5,4
3,3,675,1,0,1
3,3,683,1,1,0
3,3,825,10,5,5
3,3,1120,49,24,25
3,3,2476,78,43,35
3,3,1341,12,8,4
3,3,1154,17,9,8
3,3,6472,75,35,40
3,3,1220,36,16,20
3,3,960,31,17,14
3,3,489,6,1,5
3,3,459,5,1,4
3,3,566,2,1,1
3,3,821,23,10,13
3,3,686,9,5,4
3,3,852,6,2,4
3,3,917,15,8,7
3,3,656,21,11,10
3,3,1103,21,9,12
3,3,1000,16,6,10
3,3,934,30,13,17
3,3,538,3,1,2
3,3,624,6,2,4
3,3,703,3,1,2
3,3,1031,75,40,35
3,3,1057,9,4,5
3,3,1535,24,10,14
3,3,589,1,1,0
3,3,644,7,3,4
3,3,527,1,1,0
3,3,1067,29,12,17
3,3,1028,18,9,9
3,3,1453,42,20,22
3,3,1043,1,0,1
3,3,882,2,0,2
3,3,293,28,13,15
3,3,708,28,12,16
3,3,807,63,33,30
3,3,808,18,9,9
3,3,739,19,14,5
3,3,1070,24,15,9
3,3,1282,7,4,3
3,3,998,29,15,14
3,3,802,18,10,8
3,3,1005,7,2,5
3,3,615,9,4,5
3,3,629,2,1,1
3,3,915,9,3,6
3,3,2003,11,8,3
3,3,676,9,3,6
3,3,602,6,2,4
3,3,784,11,8,3
3,3,551,3,1,2
3,3,1843,24,14,10
3,3,1027,5,1,4
3,3,1009,5,2,3
3,3,758,1,0,1
3,3,4092,58,23,35
3,3,912,6,1,5
3,3,890,41,26,15
3,3,2495,94,47,47
3,3,4872,138,65,73
3,3,1429,13,5,8
3,3,1186,35,18,17
3,3,1369,17,6,11
3,3,1069,8,5,3
3,3,847,11,5,6
3,3,605,0,0,0
3,3,4573,94,47,47
3,3,3748,93,52,41
3,3,1274,16,7,9
3,3,1254,9,4,5
3,3,927,34,16,18
3,3,1108,9,4,5
3,3,1749,15,8,7
3,3,624,11,8,3
3,3,566,15,9,6
3,3,1330,26,14,12
3,3,1575,52,27,25
3,3,2248,62,36,26
3,3,754,8,4,4
3,3,761,10,4,6
3,3,540,35,21,14
3,3,783,176,86,90
3,3,426,3,1,2
3,3,1307,15,5,10
3,3,1034,25,10,15
3,3,450,4,1,3
3,3,1166,49,29,20
3,3,835,49,25,24
3,3,1235,46,21,25
3,3,567,4,3,1
3,3,672,4,2,2
3,3,1015,35,14,21
3,3,636,8,3,5
3,3,713,23,13,10
3,3,563,5,4,1
3,3,944,1,0,1
3,3,1012,0,0,0
3,3,790,8,3,5
3,3,879,5,1,4
3,3,1128,118,65,53
3,3,574,1,0,1
3,3,404,0,0,0
3,3,2716,66,28,38
3,3,3932,121,55,66
3,3,1362,7,4,3
3,3,427,2,1,1
3,3,145,0,0,0
3,3,213,0,0,0
3,3,664,4,3,1
3,3,207,0,0,0
3,3,262,0,0,0
3,3,164,0,0,0
3,3,475,0,0,0
3,3,740,17,8,9
3,3,1737,49,6,43
3,3,312,3,1,2
3,3,1674,3,2,1
3,3,3083,8,2,6
3,3,661,2,1,1
3,3,356,0,0,0
3,3,179,0,0,0
3,3,3027,196,98,98
3,3,491,0,0,0
3,3,638,74,40,34
3,3,2143,17,9,8
3,3,67,1,0,1
3,3,2080,73,31,42
3,3,3076,45,18,27
3,3,2246,54,20,34
3,3,4867,48,17,31
3,3,65,4,2,2
3,3,194,0,0,0
3,3,223,2,1,1
3,3,2097,36,18,18
3,3,2520,18,7,11
3,4,1024,6,3,3
3,4,1801,23,12,11
3,4,343,4,1,3
3,4,997,52,29,23
3,4,2351,41,20,21
3,4,2299,40,20,20
3,4,1553,10,5,5
3,4,1155,22,10,12
3,4,27188,834,377,457
3,4,1649,56,30,26
3,4,6172,145,63,82
3,4,787,15,9,6
3,4,731,1,0,1
3,4,2501,8,4,4
3,4,1389,0,0,0
3,4,1727,6,5,1
3,4,261,1,1,0
3,4,1915,335,157,178
3,4,746,37,22,15
3,4,5129,245,117,128
3,4,906,9,6,3
3,4,13396,218,105,113
3,4,2261,21,6,15
3,4,19545,463,227,236
3,4,675,9,4,5
3,4,6413,59,26,33
3,4,2234,146,58,88
3,4,1057,144,74,70
3,4,505,25,14,11
3,4,1817,115,43,72
3,4,1575,289,146,143
3,4,1177,59,28,31
3,4,1231,99,41,58
3,4,2331,126,47,79
3,4,2755,413,178,235
3,4,947,25,8,17
3,4,974,92,34,58
3,4,2563,118,57,61
3,4,1307,65,34,31
3,4,4489,137,63,74
3,4,14313,632,301,331
3,4,4177,245,102,143
3,4,401,1,0,1
3,4,453,18,9,9
3,4,627,78,44,34
3,5,5986,125,56,69
3,5,4858,134,62,72
3,5,1219,12,5,7
3,5,861,27,13,14
3,5,915,1,0,1
3,5,941,3,2,1
3,5,1785,45,17,28
3,5,383,60,26,34
3,5,724,22,12,10
3,5,282,5,1,4
3,3,524,25,8,17
3,3,651,25,5,20
3,3,488,4,1,3
3,4,382,35,21,14
3,4,462,20,11,9
3,4,16114,654,314,340
3,4,3898,85,40,45
3,4,2339,33,16,17
3,4,2013,159,71,88
3,4,760,61,29,32
3,4,3259,349,186,163
3,4,3861,176,83,93
3,4,2900,84,35,49
3,4,8374,345,165,180
3,4,8275,569,273,296
3,4,2795,478,242,236
3,4,595,74,37,37
3,4,1702,439,205,234
3,4,1939,727,355,372
3,4,1438,22,11,11
3,4,1684,135,68,67
3,4,2807,220,100,120
3,4,1242,63,34,29
3,4,1213,163,75,88
3,4,1850,226,104,122
3,4,1619,285,131,154
3,4,2063,407,192,215
3,4,5346,1578,781,797
3,4,1688,277,123,154
3,4,4660,244,123,121
3,4,526,5,2,3
3,4,376,19,11,8
3,4,6784,377,184,193
3,4,804,55,24,31
3,4,1260,232,93,139
3,4,1315,75,33,42
3,4,1086,19,7,12
3,4,2218,78,40,38
3,4,2318,132,63,69
3,4,1045,15,5,10
3,4,2319,35,13,22
3,4,991,90,41,49
3,4,1001,124,62,62
3,4,626,53,22,31
3,4,471,23,13,10
3,4,992,22,11,11
3,4,5474,313,135,178
3,4,1321,158,87,71
3,4,5811,159,80,79
3,4,3257,141,74,67
3,4,1177,59,31,28
3,4,769,20,8,12
3,4,537,44,23,21
3,4,3191,70,34,36
3,4,2830,64,26,38
3,4,1276,36,10,26
3,4,1755,33,13,20
3,4,2761,46,23,23
3,4,2209,181,86,95
3,4,2662,87,39,48
3,4,1631,69,30,39
3,4,1082,24,10,14
3,4,1609,103,42,61
3,4,3133,44,17,27
3,4,13402,485,221,264
3,4,2241,53,28,25
3,4,2015,11,6,5
3,4,1404,10,1,9
3,4,1324,6,4,2
3,4,1267,8,1,7
3,4,1151,7,3,4
3,4,1288,10,3,7
3,4,1144,2,1,1
3,4,1229,1,0,1
3,4,1317,24,12,12
3,4,1265,9,4,5
3,4,1361,14,5,9
3,4,1392,5,1,4
3,4,1193,29,14,15
3,4,1243,18,9,9
3,4,1154,48,27,21
3,4,1434,51,26,25
3,4,1000,6,1,5
3,4,1251,65,28,37
3,4,1395,44,23,21
3,4,1365,24,10,14
3,4,1343,17,6,11
3,4,1801,3,0,3
3,4,1340,20,10,10
3,4,922,0,0,0
3,4,1096,64,33,31
3,4,1021,8,3,5
3,3,2474,16,6,10
3,3,833,6,4,2
3,3,1741,28,18,10
3,3,1423,18,7,11
3,3,882,10,6,4
3,3,1288,9,2,7
3,3,5982,235,113,122
3,3,703,8,4,4
3,3,372,0,0,0
3,3,944,11,5,6
3,3,967,125,61,64
3,3,1137,89,36,53
3,3,1256,31,20,11
3,3,947,6,4,2
3,3,880,26,15,11
3,3,928,7,2,5
3,3,342,3,1,2
3,3,552,6,5,1
3,3,1848,70,37,33
3,3,906,7,3,4
3,3,1049,9,3,6
3,3,1388,44,19,25
3,3,1184,51,30,21
3,3,1025,62,36,26
3,3,1194,10,1,9
3,3,2528,72,35,37
3,3,1596,55,34,21
3,3,1215,13,7,6
3,3,1207,11,8,3
3,3,1200,14,8,6
3,3,4319,223,115,108
3,3,1445,14,8,6
3,3,2511,61,26,35
3,3,949,63,26,37
3,3,1132,12,8,4
3,3,5643,51,24,27
3,3,1049,4,2,2
3,3,1203,4,2,2
3,3,1143,37,17,20
3,3,7833,156,70,86
3,3,1291,17,10,7
3,3,1281,45,20,25
3,3,2206,89,48,41
3,3,1159,8,3,5
3,3,5191,201,93,108
3,3,1850,32,16,16
3,3,1265,11,5,6
3,3,3656,66,31,35
3,3,3010,28,16,12
3,3,1680,19,8,11
3,3,1605,14,7,7
3,3,1807,57,10,47
3,3,3248,28,12,16
3,3,1896,13,6,7
3,3,2901,41,17,24
3,3,2863,201,87,114
4,1,663,3,2,1
4,1,807,12,8,4
4,1,773,128,68,60
4,1,17196,477,248,229
4,1,1350,6,3,3
4,1,1619,36,16,20
4,1,1053,53,27,26
4,1,934,11,3,8
4,1,6965,140,73,67
4,1,875,1,1,0
4,1,904,31,16,15
4,1,1742,22,11,11
4,1,2240,78,40,38
4,1,1351,7,3,4
4,1,1575,0,0,0
4,1,1546,33,15,18
4,1,10264,318,175,143
4,1,853,11,5,6
4,1,1447,136,75,61
4,1,1650,201,109,92
4,1,2282,68,37,31
4,1,1180,16,5,11
4,1,1289,20,7,13
4,1,1262,8,3,5
4,1,656,21,9,12
4,1,1187,25,9,16
4,1,1079,23,12,11
4,1,513,12,3,9
4,1,887,32,19,13
4,1,772,7,2,5
4,1,785,6,3,3
4,1,959,5,4,1
4,1,1189,60,28,32
4,1,1640,13,9,4
4,1,1434,103,47,56
4,1,1476,5,3,2
4,1,1354,2,1,1
4,1,1001,17,9,8
4,1,2861,16,7,9
4,1,937,66,35,31
4,1,1030,70,35,35
4,1,1290,4,2,2
4,1,1148,19,12,7
4,1,1043,40,26,14
4,1,933,12,5,7
4,1,1275,31,16,15
4,1,1032,42,27,15
4,1,976,22,9,13
4,1,1213,29,14,15
4,1,606,1,1,0
4,1,1118,26,18,8
4,1,764,11,6,5
4,1,1060,9,5,4
4,1,907,45,29,16
4,1,1348,42,18,24
4,1,1077,27,16,11
4,1,1243,22,13,9
4,1,1343,32,14,18
4,1,1291,19,11,8
4,1,1123,13,6,7
4,1,981,55,21,34
4,1,1412,32,15,17
4,1,1822,55,33,22
4,1,1624,57,32,25
4,1,2511,59,33,26
4,1,1467,52,26,26
4,1,1208,19,9,10
4,1,1823,48,18,30
4,1,1191,5,0,5
4,1,1432,8,4,4
4,1,1132,24,12,12
4,1,1489,48,27,21
4,1,1707,47,23,24
4,1,1296,15,12,3
4,1,2970,56,29,27
4,1,1066,13,7,6
4,1,1146,6,3,3
4,1,1117,12,5,7
4,1,11424,155,78,77
4,1,980,22,13,9
4,1,18461,435,226,209
4,1,1345,93,48,45
4,1,7070,204,114,90
4,1,1193,8,3,5
4,1,1408,12,7,5
4,1,1168,38,20,18
4,1,1131,25,14,11
4,1,752,3,2,1
4,1,1189,33,18,15
4,1,2582,57,28,29
4,1,2676,84,50,34
4,1,1520,36,17,19
4,1,1361,6,2,4
4,1,1846,20,9,11
4,1,2644,16,9,7
4,1,1418,6,3,3
4,1,1500,11,7,4
4,1,994,8,7,1
4,1,1685,20,12,8
4,1,3301,75,35,40
4,1,3140,18,7,11
4,1,2525,41,20,21
4,1,1837,49,21,28
4,1,1140,6,4,2
4,1,11577,207,94,113
4,1,1734,50,37,13
4,1,1837,13,5,8
4,1,4782,133,64,69
4,1,4028,43,23,20
4,1,1889,39,16,23
4,1,2676,72,29,43
4,1,8631,51,29,22
4,1,781,13,5,8
4,1,1400,14,6,8
4,1,1434,31,19,12
4,1,1456,48,19,29
4,1,2059,35,17,18
4,1,1228,109,54,55
4,1,588,1,1,0
4,1,1284,9,4,5
4,1,1715,24,14,10
4,1,2106,16,8,8
4,1,1088,27,13,14
4,1,9146,254,133,121
4,1,2058,12,5,7
4,1,3537,43,19,24
4,1,1182,3,0,3
4,1,293,2,1,1
4,1,2273,76,37,39
4,1,519,6,3,3
4,1,382,0,0,0
4,1,306,0,0,0
4,1,806,4,2,2
4,1,315,0,0,0
4,1,990,0,0,0
4,1,459,0,0,0
4,1,348,0,0,0
4,1,619,2,1,1
4,1,4174,12,4,8
4,1,1276,10,6,4
4,1,1219,7,2,5
4,1,3673,590,306,284
4,1,427,1,0,1
4,1,342,5,1,4
4,1,1157,1,0,1
4,1,787,0,0,0
4,2,2636,61,30,31
4,2,1432,5,4,1
4,2,1297,8,3,5
4,2,947,26,14,12
4,2,1088,1,0,1
4,2,1118,113,56,57
4,2,1306,33,19,14
4,2,2967,126,71,55
4,2,1936,157,85,72
4,2,1275,113,58,55
4,2,968,3,0,3
4,2,1228,2,1,1
4,2,972,23,16,7
4,2,1162,85,44,41
4,2,1026,2,1,1
4,2,1336,1025,508,517
4,2,1120,175,82,93
4,2,1161,8,3,5
4,2,403,0,0,0
4,2,2891,1,0,1
4,2,1786,3,0,3
4,2,1849,8,4,4
4,2,2217,11,7,4
4,2,1421,0,0,0
4,2,1031,0,0,0
4,2,2286,4,1,3
4,12,2673,26,12,14
4,12,1830,11,6,5
4,12,3042,13,3,10
4,12,3831,13,4,9
4,12,2062,75,41,34
4,2,372,3,1,2
4,2,2306,22,12,10
4,12,3135,5,4,1
4,2,816,10,3,7
4,2,261,1,1,0
4,3,9229,137,68,69
4,3,7418,206,119,87
4,3,4381,65,33,32
4,3,2056,16,9,7
4,3,2206,24,10,14
4,3,2427,171,102,69
4,3,2047,99,44,55
4,3,1982,81,39,42
4,3,3223,66,28,38
4,3,1758,75,30,45
4,3,749,9,6,3
4,3,1976,19,7,12
4,3,1746,54,25,29
4,3,1727,33,13,20
4,3,1460,244,124,120
4,3,12,0,0,0
4,3,1651,78,48,30
4,3,1071,11,6,5
4,3,1139,11,5,6
4,3,1926,39,24,15
4,3,1800,46,26,20
4,3,1085,21,10,11
4,3,6345,58,25,33
4,3,3962,66,35,31
4,3,2295,56,27,29
4,3,1930,49,20,29
4,3,1623,51,32,19
4,3,1938,41,26,15
4,3,1355,201,108,93
4,3,876,150,86,64
4,3,893,61,26,35
4,3,1031,85,43,42
4,3,297,27,13,14
4,3,992,147,76,71
4,3,1313,53,31,22
4,3,1948,39,18,21
4,3,719,9,3,6
4,3,1017,14,6,8
4,3,726,77,39,38
4,3,573,3,1,2
4,3,689,42,22,20
4,3,1136,14,8,6
4,3,1436,10,4,6
4,3,1594,41,17,24
4,3,1463,47,17,30
4,3,1212,11,6,5
4,3,9139,172,93,79
4,3,2773,42,25,17
4,3,2423,57,30,27
4,3,2317,34,19,15
4,3,2163,38,22,16
4,3,1616,9,6,3
4,3,1681,13,9,4
4,3,1373,46,28,18
4,3,994,21,13,8
4,3,2211,4,1,3
4,3,1619,2,1,1
4,3,1460,3,2,1
4,3,3289,27,13,14
4,3,12030,399,171,228
4,3,1805,12,3,9
4,3,1479,12,6,6
4,3,1494,18,13,5
4,3,1249,50,31,19
4,3,4827,57,34,23
4,3,3766,50,19,31
4,3,1376,1,1,0
4,3,1257,11,5,6
4,3,1620,12,8,4
4,3,1072,1,0,1
4,3,793,4,1,3
4,3,3401,497,249,248
4,3,4250,285,156,129
4,3,1889,9,4,5
4,3,1764,20,10,10
4,3,1367,52,26,26
4,3,1837,22,8,14
4,3,2145,15,7,8
4,3,1562,5,5,0
4,3,589,18,7,11
4,3,3614,14,9,5
4,3,1909,14,8,6
4,3,4642,5,4,1
4,3,2733,14,9,5
4,3,974,0,0,0
4,3,393,3,1,2
4,3,1075,19,6,13
4,3,582,2,0,2
4,10,1373,26,10,16
4,10,717,355,173,182
4,10,475,3,1,2
4,10,2210,9,5,4
4,10,2836,12,8,4
4,10,2525,15,5,10
4,10,2068,19,11,8
4,10,1427,17,9,8
4,10,2470,26,14,12
4,3,512,2,1,1
4,10,1132,2,1,1
4,10,426,0,0,0
4,10,409,0,0,0
4,10,569,1,0,1
4,10,772,1,1,0
4,10,176,0,0,0
4,10,1259,32,15,17
4,10,754,4,2,2
4,10,1229,29,17,12
4,10,260,1,0,1
4,10,2752,10,5,5
4,10,1021,10,2,8
4,10,908,18,11,7
4,10,1236,15,8,7
4,10,1547,3,0,3
4,10,501,0,0,0
4,10,4079,22,6,16
4,10,414,0,0,0
4,4,1044,85,37,48
4,4,1438,14,10,4
4,4,1917,19,9,10
4,4,1241,49,22,27
4,4,1336,14,4,10
4,4,467,22,12,10
4,4,870,28,20,8
4,4,1198,12,7,5
4,4,1256,6,4,2
4,4,2960,29,12,17
4,4,2291,32,20,12
4,4,1591,19,10,9
4,4,2118,23,12,11
4,4,2193,19,13,6
4,4,3403,13,8,5
4,4,2193,31,21,10
4,4,9393,72,33,39
4,13,2310,10,4,6
4,13,872,2,1,1
4,13,1753,2,1,1
4,13,1241,8,4,4
4,13,1586,28,16,12
4,13,1765,28,18,10
4,13,1078,4,3,1
4,13,2502,1,1,0
4,13,2267,5,3,2
4,4,1247,7,3,4
4,4,1209,1,1,0
4,4,715,9,4,5
4,4,1697,4,0,4
4,4,1667,9,4,5
4,4,953,4,1,3
4,4,1216,25,12,13
4,4,1059,0,0,0
4,4,341,0,0,0
4,4,757,1,1,0
4,4,3181,1,1,0
4,4,1784,6,3,3
4,4,1556,5,2,3
4,4,1387,21,9,12
4,4,975,6,1,5
4,4,1296,2,2,0
4,4,1684,2,1,1
4,4,2042,42,19,23
4,4,911,3,1,2
4,4,1592,8,3,5
4,4,1990,7,5,2
4,4,692,30,14,16
4,4,819,2,1,1
4,4,591,1,0,1
4,4,992,0,0,0
4,4,353,0,0,0
4,9,3191,60,31,29
4,9,998,17,10,7
4,9,389,2,1,1
4,11,1294,8,5,3
4,11,2144,66,32,34
4,9,2041,27,14,13
4,11,1236,21,7,14
4,5,3042,4,1,3
4,5,3729,95,47,48
4,5,1220,24,12,12
4,5,1958,6,1,5
4,5,867,0,0,0
4,5,621,8,6,2
4,5,1100,1,1,0
4,5,1825,2,0,2
4,5,1348,6,3,3
4,5,2094,18,9,9
4,5,1449,8,4,4
4,5,499,5,0,5
4,5,1981,9,6,3
4,5,2154,20,7,13
4,5,1484,4,2,2
4,5,2010,13,6,7
4,5,1976,3,2,1
4,5,2934,4,1,3
4,6,2836,47,20,27
4,6,5517,83,48,35
4,6,1212,13,8,5
4,6,1163,22,11,11
4,6,472,341,148,193
4,6,584,272,145,127
4,6,416,222,108,114
4,6,3320,29,10,19
4,6,1300,3,2,1
4,6,457,10,5,5
4,6,505,0,0,0
4,6,474,0,0,0
4,6,154,0,0,0
4,6,1008,0,0,0
4,6,1435,4,0,4
4,6,671,2,0,2
4,6,802,0,0,0
4,6,1113,2,1,1
4,6,645,2,0,2
4,6,2334,2,1,1
4,6,1762,21,10,11
4,6,880,3,1,2
4,6,1837,12,7,5
4,6,1177,8,2,6
4,6,1634,1,0,1
4,6,869,0,0,0
4,6,1076,4,2,2
4,6,662,1,0,1
4,6,1366,24,12,12
4,6,2244,1,1,0
4,6,1288,1,1,0
4,6,511,1,0,1
4,11,240,0,0,0
4,11,450,0,0,0
4,11,2742,60,28,32
4,11,320,0,0,0
4,11,6997,84,45,39
4,11,240,1,1,0
4,11,509,14,10,4
4,11,584,5,2,3
4,11,2738,11,6,5
4,11,1335,1,0,1
4,11,427,0,0,0
4,11,623,2,2,0
4,11,2444,4,2,2
4,11,4225,29,13,16
4,11,3167,12,4,8
4,7,1798,5,3,2
4,7,2961,29,11,18
4,7,362,5,3,2
4,7,849,0,0,0
4,7,467,0,0,0
4,7,593,2,1,1
4,7,298,1,0,1
4,7,345,2,1,1
4,7,132,0,0,0
4,7,1100,17,8,9
4,8,2530,42,24,18
4,8,2218,13,5,8
4,8,2298,25,14,11
4,8,2018,18,3,15
4,8,270,0,0,0
4,8,1096,8,4,4
4,8,116,0,0,0
4,8,492,3,1,2
4,9,6337,72,41,31
4,9,1831,15,9,6
4,9,1939,13,7,6
4,9,2718,12,7,5
4,9,672,13,6,7
4,9,1226,28,15,13
4,9,2696,113,61,52
4,9,2275,16,7,9
4,9,1188,30,13,17
4,9,1115,20,9,11
4,9,1185,62,40,22
4,9,925,61,30,31
4,9,641,2,1,1
4,9,1777,21,12,9
4,9,1587,37,17,20
4,9,1296,34,19,15
4,9,3056,12,5,7
4,9,529,3,1,2
4,9,705,6,2,4
4,9,794,6,3,3
4,9,3400,5,4,1
4,9,972,2,0,2
4,9,1730,2,0,2
4,9,1921,0,0,0
4,3,1426,1,0,1
4,3,1233,0,0,0
4,3,410,1,1,0
4,9,1151,3,1,2
4,9,764,1,1,0
4,9,1493,5,2,3
4,3,1702,7,1,6
4,3,794,3,0,3
4,9,1826,5,2,3
4,9,1748,38,22,16
4,9,1138,6,3,3
4,3,510,2,0,2
4,3,1828,2,1,1
4,9,1056,3,1,2
4,3,2132,5,2,3
4,3,1258,5,1,4
4,3,696,3,2,1
4,9,2498,17,7,10
4,10,452,3,0,3
4,3,3480,225,99,126
4,3,3831,183,89,94
4,3,1330,41,21,20
4,3,1359,22,11,11
4,3,589,0,0,0
4,3,1557,14,9,5
4,3,491,6,3,3
4,3,1158,17,9,8
4,3,836,30,14,16
4,3,928,15,7,8
4,3,715,10,2,8
4,3,2236,69,40,29
4,3,1048,9,3,6
4,3,3556,37,21,16
4,3,574,1,0,1
4,3,1324,25,14,11
4,3,606,14,8,6
4,3,727,0,0,0
4,3,4294,267,134,133
4,3,796,8,4,4
4,3,1952,88,45,43
4,3,588,11,6,5
4,3,663,13,8,5
4,3,523,6,5,1
4,3,1233,56,33,23
4,3,424,3,1,2
4,3,1602,14,8,6
4,3,786,15,10,5
4,3,539,9,5,4
4,3,756,2,0,2
4,3,1216,73,35,38
4,3,566,2,2,0
4,3,672,1,1,0
4,3,535,0,0,0
4,3,574,2,0,2
4,3,531,1,1,0
4,3,544,0,0,0
4,4,720,5,2,3
4,4,1225,1,0,1
4,4,352,0,0,0
4,10,944,0,0,0
4,10,1743,4,1,3
4,10,1594,5,1,4
4,10,738,1,1,0
4,10,764,2,0,2
4,10,3715,17,6,11
4,10,620,0,0,0
4,4,4508,22,13,9
4,4,1527,2,1,1
5,1,749,2,1,1
5,1,255,0,0,0
5,2,2845,84,36,48
5,2,6431,26,9,17
5,2,1902,21,13,8
5,2,773,10,8,2
5,2,1166,48,26,22
5,2,1241,21,9,12
5,2,22485,417,183,234
5,2,2965,19,10,9
5,2,3531,35,13,22
5,2,410,0,0,0
5,2,724,2,0,2
5,2,626,5,1,4
5,2,600,1,0,1
5,2,781,9,3,6
5,2,1559,19,15,4
5,2,13684,78,41,37
5,2,1018,3,2,1
5,2,1024,3,3,0
5,2,858,6,1,5
5,2,515,5,1,4
5,2,497,1,1,0
5,2,1458,8,5,3
5,2,833,1,1,0
5,2,1006,8,3,5
5,2,1621,1,1,0
5,2,2179,11,4,7
5,2,1291,7,3,4
5,2,11592,33,11,22
5,2,836,8,6,2
5,2,13786,42,19,23
5,2,6126,40,18,22
5,2,5379,14,5,9
5,2,1755,5,3,2
5,2,1666,8,5,3
5,2,128,0,0,0
5,2,19185,86,41,45
5,3,4162,17,6,11
5,3,1943,1,1,0
5,3,1304,1,1,0
5,3,858,0,0,0
5,3,791,4,1,3
5,3,2153,7,3,4
5,3,921,10,4,6
5,3,1255,1,0,1
5,3,1244,3,2,1
5,3,3938,12,3,9
5,3,713,0,0,0
5,3,846,92,49,43
5,3,1284,218,112,106
5,3,1578,3,1,2
5,3,59,0,0,0
5,4,7664,94,42,52
5,4,839,13,7,6
5,4,2795,25,9,16
5,4,285,3,1,2
5,4,1426,35,16,19
5,4,952,1,1,0
5,4,637,403,175,228
5,4,167,0,0,0
5,4,291,0,0,0
5,4,1449,71,33,38
5,4,516,106,53,53
5,4,173,28,16,12
5,4,213,7,1,6
5,4,261,8,5,3
5,4,484,69,32,37
5,4,2636,325,161,164
5,4,334,117,56,61
5,4,260,56,26,30
5,4,978,2,0,2
5,4,1781,644,308,336
5,4,605,49,24,25
5,5,518,13,7,6
5,5,925,1,0,1
5,5,209,0,0,0
5,6,3782,1,0,1
5,6,1307,11,5,6
5,6,2855,7,3,4
5,6,2027,5,4,1
5,6,1024,4,2,2
5,6,1763,10,5,5
5,6,3498,11,2,9
5,6,1683,3,2,1
5,6,927,8,2,6
5,6,792,0,0,0
5,6,2151,5,3,2
5,6,2011,8,5,3
5,6,329,1,1,0
5,6,219,0,0,0
5,6,24,1,1,0
5,6,143,0,0,0
5,6,120,1,0,1
5,6,122,1,1,0
5,6,121,0,0,0
5,6,381,12,9,3
5,6,144,6,3,3
5,7,1527,5,3,2
5,7,790,1,0,1
5,7,660,4,1,3
5,7,1836,4,1,3
5,7,912,2,0,2
5,7,894,2,1,1
5,7,4008,6,1,5
5,7,42,0,0,0
5,7,138,0,0,0
5,7,154,0,0,0
5,7,257,0,0,0
5,7,621,0,0,0
5,7,253,0,0,0
5,7,162,1,0,1
5,7,464,0,0,0
5,8,288,0,0,0
5,8,254,0,0,0
5,8,381,1,1,0
5,8,2122,10,4,6
5,9,2740,0,0,0
5,9,2744,18,7,11
5,9,983,6,4,2
5,9,5543,35,13,22
5,9,1943,17,10,7
5,9,938,1,0,1
5,9,2454,3,0,3
5,9,1920,1,1,0
5,9,1053,0,0,0
5,9,448,0,0,0
5,9,856,4,1,3
5,9,1102,4,2,2
5,9,1880,2,1,1
5,9,1641,10,6,4
5,9,1618,11,8,3
5,9,2058,7,5,2
5,9,6747,17,4,13
5,9,3362,11,4,7
5,9,357,0,0,0
5,9,493,0,0,0
5,9,129,0,0,0
5,9,763,0,0,0
5,9,0,0,0,0
5,9,1021,0,0,0
5,9,590,23,12,11
5,9,513,2,0,2
5,9,1029,47,24,23
5,9,769,2,1,1
5,9,1280,0,0,0
5,9,584,0,0,0
5,9,841,8,3,5
5,9,1576,3,2,1
5,9,903,0,0,0
5,9,500,2,2,0
5,9,997,3,1,2
5,9,1106,14,5,9
5,9,312,0,0,0
5,9,1388,26,15,11
5,9,1439,16,11,5
5,9,337,0,0,0
5,9,1395,0,0,0
5,9,603,0,0,0
5,10,9990,39,12,27
5,10,4113,10,5,5
5,10,5434,8,4,4
5,10,2537,13,8,5
5,10,2083,9,5,4
5,10,1989,7,4,3
5,10,1771,35,12,23
5,10,1675,3,2,1
5,10,1582,7,4,3
5,10,1149,11,5,6
5,10,1617,14,6,8
5,10,1747,5,4,1
5,10,1984,14,6,8
5,10,815,0,0,0
5,10,2275,4,2,2
5,10,1246,3,2,1
5,10,1345,10,8,2
5,10,970,2,1,1
5,10,3979,29,17,12
5,10,2236,5,3,2
5,10,1808,4,1,3
5,10,609,4,3,1
5,10,1232,8,4,4
5,10,1016,7,4,3
5,10,1158,62,34,28
5,10,2273,20,7,13
5,10,1576,20,7,13
5,10,1784,25,8,17
5,10,956,5,3,2
5,10,1421,5,1,4
5,10,1414,11,6,5
5,10,1531,2,1,1
5,10,790,0,0,0
5,10,1574,3,1,2
5,10,1708,4,2,2
5,10,1846,6,4,2
5,10,2239,24,11,13
5,10,1754,3,0,3
5,10,1916,18,7,11
5,10,1892,10,3,7
5,10,1484,0,0,0
5,11,3005,97,47,50
5,11,1230,17,10,7
5,11,1579,198,105,93
5,11,627,5,3,2
5,11,458,0,0,0
5,11,349,1,0,1
5,11,149,0,0,0
5,11,719,3,1,2
5,11,517,3,1,2
5,11,489,8,5,3
5,11,380,0,0,0
5,11,503,13,7,6
5,11,315,1,1,0
5,11,455,0,0,0
5,11,352,19,10,9
5,11,696,0,0,0
5,12,444,4,1,3
5,12,395,5,2,3
5,12,224,1,0,1
5,12,318,0,0,0
5,12,250,1,1,0
5,13,323,0,0,0
5,13,1413,0,0,0
5,14,383,1,1,0
5,14,690,1,1,0
5,14,1386,1,1,0
5,14,839,2,1,1
5,14,744,0,0,0
5,14,2092,13,7,6
5,14,1436,1,0,1
5,14,234,0,0,0
5,14,337,0,0,0
5,14,744,0,0,0
5,15,570,0,0,0
5,15,451,0,0,0
5,15,415,0,0,0
5,15,159,0,0,0
5,16,830,3,1,2
5,16,935,0,0,0
5,17,2010,17,8,9
5,17,6719,114,50,64
5,17,4956,12,7,5
5,17,3238,49,28,21
5,17,1666,9,6,3
5,17,1615,3,2,1
5,17,1185,23,15,8
5,17,1704,18,14,4
5,17,6976,33,16,17
5,17,1156,17,8,9
5,17,770,3,1,2
5,17,5438,68,33,35
5,17,3896,48,21,27
5,17,930,0,0,0
5,17,1963,13,4,9
5,17,2256,39,18,21
5,17,1502,7,3,4
5,17,2608,21,9,12
5,17,2371,11,6,5
5,17,2997,9,5,4
5,17,1575,1,0,1
5,17,913,17,4,13
5,17,989,1,0,1
5,17,2404,3,1,2
5,17,621,8,4,4
5,17,1789,6,1,5
5,17,1402,6,3,3
5,17,2064,25,9,16
5,17,1252,5,5,0
5,17,1795,3,2,1
5,17,1670,9,4,5
5,17,2445,6,1,5
5,17,1067,15,8,7
5,17,2267,10,4,6
5,17,1896,3,0,3
5,17,1162,8,2,6
5,17,1736,4,2,2
5,17,1835,19,10,9
5,17,744,0,0,0
5,17,1335,2,1,1
5,17,1862,16,8,8
5,17,2255,25,15,10
5,17,618,4,4,0
5,17,671,0,0,0
5,17,681,0,0,0
5,17,831,1,1,0
5,17,1110,34,14,20
5,17,1427,3,1,2
5,17,5259,45,21,24
5,17,2250,3,2,1
5,17,3085,48,20,28
5,17,1436,10,2,8
5,17,933,21,11,10
5,17,2044,5,0,5
5,17,1072,0,0,0
5,17,2487,46,24,22
5,17,670,0,0,0
5,17,1034,1,1,0
5,17,352,2,0,2
5,17,673,4,0,4
5,17,284,0,0,0
5,17,1045,2,2,0
5,18,1612,6,5,1
5,18,2150,7,5,2
5,18,1587,23,16,7
5,18,1967,24,12,12
5,18,1607,7,4,3
5,18,1242,12,4,8
5,18,5256,32,19,13
5,18,5843,39,18,21
5,18,1985,14,5,9
5,18,1999,3,2,1
5,18,2125,16,7,9
5,18,1322,11,4,7
5,18,2177,6,4,2
5,18,1939,43,25,18
5,18,4564,16,10,6
5,18,1685,12,8,4
5,18,1901,3,1,2
5,18,1369,8,4,4
5,18,8563,15,10,5
5,18,3435,4,1,3
5,18,1612,2,1,1
5,18,1237,14,6,8
5,18,1660,10,3,7
5,18,1483,4,1,3
5,18,1484,7,4,3
5,18,1334,9,5,4
5,18,1374,7,1,6
5,18,1507,1,1,0
5,18,2225,4,1,3
5,18,3316,31,17,14
5,18,2288,55,27,28
5,18,1670,9,7,2
5,18,1461,9,2,7
5,18,1138,16,8,8
5,18,1015,29,17,12
5,18,520,32,20,12
5,18,1194,1,1,0
5,18,2074,11,2,9
5,18,2409,27,10,17
5,18,825,7,5,2
5,18,1111,20,9,11
5,18,1572,0,0,0
5,18,2103,12,3,9
5,18,5665,24,8,16
5,18,881,9,4,5
5,18,1614,15,6,9
5,18,896,6,1,5
5,18,591,6,2,4
5,18,854,5,0,5
5,18,996,1,1,0
5,18,1480,35,16,19
5,18,2026,17,9,8
5,18,2410,7,4,3
5,18,1776,16,5,11
5,18,1475,18,8,10
5,18,608,3,2,1
5,18,659,0,0,0
5,18,1631,8,6,2
5,18,9501,40,19,21
5,18,2075,11,6,5
5,18,1735,2,1,1
5,18,473,2,0,2
5,18,1094,10,4,6
5,18,1377,49,23,26
5,18,1729,45,22,23
5,18,2067,134,67,67
5,18,2338,13,5,8
5,18,1248,13,8,5
5,18,1276,22,15,7
5,18,767,8,6,2
5,18,830,16,7,9
5,18,1420,13,9,4
5,18,789,12,4,8
5,18,1162,2,2,0
5,18,782,1,0,1
5,18,439,8,4,4
5,18,764,7,5,2
5,18,1451,0,0,0
5,18,3350,46,20,26
5,18,2741,2,0,2
5,18,1557,4,2,2
5,18,745,23,12,11
5,18,839,0,0,0
5,18,1332,6,2,4
5,18,1015,0,0,0
5,18,1327,3,2,1
5,18,1387,8,4,4
5,18,1312,11,7,4
5,18,1776,4,0,4
5,18,1379,4,1,3
5,18,686,0,0,0
5,18,898,4,3,1
5,18,925,2,0,2
5,18,1742,3,1,2
5,18,1784,15,9,6
5,18,2974,2,1,1
5,18,1934,11,4,7
5,18,1753,2,0,2
5,18,884,1,1,0
5,18,675,3,2,1
5,18,1740,17,10,7
5,18,1273,4,3,1
5,18,1899,5,1,4
5,18,1925,20,10,10
5,18,536,1,0,1
5,18,2194,11,4,7
5,18,1118,1,1,0
5,18,2409,24,12,12
5,18,1423,4,2,2
5,18,1269,5,4,1
5,18,1126,16,7,9
5,18,2537,24,9,15
5,18,13364,64,27,37
5,18,1703,6,3,3
5,18,3026,7,4,3
5,18,1214,4,2,2
5,18,1967,22,9,13
5,18,5423,118,61,57
5,18,2476,14,9,5
5,18,3890,15,10,5
5,18,1592,12,6,6
5,18,1113,4,2,2
5,18,1379,6,2,4
5,18,436,6,1,5
5,19,2088,8,3,5
5,19,1034,1,1,0
5,19,1279,0,0,0
5,19,831,0,0,0
5,19,1645,7,2,5
5,19,1023,2,1,1
5,20,3471,85,43,42
5,20,2709,106,47,59
5,20,1411,66,31,35
5,20,1631,213,108,105
5,20,1658,33,16,17
5,20,1781,35,10,25
5,20,2809,154,79,75
5,20,1525,18,9,9
5,20,3709,68,31,37
5,20,1250,104,58,46
5,20,2786,26,7,19
5,20,2013,32,19,13
5,20,873,40,22,18
5,20,2089,65,32,33
5,20,1123,41,22,19
5,20,492,3,3,0
5,20,547,5,4,1
5,20,1264,4,0,4
5,20,1521,12,8,4
5,20,2417,35,17,18
5,20,2494,44,28,16
5,20,1233,209,88,121
5,20,634,0,0,0
5,20,2110,22,7,15
5,20,1141,0,0,0
5,20,1442,14,7,7
5,20,1170,4,2,2
5,20,1463,19,8,11
5,20,1345,10,5,5
5,20,2264,16,6,10
5,20,1106,18,6,12
5,20,1669,5,5,0
5,20,1077,2,0,2
5,20,1064,2,2,0
5,20,1347,11,3,8
5,20,726,0,0,0
5,20,505,0,0,0
5,20,1472,2,0,2
5,20,1103,0,0,0
5,20,273,1,0,1
5,20,2063,5,3,2
5,20,1854,6,2,4
5,20,557,7,3,4
5,20,1197,12,5,7
5,20,663,0,0,0
5,20,744,4,2,2
5,20,673,1,1,0
5,20,1254,0,0,0
5,21,1079,17,10,7
5,21,1744,6,4,2
5,21,950,16,8,8
5,21,1033,0,0,0
5,21,286,2,2,0
5,21,775,2,1,1
5,21,64,0,0,0
5,21,119,0,0,0
5,22,2624,17,8,9
5,22,1022,2,0,2
5,22,2125,2,1,1
5,22,3620,31,13,18
5,22,3641,8,6,2
5,22,1582,0,0,0
5,22,1022,0,0,0
5,22,2563,8,5,3
5,22,4572,21,14,7
5,22,1289,3,0,3
5,22,3086,4,1,3
5,22,1315,1,1,0
5,22,641,2,1,1
5,22,762,13,5,8
5,22,2816,15,6,9
5,22,451,23,13,10
5,22,50,1,0,1
5,23,2016,10,5,5
5,23,1690,17,6,11
5,23,381,5,2,3
5,23,194,1,0,1
5,23,267,0,0,0
5,23,141,0,0,0
5,23,1972,3,1,2
5,23,206,0,0,0
5,23,158,0,0,0
5,23,121,0,0,0
5,23,119,0,0,0
5,23,933,5,1,4
5,23,1436,0,0,0
5,24,5711,8,4,4
5,24,2966,176,102,74
5,24,1486,18,9,9
5,24,2401,17,7,10
5,24,1265,3,2,1
5,24,1031,12,2,10
5,24,2829,6,3,3
5,24,2371,6,1,5
5,24,1167,4,0,4
5,24,781,10,7,3
5,24,1350,10,7,3
5,24,1175,6,2,4
5,24,1172,4,3,1
5,24,730,17,10,7
5,24,652,1,0,1
5,24,3998,26,8,18
5,24,1936,2,0,2
5,24,1839,0,0,0
5,24,510,2,1,1
5,24,84,0,0,0
5,24,462,3,2,1
5,24,341,0,0,0
5,24,189,4,1,3
5,24,819,1,1,0
5,24,1226,1,1,0
5,24,1499,41,18,23
5,24,301,6,2,4
5,24,1266,13,6,7
5,24,317,0,0,0
5,24,1363,4,1,3
5,24,582,8,4,4
5,24,244,0,0,0
5,24,367,2,0,2
5,24,59,0,0,0
5,25,6218,55,28,27
5,25,1488,13,7,6
5,25,668,0,0,0
5,25,17852,191,78,113
5,25,3786,10,4,6
5,25,456,1,1,0
5,25,532,1,0,1
5,25,562,10,2,8
5,25,2311,10,4,6
5,25,8223,84,39,45
5,25,11658,49,20,29
5,25,2231,14,5,9
5,25,384,3,1,2
5,25,363,0,0,0
5,25,622,1,0,1
5,25,334,0,0,0
5,25,1108,2,0,2
5,25,1189,6,1,5
5,25,1865,8,3,5
5,25,634,2,0,2
5,25,597,1,1,0
5,25,478,0,0,0
5,25,238,0,0,0
5,25,501,8,3,5
5,25,3173,5,1,4
5,25,718,2,1,1
5,25,444,3,3,0
5,25,169,0,0,0
5,25,371,1,0,1
5,25,1217,5,3,2
5,25,434,0,0,0
5,25,551,2,2,0
5,25,778,4,3,1
5,25,1457,7,6,1
5,25,1992,5,2,3
5,25,1751,11,7,4
5,25,980,0,0,0
5,25,625,0,0,0
5,25,534,15,10,5
5,25,792,7,4,3
5,25,1457,5,2,3
5,25,704,3,1,2
5,25,1178,6,3,3
5,25,1847,2,1,1
5,25,5014,20,6,14
5,25,7479,124,58,66
5,25,887,6,3,3
5,25,719,4,2,2
5,25,893,7,4,3
5,25,1549,15,4,11
5,25,1499,3,0,3
5,25,345,4,2,2
5,25,3093,9,5,4
5,25,1474,11,7,4
5,25,1584,0,0,0
5,25,14229,93,46,47
5,25,601,0,0,0
5,25,6097,86,42,44
5,25,1002,1,0,1
5,25,904,3,1,2
5,25,5068,33,18,15
5,25,1531,19,7,12
5,25,2734,12,4,8
5,25,2915,9,4,5
5,25,315,0,0,0
5,25,368,0,0,0
5,25,1225,1,0,1
5,26,280,1,0,1
5,26,511,0,0,0
5,26,663,1,0,1
5,26,686,0,0,0
5,26,570,0,0,0
5,26,502,0,0,0
5,27,10440,75,36,39
5,27,1837,19,10,9
5,27,950,6,3,3
5,27,2002,18,4,14
5,27,826,18,8,10
5,27,2829,35,13,22
5,27,1392,5,1,4
5,27,2361,23,13,10
5,27,3694,23,8,15
5,27,1040,5,4,1
5,27,14275,306,146,160
5,27,20449,162,64,98
5,27,113,2,1,1
5,27,256,1,0,1
5,27,234,2,0,2
5,27,343,5,3,2
5,27,263,5,1,4
5,27,452,13,4,9
5,27,1275,18,5,13
5,27,1384,1,1,0
5,27,342,2,1,1
5,27,460,0,0,0
5,27,96,19,8,11
5,27,209,0,0,0
5,27,228,1,0,1
5,27,70,0,0,0
5,27,183,1,1,0
5,27,306,3,0,3
5,27,1269,6,2,4
5,27,575,7,4,3
5,27,169,0,0,0
5,27,11483,89,39,50
5,27,148,2,0,2
5,27,141,2,2,0
5,28,3787,22,11,11
5,28,10871,113,46,67
5,28,6864,25,15,10
5,28,1185,4,3,1
5,28,1343,5,3,2
5,28,1450,4,2,2
5,28,1089,3,1,2
5,28,1125,6,4,2
5,28,798,2,0,2
5,28,589,1,1,0
5,28,964,5,3,2
5,28,1328,2,2,0
5,28,2267,9,6,3
5,28,271,0,0,0
5,28,475,3,0,3
5,28,3548,6,2,4
5,28,990,3,1,2
5,28,1366,2,2,0
5,28,1946,78,39,39
5,28,962,6,4,2
5,28,1198,4,2,2
5,28,1566,260,132,128
5,28,3443,685,338,347
5,28,1436,6,1,5
5,28,3058,124,61,63
5,28,50,0,0,0
5,28,859,0,0,0
5,28,779,1,1,0
5,28,596,1,0,1
5,28,1282,10,4,6
5,28,746,1,1,0
5,28,1145,0,0,0
5,28,2600,10,2,8
5,28,869,2,0,2
5,28,1038,3,2,1
5,28,899,0,0,0
5,28,138,0,0,0
5,29,1088,2,0,2
5,29,1382,5,2,3
5,30,2846,26,9,17
5,30,10037,102,45,57
5,30,4026,57,22,35
5,30,3652,39,18,21
5,30,14342,101,45,56
5,30,1858,8,3,5
5,30,2346,287,132,155
5,30,4128,30,18,12
5,30,6482,171,71,100
5,30,1537,51,23,28
5,30,2071,20,11,9
5,30,1068,24,13,11
5,30,1994,13,7,6
5,30,1222,197,92,105
5,30,5927,106,52,54
5,30,9347,146,72,74
5,30,7532,82,44,38
5,30,1356,12,5,7
5,30,1788,70,38,32
5,30,1115,10,5,5
5,30,1525,44,28,16
5,30,6682,929,452,477
5,30,10769,194,95,99
5,30,2889,822,411,411
5,30,4347,40,17,23
5,30,24369,870,440,430
5,30,2743,621,317,304
5,30,3291,598,299,299
5,30,1781,73,37,36
5,30,2643,27,13,14
5,30,1132,8,1,7
5,30,1106,17,10,7
5,30,942,11,7,4
5,30,1544,16,5,11
5,30,1953,22,8,14
5,30,1356,61,31,30
5,30,28118,568,266,302
5,30,1185,497,266,231
5,30,3811,9,5,4
5,30,1342,9,4,5
5,30,1229,9,2,7
5,30,3218,27,11,16
5,30,1097,63,31,32
5,30,682,24,16,8
5,30,1285,24,11,13
5,30,1297,14,6,8
5,30,1565,107,56,51
5,30,41056,950,485,465
5,30,1532,61,32,29
5,30,1549,0,0,0
5,30,1298,17,8,9
5,30,1217,23,13,10
5,30,858,24,8,16
5,30,1076,13,3,10
5,30,744,10,5,5
5,30,671,3,3,0
5,30,964,69,41,28
5,30,1797,20,9,11
5,30,2514,322,156,166
5,30,1247,3,1,2
5,30,4113,331,161,170
5,30,1564,0,0,0
5,30,1896,9,5,4
5,30,1350,1,1,0
5,30,2263,1178,581,597
5,30,2773,9,6,3
5,30,2016,33,16,17
5,30,833,11,4,7
5,30,926,14,7,7
5,30,765,7,4,3
5,30,2466,137,68,69
5,30,1556,86,42,44
5,30,632,2,2,0
5,30,956,2,1,1
5,30,1111,29,16,13
5,30,1165,9,5,4
5,30,609,5,3,2
5,30,1179,16,6,10
5,30,866,24,9,15
5,30,719,8,6,2
5,30,860,8,5,3
5,30,545,15,5,10
5,30,1451,1,0,1
5,30,1338,17,6,11
5,30,2513,24,11,13
5,30,1375,10,5,5
5,30,5352,49,22,27
5,30,3073,24,11,13
5,30,2318,149,71,78
5,30,1426,3,1,2
5,30,1758,6,3,3
5,30,1056,0,0,0
5,30,1122,21,13,8
5,30,1042,7,2,5
5,30,905,0,0,0
5,30,1057,6,5,1
5,30,618,0,0,0
5,30,714,1,0,1
5,30,1160,5,1,4
5,30,2048,30,16,14
5,30,3935,61,31,30
5,30,4226,80,37,43
5,30,1595,5,3,2
5,30,6359,52,22,30
5,30,1279,5,4,1
5,30,2206,13,7,6
5,30,1053,12,3,9
5,30,1144,12,5,7
5,30,843,11,5,6
5,30,832,14,10,4
5,30,585,3,0,3
5,30,579,3,1,2
5,30,687,4,3,1
5,30,466,3,2,1
5,30,629,1,0,1
5,30,616,8,4,4
5,30,1982,26,15,11
5,30,918,11,3,8
5,30,673,6,2,4
5,30,1579,10,4,6
5,30,1323,2,0,2
5,30,5378,9,3,6
5,30,3115,4,2,2
5,30,1705,5,4,1
5,30,1344,2,1,1
5,30,1918,11,3,8
5,30,762,9,6,3
5,30,444,2,2,0
5,30,596,11,5,6
5,30,812,18,11,7
5,30,763,14,9,5
5,30,959,21,10,11
5,30,1109,7,6,1
5,30,1177,5,2,3
5,30,1192,14,10,4
5,30,1239,15,6,9
5,30,1978,33,19,14
5,30,7690,323,162,161
5,30,14592,149,66,83
5,30,1184,9,3,6
5,30,1206,11,2,9
5,30,1496,10,5,5
5,30,1033,29,14,15
5,30,568,18,8,10
5,30,712,11,4,7
5,30,1067,14,6,8
5,30,1660,32,13,19
5,30,530,20,9,11
5,30,748,3,0,3
5,30,1081,18,5,13
5,30,631,21,15,6
5,30,847,9,6,3
5,30,2193,15,7,8
5,30,992,3,0,3
5,30,1179,3,3,0
5,30,1918,0,0,0
5,30,1418,374,183,191
5,30,1385,212,114,98
5,30,1153,14,5,9
5,30,1375,5,3,2
5,30,969,18,9,9
5,30,811,11,6,5
5,30,955,15,9,6
5,30,872,4,2,2
5,30,1296,6,3,3
5,30,1223,11,2,9
5,30,1285,5,2,3
5,30,834,34,15,19
5,30,940,11,4,7
5,30,468,20,9,11
5,30,602,14,8,6
5,30,1534,42,24,18
5,30,1890,19,8,11
5,30,2821,44,24,20
5,30,9704,541,269,272
5,30,3466,119,70,49
5,30,26308,343,179,164
5,30,4945,38,15,23
5,30,4135,33,15,18
5,30,1094,7,5,2
5,30,1255,11,7,4
5,30,1302,0,0,0
5,30,1264,1,0,1
5,30,1368,7,4,3
5,30,1102,3,0,3
5,30,866,9,5,4
5,30,852,15,8,7
5,30,1084,1,1,0
5,30,1210,3,2,1
5,30,1279,26,15,11
5,30,1050,29,13,16
5,30,1457,26,15,11
5,30,1668,20,10,10
5,30,893,1,0,1
5,30,990,7,3,4
5,30,1459,12,9,3
5,30,1588,0,0,0
5,30,1552,0,0,0
5,30,2173,12,5,7
5,30,3080,14,7,7
5,30,1134,2,0,2
5,30,1551,6,4,2
5,30,1168,3,0,3
5,30,1193,2,2,0
5,30,1151,2,1,1
5,30,2857,11,3,8
5,30,1577,15,7,8
5,30,2119,102,51,51
5,30,1072,13,8,5
5,30,1026,0,0,0
5,30,1328,1,1,0
5,30,1308,7,4,3
5,30,14698,88,38,50
5,30,1635,7,4,3
5,30,1456,93,52,41
5,30,9973,961,474,487
5,30,1255,10,4,6
5,30,1210,7,3,4
5,30,8559,32,14,18
5,30,8589,71,31,40
5,30,2098,9,5,4
5,30,6274,55,25,30
5,30,1364,15,10,5
5,30,1290,4,3,1
5,30,1202,91,47,44
5,30,1461,9,6,3
5,30,1282,15,5,10
5,30,1174,49,28,21
5,30,1356,17,8,9
5,30,1082,5,3,2
5,30,2181,20,9,11
5,30,753,4,4,0
5,30,1431,7,4,3
5,30,1257,2,1,1
5,30,1625,1,0,1
5,30,2190,17,7,10
5,30,2768,48,20,28
5,30,1831,24,8,16
5,30,4081,19,7,12
5,30,11152,45,22,23
5,30,1986,9,4,5
5,30,2418,4,1,3
5,30,2062,8,2,6
5,30,1652,15,10,5
5,30,1422,26,9,17
5,30,1580,11,7,4
5,30,4768,37,17,20
5,30,1602,16,7,9
5,30,3864,98,48,50
5,30,3775,136,64,72
5,30,4273,35,16,19
5,30,1401,15,7,8
5,30,1520,19,9,10
5,30,1643,477,232,245
5,30,2491,4,1,3
5,30,2324,8,5,3
5,30,10855,100,46,54
5,30,2281,26,14,12
5,30,1782,12,4,8
5,30,2076,12,7,5
5,30,1825,16,6,10
5,30,12532,79,44,35
5,30,11931,223,106,117
5,30,1420,17,8,9
5,30,1453,8,3,5
5,30,1465,23,11,12
5,30,2618,39,22,17
5,30,1156,24,11,13
5,30,261,0,0,0
5,30,563,6,3,3
5,30,13702,206,93,113
5,30,102,1,0,1
5,30,245,2,2,0
5,30,8945,378,195,183
5,30,21328,657,326,331
5,30,348,3,1,2
5,30,513,2,1,1
5,30,1189,10,6,4
5,30,463,11,6,5
5,30,2015,8,4,4
5,30,122,0,0,0
5,30,249,0,0,0
5,30,1647,20,8,12
5,30,390,0,0,0
5,30,342,0,0,0
5,30,157,1,1,0
5,30,312,2,2,0
5,30,87,0,0,0
5,30,130,1,0,1
5,30,238,2,1,1
5,30,351,1,0,1
5,30,93,2,1,1
5,30,250,5,1,4
5,30,382,0,0,0
5,30,210,0,0,0
5,30,171,0,0,0
5,30,538,0,0,0
5,30,184,4,1,3
5,30,638,1,0,1
5,30,149,1,1,0
5,30,403,29,12,17
5,30,114,10,5,5
5,30,229,12,4,8
5,30,254,99,44,55
5,30,586,3,2,1
5,30,575,0,0,0
5,31,2285,5,4,1
5,31,1720,9,4,5
5,31,3135,30,15,15
5,31,1644,4,2,2
5,31,1136,1,1,0
5,31,729,3,1,2
5,31,1932,11,5,6
5,31,1811,2,0,2
5,31,2742,7,1,6
5,31,1670,20,7,13
5,31,1360,6,3,3
5,31,1630,7,4,3
5,31,2185,5,4,1
5,31,284,3,0,3
5,31,379,0,0,0
5,31,315,0,0,0
5,31,291,1,0,1
5,32,789,3,1,2
5,32,577,2,2,0
5,32,1065,5,2,3
5,32,1174,2,2,0
5,32,2372,39,16,23
5,32,1174,3,2,1
5,32,1547,25,14,11
5,32,1275,2,1,1
5,32,1042,22,11,11
5,32,1780,28,15,13
5,32,1192,2,0,2
5,32,1163,49,22,27
5,32,459,4,1,3
5,32,1636,8,4,4
5,32,1012,6,3,3
5,32,1428,21,12,9
5,32,913,3,3,0
5,32,623,0,0,0
5,32,1355,3,1,2
5,32,713,0,0,0
5,32,2743,20,10,10
5,32,869,2,1,1
5,32,690,0,0,0
5,32,668,6,5,1
5,32,3285,7,4,3
5,32,931,0,0,0
5,32,901,3,1,2
5,32,1236,14,7,7
5,32,799,9,7,2
5,32,659,1,1,0
5,32,3405,65,33,32
5,32,560,112,61,51
5,32,1221,3,1,2
5,33,6035,24,16,8
5,33,1116,0,0,0
5,33,1587,5,2,3
5,33,4308,12,6,6
5,33,1338,1,0,1
5,33,1536,6,3,3
5,33,2380,441,230,211
5,33,2062,23,15,8
5,33,791,19,9,10
5,33,1808,2,0,2
5,33,581,2,1,1
5,33,492,5,3,2
5,33,1040,8,2,6
5,33,1461,50,26,24
5,33,1201,2,1,1
5,33,1284,8,3,5
5,33,412,7,3,4
5,33,852,0,0,0
5,33,2051,11,4,7
5,33,2636,12,4,8
5,33,1484,3,0,3
5,33,840,12,6,6
5,33,989,6,3,3
5,33,843,1,0,1
5,33,3487,36,22,14
5,33,1931,12,4,8
5,33,1397,25,13,12
5,33,3589,6,2,4
5,33,387,4,1,3
5,33,370,2,0,2
5,33,324,0,0,0
5,33,786,7,3,4
5,33,156,1,1,0
5,33,124,0,0,0
5,33,1590,2,0,2
5,33,360,1,0,1
5,33,664,0,0,0
5,33,1005,6,6,0
5,33,1249,2,0,2
5,33,1148,0,0,0
5,33,1279,2,1,1
5,33,1578,4,2,2
5,33,563,2,0,2
5,33,357,0,0,0
5,33,1058,2,1,1
5,33,1377,3,2,1
5,33,1785,3,0,3
5,33,957,4,3,1
5,33,1579,0,0,0
5,33,1784,4,2,2
5,33,1911,6,3,3
5,33,3441,8,5,3
5,33,705,1,0,1
5,33,685,2,1,1
5,33,228,1,0,1
5,33,1318,2,1,1
5,33,1187,0,0,0
5,33,1267,2,1,1
5,33,1978,7,2,5
5,33,641,4,1,3
5,33,1049,2,1,1
5,33,524,14,7,7
5,33,884,3,2,1
5,33,886,0,0,0
5,33,921,0,0,0
5,33,1424,1,1,0
5,33,2029,4,2,2
5,33,1042,4,2,2
5,33,1347,10,4,6
5,33,1128,1,1,0
5,33,1514,15,11,4
5,33,1753,0,0,0
5,33,1891,1,0,1
5,33,721,0,0,0
5,33,501,0,0,0
5,34,462,1,1,0
5,34,4792,16,7,9
5,34,186,0,0,0
5,34,958,1,1,0
5,34,330,2,1,1
5,35,4792,35,19,16
5,35,3339,146,73,73
5,35,5693,11,5,6
5,35,1444,1,0,1
5,35,2183,0,0,0
5,35,6050,62,34,28
5,35,904,38,15,23
5,35,3818,19,7,12
5,35,8568,192,85,107
5,35,1222,17,7,10
5,35,1223,8,6,2
5,35,4009,20,7,13
5,35,24398,276,151,125
5,35,1319,2,1,1
5,35,824,2,0,2
5,35,1058,12,5,7
5,35,1123,2,1,1
5,35,892,3,1,2
5,35,1335,74,37,37
5,35,1933,13,6,7
5,35,1433,4,2,2
5,35,3200,6,2,4
5,35,813,8,5,3
5,35,942,7,2,5
5,35,1290,19,11,8
5,35,1108,7,4,3
5,35,848,2,1,1
5,35,597,3,2,1
5,35,806,0,0,0
5,35,1570,3,1,2
5,35,1534,4,2,2
5,35,914,3,1,2
5,35,975,8,5,3
5,35,592,8,1,7
5,35,922,17,9,8
5,35,1512,43,24,19
5,35,964,4,4,0
5,35,1303,9,7,2
5,35,874,0,0,0
5,35,472,1,0,1
5,35,745,13,7,6
5,35,825,16,7,9
5,35,1227,10,5,5
5,35,1143,1,0,1
5,35,841,1,0,1
5,35,588,3,0,3
5,35,1159,4,3,1
5,35,1006,6,5,1
5,35,915,0,0,0
5,35,1202,2,1,1
5,35,813,3,2,1
5,35,616,5,2,3
5,35,768,8,4,4
5,35,801,2,1,1
5,35,138,0,0,0
5,35,1008,10,4,6
5,35,1211,28,13,15
5,35,697,103,54,49
5,35,348,2,1,1
5,35,398,5,4,1
5,35,1135,40,20,20
5,35,1467,134,78,56
5,35,605,24,13,11
5,35,505,25,12,13
5,35,590,30,17,13
5,35,212,1,1,0
5,35,358,3,2,1
5,35,511,2,1,1
5,35,558,1,1,0
5,35,591,6,4,2
5,35,286,20,12,8
5,35,375,2,0,2
5,35,304,17,7,10
5,35,582,11,3,8
5,35,604,1,0,1
5,35,1017,76,38,38
5,35,321,4,2,2
5,35,736,387,201,186
5,35,655,295,148,147
5,35,33,2,1,1
5,35,853,12,6,6
5,35,468,6,4,2
5,35,1041,26,13,13
5,35,866,5,2,3
5,35,422,5,3,2
5,35,598,8,2,6
5,35,895,29,12,17
5,35,1802,61,34,27
5,35,893,4,3,1
5,35,462,9,4,5
5,35,812,18,8,10
5,35,3357,19,7,12
5,35,212,3,1,2
5,35,633,3,0,3
5,35,506,4,1,3
5,35,822,8,5,3
5,35,697,0,0,0
5,35,915,1,1,0
5,35,1411,7,4,3
5,35,207,0,0,0
5,35,1280,3,1,2
5,35,127,0,0,0
5,35,1477,10,6,4
5,35,206,0,0,0
5,35,1185,2,2,0
5,35,660,2,1,1
5,35,428,13,6,7
5,35,481,1,1,0
5,35,383,10,4,6
5,35,580,5,4,1
5,35,1585,7,4,3
5,35,1017,7,3,4
5,35,388,1,0,1
5,35,726,4,3,1
5,35,1099,1,1,0
5,35,340,0,0,0
5,35,420,1,1,0
5,35,257,0,0,0
5,35,311,1,1,0
5,35,836,3,1,2
5,35,1002,4,1,3
5,35,962,8,3,5
5,35,1125,33,22,11
5,35,1326,46,23,23
5,35,135,0,0,0
5,35,298,3,1,2
5,35,539,4,3,1
5,35,1635,5,1,4
5,35,837,2,1,1
5,35,518,9,6,3
5,35,35,1,0,1
5,35,168,1,1,0
5,35,402,0,0,0
5,35,2067,8,4,4
5,35,535,9,4,5
5,35,635,6,4,2
5,35,1657,7,6,1
5,35,22764,533,278,255
5,35,1538,8,0,8
5,35,1244,4,1,3
5,35,4581,18,12,6
5,35,1256,7,3,4
5,35,917,2,1,1
5,35,1266,21,8,13
5,35,2479,4,1,3
5,35,2051,12,6,6
5,35,8393,79,38,41
5,35,1062,3,2,1
5,35,1917,6,3,3
5,35,1759,2,2,0
5,35,1488,0,0,0
5,35,1075,2,2,0
5,35,1905,4,2,2
5,35,1268,4,3,1
5,35,979,2,2,0
5,35,1459,2,0,2
5,35,1024,4,2,2
5,35,1155,3,2,1
5,35,1389,7,1,6
5,35,812,3,2,1
5,35,725,2,1,1
5,35,472,2,1,1
5,35,1023,10,6,4
5,35,1251,39,19,20
5,35,930,4,3,1
5,35,1184,1,1,0
5,35,979,3,1,2
5,35,1349,10,3,7
5,35,1555,3,2,1
5,35,2151,6,3,3
5,35,802,6,2,4
5,35,1287,7,2,5
5,35,1204,16,12,4
5,35,1631,10,4,6
5,35,1625,27,19,8
5,35,1667,15,6,9
5,35,11803,79,40,39
5,35,19621,148,85,63
5,35,5060,27,13,14
5,35,2459,23,11,12
5,35,23198,293,128,165
5,35,1130,18,10,8
5,35,900,0,0,0
5,35,330,0,0,0
5,35,1484,4,1,3
5,35,3234,23,10,13
5,35,13902,222,112,110
5,35,2423,8,5,3
5,35,1129,14,7,7
5,35,1680,8,2,6
5,35,839,13,3,10
5,35,5730,127,64,63
5,35,872,26,18,8
5,35,1404,3,2,1
5,35,913,2,0,2
5,35,694,1,1,0
5,35,525,0,0,0
5,35,627,5,3,2
5,35,704,2,2,0
5,35,814,0,0,0
5,35,913,2,1,1
5,35,888,7,4,3
5,35,768,1,1,0
5,35,857,16,10,6
5,35,896,1,1,0
5,35,549,3,1,2
5,35,981,0,0,0
5,35,840,4,1,3
5,35,4388,35,23,12
5,35,2281,17,7,10
5,35,2272,20,9,11
5,35,928,4,1,3
5,35,1398,3,3,0
5,35,1257,0,0,0
5,35,3426,34,15,19
5,35,658,0,0,0
5,35,724,1,0,1
5,35,1717,17,9,8
5,35,1008,4,2,2
5,35,1396,41,23,18
5,35,310,0,0,0
5,35,1639,45,27,18
5,35,146,1,0,1
5,35,783,11,7,4
5,35,1132,46,22,24
5,35,816,40,21,19
5,35,786,9,6,3
5,35,1219,68,36,32
5,35,1161,7,4,3
5,35,1587,9,6,3
5,35,1039,7,2,5
5,35,795,7,4,3
5,35,1366,7,4,3
5,35,2786,18,14,4
5,35,1992,14,6,8
5,35,1876,6,2,4
5,35,2542,36,20,16
5,35,646,24,16,8
5,35,1132,47,28,19
5,35,975,15,12,3
5,35,975,2,0,2
5,35,599,7,2,5
5,35,1081,2,0,2
5,35,1514,12,4,8
5,35,1217,9,6,3
5,35,1106,15,12,3
5,35,657,8,5,3
5,35,1002,5,5,0
5,35,713,10,5,5
5,35,1705,17,10,7
5,35,2852,52,27,25
5,35,1395,23,12,11
5,35,1018,77,45,32
5,35,1454,26,15,11
5,35,1250,10,6,4
5,35,1243,2,1,1
5,35,1051,8,5,3
5,35,1303,12,3,9
5,35,571,10,5,5
5,35,387,4,2,2
5,35,1509,25,15,10
5,35,166,0,0,0
5,35,223,1,0,1
5,35,498,3,1,2
5,35,826,4,2,2
5,35,571,3,0,3
5,35,825,2,2,0
5,35,725,12,6,6
5,35,1649,35,22,13
5,35,3659,34,15,19
5,35,2806,32,15,17
5,35,1119,4,1,3
5,35,495,1,0,1
5,35,3767,19,6,13
5,35,1724,16,7,9
5,35,2056,110,55,55
5,35,504,14,7,7
5,35,826,65,31,34
5,35,969,1,1,0
5,35,2039,25,12,13
5,35,7879,348,175,173
5,35,85,0,0,0
5,35,1046,2,1,1
5,35,3595,7,2,5
5,35,2458,29,11,18
5,35,13453,153,81,72
5,35,3305,9,5,4
5,35,1955,9,6,3
5,35,2631,5,2,3
5,35,1130,4,2,2
5,35,24427,203,93,110
5,35,2110,10,3,7
5,35,1183,24,12,12
5,35,1838,0,0,0
5,35,772,0,0,0
5,35,676,4,4,0
5,35,609,1,1,0
5,35,449,0,0,0
5,36,1605,44,26,18
5,36,1917,6,5,1
5,36,471,3,1,2
5,36,745,4,3,1
5,36,1280,13,3,10
5,36,1,-6,-6,-6
5,36,380,0,0,0
5,36,190,0,0,0
5,36,476,0,0,0
5,36,1310,13,8,5
5,36,1039,0,0,0
5,36,463,0,0,0
5,36,249,1,0,1
5,36,1026,1,1,0
5,36,2112,23,14,9
5,36,2930,4,1,3
5,36,1466,12,6,6
5,36,1060,2,0,2
5,36,182,0,0,0
5,36,141,0,0,0
5,36,240,0,0,0
5,36,514,0,0,0
5,37,909,3,2,1
5,37,840,0,0,0
5,37,1257,1,1,0
5,37,835,0,0,0
5,37,1655,0,0,0
5,37,194,1,0,1
5,37,154,0,0,0
5,37,334,0,0,0
5,38,1698,39,20,19
5,38,3006,8,4,4
5,38,1099,8,3,5
5,38,709,42,17,25
5,38,1307,4,2,2
5,38,752,0,0,0
5,38,871,0,0,0
5,38,1657,6,4,2
5,38,371,18,6,12
5,38,495,0,0,0
5,38,153,23,6,17
5,38,190,3,1,2
5,38,798,0,0,0
5,35,878,11,7,4
5,35,517,3,2,1
5,35,726,7,3,4
5,35,602,13,7,6
5,35,1361,9,7,2
5,35,1172,6,5,1
5,35,897,0,0,0
5,35,971,6,3,3
5,35,1544,27,10,17
5,35,1342,2,0,2
5,35,1259,1,0,1
5,35,964,7,3,4
5,35,751,9,6,3
5,35,1211,13,8,5
5,35,1122,22,14,8
5,35,1401,26,12,14
5,35,745,2,0,2
5,35,1144,2,0,2
5,35,592,1,0,1
5,35,2022,2,2,0
5,35,673,5,1,4
5,35,866,5,3,2
5,35,1482,11,4,7
5,35,961,8,5,3
5,35,613,3,1,2
5,35,4772,27,13,14
5,35,1008,6,1,5
5,25,1489,5,2,3
5,25,1328,210,98,112
5,25,3865,138,71,67
5,25,776,4,3,1
5,25,1356,12,7,5
5,25,998,7,6,1
5,25,1309,8,3,5
5,25,1554,13,7,6
5,25,921,10,6,4
5,25,1173,9,6,3
5,25,1070,0,0,0
5,25,1624,20,10,10
5,25,1749,20,12,8
5,25,2214,4,3,1
5,25,1231,3,2,1
5,25,1164,20,8,12
5,25,1452,10,6,4
5,25,1567,3,2,1
5,25,1236,6,1,5
5,25,1258,1,1,0
5,6,1246,4,3,1
5,6,1097,0,0,0
5,6,1353,3,2,1
5,35,461,0,0,0
5,35,1225,11,7,4
5,35,72,7,4,3
5,35,501,6,3,3
5,35,330,3,1,2
5,35,306,1,0,1
5,35,789,9,4,5
5,35,335,6,3,3
5,35,796,9,5,4
5,35,540,3,2,1
5,35,824,17,6,11
5,35,868,14,5,9
5,35,919,4,4,0
5,35,1337,18,12,6
5,35,642,1,1,0
5,35,1062,3,2,1
5,35,975,4,2,2
5,35,1341,8,3,5
5,35,987,6,4,2
5,35,1255,3,2,1
5,35,677,1,0,1
5,35,1001,15,9,6
5,35,1561,8,3,5
5,35,544,8,4,4
5,35,1135,11,4,7
5,35,740,0,0,0
5,35,913,3,2,1
5,35,1119,1,1,0
5,35,704,2,1,1
5,35,655,1,0,1
5,35,397,1,0,1
5,35,693,1,1,0
5,35,899,1,0,1
5,35,828,2,0,2
5,35,745,3,3,0
5,35,655,0,0,0
5,35,641,1,0,1
5,35,452,0,0,0
5,35,483,0,0,0
5,35,644,1,1,0
5,30,1925,26,14,12
5,30,717,15,5,10
5,30,908,9,3,6
5,30,1149,16,6,10
5,30,983,5,2,3
5,30,975,62,28,34
5,30,509,1,0,1
5,30,779,0,0,0
5,30,1629,7,3,4
5,30,865,5,2,3
5,30,1252,14,9,5
5,30,1674,6,2,4
5,30,2001,24,10,14
5,30,644,1,1,0
5,30,1660,14,8,6
5,30,2261,13,4,9
5,30,930,7,6,1
5,30,458,1,0,1
5,30,1169,2,1,1
5,30,1841,8,5,3
5,30,882,7,4,3
5,30,858,0,0,0
5,30,2187,13,7,6
5,30,1634,2,1,1
5,30,1873,18,6,12
5,30,10202,36,16,20
5,30,1724,11,9,2
5,30,1280,3,2,1
5,30,1575,6,2,4
5,30,1268,5,2,3
5,30,1870,6,2,4
5,30,757,2,1,1
5,30,554,2,0,2
5,30,813,2,1,1
5,30,1439,1,0,1
5,30,720,2,0,2
5,30,598,0,0,0
5,30,501,0,0,0
5,30,876,15,8,7
5,30,537,1,0,1
5,30,579,3,3,0
5,30,1197,3,2,1
5,30,564,3,3,0
5,30,1209,1,1,0
5,30,660,2,1,1
5,30,1142,12,8,4
5,30,1430,4,1,3
5,30,1072,8,3,5
5,30,5869,162,81,81
5,30,1561,1,1,0
5,30,1163,4,4,0
5,30,994,14,7,7
5,30,1025,9,6,3
5,30,976,7,3,4
5,30,665,1,0,1
5,30,4939,71,40,31
5,30,687,2,1,1
5,30,965,2,2,0
5,30,1064,16,6,10
5,30,1601,16,8,8
5,30,914,3,0,3
5,30,1353,0,0,0
5,30,687,0,0,0
5,30,1145,3,1,2
5,30,916,3,0,3
5,30,10191,88,43,45
5,30,995,0,0,0
5,30,1112,3,0,3
5,30,1577,5,2,3
5,30,2520,45,19,26
5,30,1346,13,5,8
5,2,2747,29,14,15
5,2,1763,8,5,3
5,2,1070,5,1,4
5,2,656,7,3,4
5,2,498,5,1,4
5,2,468,15,9,6
5,2,954,3,2,1
5,2,910,5,3,2
5,2,631,10,6,4
5,2,875,0,0,0
5,2,1005,0,0,0
5,2,525,0,0,0
5,2,598,2,2,0
5,2,1700,4,2,2
5,2,1091,5,3,2
5,2,704,0,0,0
5,2,1280,8,6,2
5,2,802,1,0,1
5,2,1264,8,3,5
5,2,1054,2,0,2
5,2,1040,2,2,0
5,2,927,21,7,14
5,2,701,2,0,2
5,2,706,0,0,0
5,2,1101,3,1,2
5,2,1125,6,3,3
5,2,964,0,0,0
5,2,730,2,1,1
5,2,1357,5,1,4
5,32,815,28,7,21
5,27,1687,5,2,3
5,27,4378,12,6,6
5,27,4073,3,3,0
5,27,4136,12,3,9
5,27,3489,19,13,6
5,27,3809,12,7,5
5,27,3146,9,6,3
5,27,4338,29,9,20
5,27,3574,56,24,32
5,27,3952,38,16,22
5,27,3570,9,6,3
5,35,4364,40,22,18
5,35,5589,172,90,82
5,35,6106,223,120,103
5,35,9586,269,123,146
5,35,6113,49,17,32
5,35,8817,102,48,54
5,35,5038,117,56,61
5,35,5068,24,17,7
5,35,7702,95,41,54
5,35,3878,25,11,14
5,35,5471,170,91,79
5,35,5127,15,7,8
5,35,5873,44,21,23
5,35,2602,45,21,24
5,35,3815,23,9,14
5,35,2101,9,5,4
5,35,4590,8,3,5
5,35,5689,78,40,38
5,35,5315,61,32,29
5,35,2823,9,5,4
5,35,6465,176,91,85
5,35,4855,61,33,28
5,35,6442,849,427,422
5,35,4696,97,51,46
5,35,224,15,9,6
6,1,6416,201,104,97
6,1,912,40,17,23
6,1,1563,10,6,4
6,1,814,6,4,2
6,1,541,3,1,2
6,1,2002,63,29,34
6,1,846,0,0,0
6,1,961,11,6,5
6,1,882,3,2,1
6,1,1171,24,10,14
6,1,532,4,2,2
6,1,1097,18,8,10
6,1,1941,52,27,25
6,1,1022,7,4,3
6,1,578,4,1,3
6,1,549,4,2,2
6,1,696,1,1,0
6,1,822,1,0,1
6,1,967,8,4,4
6,1,798,7,4,3
6,1,1101,48,21,27
6,1,903,21,13,8
6,1,3965,28,11,17
6,1,5980,35,17,18
6,1,1165,5,3,2
6,1,806,8,3,5
6,1,697,85,49,36
6,1,483,2,2,0
6,1,641,32,17,15
6,1,400,24,14,10
6,1,926,4,3,1
6,1,1146,43,27,16
6,1,1276,33,19,14
6,1,1261,26,8,18
6,1,1397,11,5,6
6,1,1589,8,4,4
6,1,2872,23,11,12
6,1,875,10,3,7
6,1,520,19,13,6
6,1,495,19,7,12
6,1,383,5,3,2
6,1,535,0,0,0
6,1,1055,13,6,7
6,1,418,9,7,2
6,1,1698,118,58,60
6,1,870,3,1,2
6,1,1232,50,22,28
6,1,1118,20,9,11
6,1,291,0,0,0
6,1,754,15,8,7
6,1,655,5,2,3
6,1,1574,7,3,4
6,1,1408,11,7,4
6,1,3093,94,45,49
6,1,1043,23,13,10
6,1,454,5,2,3
6,1,694,13,5,8
6,1,977,7,4,3
6,1,1189,3,1,2
6,1,11630,65,36,29
6,1,2442,107,56,51
6,1,11232,373,208,165
6,1,1251,1,0,1
6,1,1214,6,3,3
6,1,2744,61,38,23
6,1,1086,6,4,2
6,1,883,8,6,2
6,1,1662,7,4,3
6,1,6096,230,110,120
6,1,1141,11,6,5
6,1,839,42,22,20
6,1,740,93,52,41
6,1,7357,93,38,55
6,1,2279,23,10,13
6,1,2164,20,9,11
6,1,4181,49,17,32
6,1,3075,6,0,6
6,1,295,0,0,0
6,1,2734,30,11,19
6,1,734,26,11,15
6,1,4130,33,17,16
6,1,5755,39,16,23
6,1,1247,16,8,8
6,1,1569,3,1,2
6,1,1076,10,5,5
6,1,969,42,16,26
6,1,1135,48,22,26
6,1,876,9,5,4
6,1,743,17,6,11
6,1,448,3,2,1
6,1,526,0,0,0
6,2,3213,255,137,118
6,2,1642,73,39,34
6,2,1630,74,34,40
6,2,2188,23,13,10
6,2,1484,32,14,18
6,2,413,1,0,1
6,2,111,0,0,0
6,2,554,1,0,1
6,2,2138,142,70,72
6,2,2035,13,9,4
6,2,751,11,2,9
6,2,2718,17,11,6
6,2,2843,25,12,13
6,3,4818,28,15,13
6,3,2097,26,11,15
6,3,1841,109,59,50
6,3,1552,23,11,12
6,3,923,21,11,10
6,3,1283,211,94,117
6,3,3060,199,106,93
6,3,352,0,0,0
6,3,445,0,0,0
6,3,304,0,0,0
6,3,343,0,0,0
6,3,1442,0,0,0
6,3,949,0,0,0
6,3,869,5,3,2
6,3,629,23,12,11
6,4,2899,17,8,9
6,4,1631,8,4,4
6,4,1257,8,1,7
6,4,1738,13,9,4
6,4,2268,39,18,21
6,4,2065,12,4,8
6,4,2525,5,4,1
6,4,1583,3,2,1
6,4,1007,2,1,1
6,4,1282,1,0,1
6,4,1692,3,0,3
6,4,1889,28,17,11
6,4,2003,5,1,4
6,4,1136,0,0,0
6,4,2403,14,7,7
6,4,2658,65,30,35
6,4,569,0,0,0
6,4,1152,1,1,0
6,5,10541,416,205,211
6,5,13520,213,99,114
6,5,6609,34,16,18
6,5,1496,4,2,2
6,5,893,14,6,8
6,5,1378,72,38,34
6,5,1961,163,101,62
6,5,14467,255,131,124
6,5,16930,317,161,156
6,5,2190,28,16,12
6,5,1704,19,13,6
6,5,1803,26,18,8
6,5,1219,4,2,2
6,5,849,0,0,0
6,5,9875,250,123,127
6,5,1149,37,23,14
6,5,1009,6,4,2
6,5,1467,6,2,4
6,5,959,6,5,1
6,5,1036,21,10,11
6,5,729,11,5,6
6,5,2342,11,5,6
6,5,3938,62,24,38
6,5,5395,76,43,33
6,5,2588,52,25,27
6,5,1781,10,4,6
6,5,1583,68,35,33
6,5,475,2,1,1
6,5,579,3,2,1
6,5,520,3,1,2
6,5,590,0,0,0
6,6,2939,29,17,12
6,6,2466,3,2,1
6,6,1024,9,5,4
6,6,1204,5,3,2
6,6,1122,7,3,4
6,6,644,1,1,0
6,6,1160,2,1,1
6,6,1554,3,1,2
6,6,1735,9,8,1
6,6,1003,46,21,25
6,6,901,30,15,15
6,6,1448,2,2,0
6,6,1642,4,2,2
6,6,1401,12,6,6
6,6,655,2,1,1
6,6,1283,0,0,0
6,6,1243,3,1,2
6,6,1245,1,1,0
6,6,1936,6,4,2
6,6,480,0,0,0
6,6,539,7,3,4
6,7,1448,9,5,4
6,7,1605,1,1,0
6,7,168,0,0,0
6,7,421,0,0,0
6,7,629,8,6,2
6,7,388,0,0,0
6,7,211,0,0,0
6,7,745,2,1,1
6,8,621,8,4,4
6,8,7,0,0,0
6,8,2322,13,4,9
6,8,589,39,13,26
6,8,1829,13,6,7
6,8,1091,3,2,1
6,8,1893,4,2,2
6,8,467,13,8,5
6,8,985,17,12,5
6,8,1479,12,6,6
6,8,1691,178,90,88
6,8,2262,22,13,9
6,8,572,1,1,0
6,8,1351,0,0,0
6,8,1187,6,4,2
6,8,1940,5,2,3
6,8,2508,7,4,3
6,8,1216,1,1,0
6,8,595,0,0,0
6,8,988,1,0,1
6,8,536,1,1,0
6,8,963,21,11,10
6,8,530,2,1,1
6,8,853,0,0,0
6,8,304,1,1,0
6,8,1439,1,0,1
6,8,1252,6,5,1
6,8,1074,7,3,4
6,8,1883,7,3,4
6,8,224,1,1,0
6,8,2974,55,29,26
6,8,404,0,0,0
6,8,1505,19,9,10
6,8,2170,57,32,25
6,8,2070,9,2,7
6,8,629,11,5,6
6,8,23045,276,137,139
6,8,3346,65,35,30
6,8,22011,575,285,290
6,8,856,10,6,4
6,8,1419,341,193,148
6,8,626,96,49,47
6,8,682,20,8,12
6,8,3159,11,4,7
6,8,13637,168,95,73
6,8,2313,111,60,51
6,8,3133,139,62,77
6,8,628,18,7,11
6,8,19221,202,101,101
6,8,923,0,0,0
6,8,16559,197,90,107
6,8,5431,109,58,51
6,8,2069,22,16,6
6,8,1674,21,9,12
6,8,660,8,1,7
6,8,375,0,0,0
6,8,1184,17,1,16
6,8,1165,6,3,3
6,8,3709,79,35,44
6,8,1716,23,11,12
6,8,3130,27,11,16
6,8,1891,52,27,25
6,8,1187,49,29,20
6,8,1779,37,18,19
6,8,2518,18,10,8
6,8,693,1,1,0
6,8,766,0,0,0
6,8,2375,2,1,1
6,8,695,9,4,5
6,8,2053,8,3,5
6,9,1971,18,12,6
6,9,2709,3,2,1
6,9,1572,7,4,3
6,9,932,1,1,0
6,9,265,0,0,0
6,9,1596,101,50,51
6,9,1186,11,6,5
6,10,4638,42,24,18
6,10,1344,4,2,2
6,10,670,0,0,0
6,10,11359,110,53,57
6,10,1048,8,2,6
6,10,3384,93,53,40
6,10,5102,53,25,28
6,10,902,5,4,1
6,10,823,0,0,0
6,10,5645,78,38,40
6,10,552,1,1,0
6,10,616,0,0,0
6,10,1132,66,35,31
6,10,4850,512,248,264
6,10,6187,34,19,15
6,10,1220,3,2,1
6,10,865,9,4,5
6,10,590,0,0,0
6,10,745,1,0,1
6,10,795,224,107,117
6,10,2138,716,369,347
6,10,1780,5,3,2
6,10,1167,2,0,2
6,10,676,1,0,1
6,10,798,8,4,4
6,10,2009,71,34,37
6,10,1114,0,0,0
6,10,1220,8,4,4
6,10,1366,1,1,0
6,10,655,1,1,0
6,10,1077,0,0,0
6,10,1485,2,2,0
6,10,955,7,3,4
6,10,1409,4,1,3
6,10,2604,12,8,4
6,10,4641,19,11,8
6,10,1029,14,6,8
6,10,1791,113,48,65
6,10,3679,34,16,18
6,10,5283,26,16,10
6,10,925,6,3,3
6,10,1045,10,3,7
6,10,1332,4,4,0
6,10,874,18,8,10
6,10,1825,10,5,5
6,10,661,1,0,1
6,10,1295,6,1,5
6,10,1401,8,5,3
6,10,891,57,35,22
6,10,1261,28,14,14
6,10,569,1,1,0
6,10,902,2,1,1
6,10,3073,5,3,2
6,10,226,0,0,0
6,10,217,0,0,0
6,10,365,28,14,14
6,10,352,6,3,3
6,10,4692,136,71,65
6,10,2779,84,48,36
6,10,2282,88,47,41
6,5,2521,105,51,54
6,5,3437,106,50,56
6,5,647,3,2,1
6,5,587,0,0,0
6,5,473,3,1,2
6,5,751,11,5,6
6,5,928,6,4,2
6,5,975,4,2,2
6,5,716,5,5,0
6,5,612,1,1,0
6,5,840,6,4,2
6,5,751,13,7,6
6,5,1005,1,0,1
6,5,993,6,3,3
6,5,607,24,11,13
6,5,936,11,2,9
6,5,529,9,5,4
6,5,889,7,3,4
6,5,1120,13,5,8
6,5,803,72,42,30
6,5,1093,26,10,16
6,5,932,3,2,1
6,5,1047,7,4,3
6,5,784,0,0,0
6,5,1590,22,13,9
6,5,1653,23,11,12
6,5,1558,12,5,7
6,5,420,1,0,1
6,5,649,1,1,0
6,5,415,21,9,12
6,5,1074,25,10,15
6,5,751,19,11,8
6,5,1257,20,7,13
6,5,1652,7,5,2
6,5,1337,17,9,8
6,5,987,25,12,13
7,1,2914,19,10,9
7,1,3703,23,16,7
7,1,809,0,0,0
7,1,1884,19,5,14
7,1,3001,28,14,14
7,2,3641,12,7,5
7,2,1653,1,1,0
7,2,4604,77,44,33
7,2,1638,0,0,0
7,2,1954,0,0,0
7,2,1287,3,2,1
7,2,1155,5,2,3
7,2,1363,0,0,0
7,122,2013,3,2,1
7,122,2559,8,4,4
7,122,3664,2,2,0
7,2,484,0,0,0
7,2,3415,5,2,3
7,122,2547,0,0,0
7,3,2028,4,2,2
7,3,1958,1,0,1
7,3,1441,10,4,6
7,3,2399,3,3,0
7,3,2443,1,0,1
7,3,2506,5,2,3
7,3,2164,23,11,12
7,3,3175,88,40,48
7,3,1455,22,11,11
7,3,1783,4,2,2
7,3,1778,6,3,3
7,3,1125,839,421,418
7,3,777,117,55,62
7,3,2861,3,0,3
7,4,4447,27,8,19
7,4,3378,19,9,10
7,4,5446,306,149,157
7,4,2329,7,3,4
7,4,3217,17,6,11
7,4,4517,7,1,6
7,4,4446,65,34,31
7,4,5001,34,22,12
7,4,3977,10,4,6
7,5,3527,3,1,2
7,5,1445,3,2,1
7,5,1058,1,0,1
7,5,994,5,3,2
7,5,3360,51,30,21
7,5,1611,4,2,2
7,5,5090,10,5,5
7,5,1975,10,4,6
7,5,2730,66,20,46
7,5,2841,6,1,5
7,6,2928,8,5,3
7,6,2320,2,0,2
7,6,1899,1,0,1
7,6,2404,11,5,6
7,6,562,0,0,0
7,6,2077,4,1,3
7,6,1722,0,0,0
7,6,2418,2,2,0
7,6,1618,2,2,0
7,6,922,5,2,3
7,6,3285,6,2,4
7,6,3384,1,1,0
7,6,3657,20,12,8
7,6,2487,5,1,4
7,7,2734,1,0,1
7,7,1816,2,2,0
7,7,3513,4,1,3
7,7,3194,0,0,0
7,8,2225,4,1,3
7,8,2584,12,5,7
7,8,2662,8,3,5
7,8,1829,3,3,0
7,8,2945,0,0,0
7,8,7105,13,7,6
7,8,4295,10,6,4
7,8,1405,6,2,4
7,8,3114,3,0,3
7,116,1159,2,0,2
7,8,2681,0,0,0
7,116,3500,5,2,3
7,8,742,0,0,0
7,8,599,0,0,0
7,116,1942,0,0,0
7,116,1787,3,1,2
7,9,1976,371,211,160
7,9,835,127,64,63
7,9,931,7,4,3
7,9,2832,18,9,9
7,9,2238,2,0,2
7,9,1051,11,8,3
7,9,498,5,4,1
7,9,2346,14,7,7
7,9,1320,2,0,2
7,9,1624,6,4,2
7,9,5441,56,33,23
7,9,2039,14,7,7
7,9,2323,22,8,14
7,9,351,3,1,2
7,9,589,11,4,7
7,9,1624,2,0,2
7,9,1770,0,0,0
7,9,1052,1,1,0
7,9,1811,10,4,6
7,9,614,1,0,1
7,9,253,0,0,0
7,9,1539,5,3,2
7,9,1854,7,3,4
7,9,2165,19,8,11
7,9,2067,7,4,3
7,10,2468,9,5,4
7,10,2575,5,1,4
7,10,2092,1,1,0
7,11,1410,0,0,0
7,11,1723,4,1,3
7,11,797,0,0,0
7,11,494,0,0,0
7,11,1363,7,4,3
7,11,2005,4,3,1
7,11,1332,1,1,0
7,11,1677,0,0,0
7,11,1962,1,0,1
7,11,958,7,4,3
7,11,1765,4,0,4
7,11,1674,0,0,0
7,11,2658,11,3,8
7,11,999,12,8,4
7,12,8606,104,54,50
7,12,3673,24,10,14
7,12,4067,32,13,19
7,12,3690,32,15,17
7,12,2887,36,10,26
7,12,3155,5,3,2
7,12,13278,92,54,38
7,12,1972,0,0,0
7,12,2470,2,1,1
7,12,943,1,0,1
7,12,951,0,0,0
7,12,1075,0,0,0
7,12,4673,28,11,17
7,12,12675,132,69,63
7,13,3914,24,12,12
7,13,3890,5,3,2
7,13,2006,5,2,3
7,13,3807,27,13,14
7,13,2838,186,89,97
7,13,2962,130,66,64
7,13,2881,3,3,0
7,13,5940,12,5,7
7,13,3922,0,0,0
7,13,4035,5,3,2
7,13,4400,2,0,2
7,14,1824,17,10,7
7,14,1546,1,1,0
7,14,6193,10,4,6
7,14,1262,1,0,1
7,14,3430,6,3,3
7,14,2180,19,6,13
7,14,2730,11,4,7
7,15,3084,22,13,9
7,15,5878,25,12,13
7,15,2396,29,15,14
7,15,2992,14,8,6
7,15,1852,2,0,2
7,15,1302,1,0,1
7,15,808,5,5,0
7,15,1578,3,0,3
7,15,946,0,0,0
7,15,1107,1,1,0
7,15,2139,3,2,1
7,15,837,1,1,0
7,15,1377,2,1,1
7,15,2137,6,3,3
7,15,858,8,3,5
7,15,2479,7,1,6
7,15,2525,69,36,33
7,15,2331,2,0,2
7,15,2845,15,5,10
7,15,2688,3,3,0
7,15,1988,5,3,2
7,15,3283,8,6,2
7,15,3063,3,1,2
7,16,1682,4,1,3
7,16,2138,2,1,1
7,16,1759,1,1,0
7,16,1052,0,0,0
7,16,752,0,0,0
7,16,653,1,1,0
7,16,1635,0,0,0
7,16,2982,0,0,0
7,16,2260,9,2,7
7,16,1373,8,2,6
7,16,928,6,0,6
7,17,2700,11,7,4
7,17,1277,6,3,3
7,17,3854,80,41,39
7,17,3234,2,1,1
7,17,811,2,0,2
7,17,2010,2,1,1
7,17,2209,0,0,0
7,17,1055,4,2,2
7,17,1654,1,1,0
7,17,2892,50,26,24
7,17,2932,29,16,13
7,17,3896,8,4,4
7,17,10620,63,32,31
7,17,2333,1,0,1
7,17,5441,60,40,20
7,17,3735,15,8,7
7,17,335,0,0,0
7,17,3446,24,14,10
7,17,2200,12,5,7
7,17,528,3,1,2
7,17,2794,2,1,1
7,17,1064,11,7,4
7,17,1794,1,1,0
7,17,1336,1,1,0
7,17,3557,4,3,1
7,17,1204,8,3,5
7,17,4523,17,6,11
7,17,1990,16,10,6
7,17,1862,28,16,12
7,17,791,7,3,4
7,17,403,0,0,0
7,17,760,0,0,0
7,17,1366,4,2,2
7,17,1851,0,0,0
7,17,1454,2,2,0
7,17,1797,0,0,0
7,17,1495,0,0,0
7,18,1548,1,1,0
7,18,1825,2,1,1
7,18,1393,1,0,1
7,18,2892,6,3,3
7,18,2621,3,0,3
7,19,7160,52,28,24
7,19,2284,14,7,7
7,19,884,4,3,1
7,19,5007,44,24,20
7,19,2192,17,10,7
7,19,7721,24,11,13
7,19,1347,5,3,2
7,19,1060,1,1,0
7,19,924,3,1,2
7,19,3740,11,5,6
7,19,4597,23,11,12
7,19,1518,3,1,2
7,19,1231,20,9,11
7,19,440,2,1,1
7,19,696,6,4,2
7,19,1554,3,1,2
7,19,4600,21,10,11
7,19,4313,16,11,5
7,19,2647,2,0,2
7,19,979,4,2,2
7,19,3266,26,15,11
7,19,14839,309,154,155
7,19,4976,4,1,3
7,19,4135,16,9,7
7,19,8902,185,93,92
7,19,4127,2,0,2
7,19,11125,41,25,16
7,19,2618,1,0,1
7,19,2066,3,2,1
7,19,926,0,0,0
7,19,2700,4,0,4
7,19,2119,2,1,1
7,19,1272,5,1,4
7,19,2339,4,4,0
7,19,1017,0,0,0
7,19,2606,3,1,2
7,19,1466,6,4,2
7,19,2387,23,8,15
7,19,895,0,0,0
7,19,3164,3,0,3
7,19,2367,4,2,2
7,19,844,1,1,0
7,19,2240,20,7,13
7,19,2630,4,1,3
7,19,3074,17,11,6
7,19,1441,1,0,1
7,19,2812,8,4,4
7,19,1941,2,2,0
7,19,1785,9,2,7
7,19,4410,13,4,9
7,19,2940,4,3,1
7,19,2025,8,1,7
7,19,1564,1,0,1
7,20,2914,9,5,4
7,20,2293,19,7,12
7,20,1438,74,37,37
7,20,1798,50,21,29
7,20,471,0,0,0
7,20,2139,278,147,131
7,20,4099,164,75,89
7,20,3354,164,90,74
7,20,2358,11,5,6
7,20,2068,0,0,0
7,20,1043,3,1,2
7,20,348,15,7,8
7,20,1172,4,2,2
7,20,1353,0,0,0
7,20,1914,3,3,0
7,20,2377,5,1,4
7,20,1081,1,1,0
7,20,2159,13,3,10
7,20,3156,10,6,4
7,20,2848,8,2,6
7,20,1663,631,300,331
7,20,2513,158,72,86
7,20,2706,8,3,5
7,20,2855,3,1,2
7,21,1371,54,26,28
7,21,2142,26,16,10
7,21,1294,18,7,11
7,21,1834,56,31,25
7,21,2515,179,90,89
7,21,1231,0,0,0
7,21,804,42,24,18
7,21,903,0,0,0
7,21,1495,3,2,1
7,21,1598,1,0,1
7,21,1064,12,3,9
7,21,1938,6,1,5
7,21,2205,8,3,5
7,21,1807,19,11,8
7,22,1430,0,0,0
7,22,5782,3,0,3
7,22,4801,3,1,2
7,22,5236,6,3,3
7,22,5238,11,5,6
7,23,1312,3,0,3
7,23,1880,11,7,4
7,23,2683,2,2,0
7,23,3587,5,2,3
7,23,3391,1,1,0
7,23,2094,3,2,1
7,23,2658,2,1,1
7,23,2304,26,14,12
7,23,3858,11,6,5
7,23,1310,16,9,7
7,23,4316,4,3,1
7,23,2980,7,4,3
7,23,694,1,1,0
7,23,2630,47,20,27
7,23,2395,0,0,0
7,23,3646,2,2,0
7,23,1980,4,2,2
7,23,1403,0,0,0
7,23,816,0,0,0
7,23,2273,1,1,0
7,23,3226,4,1,3
7,23,2941,2,2,0
7,23,3316,12,5,7
7,23,3665,1,0,1
7,23,1429,0,0,0
7,23,2713,7,4,3
7,23,3528,10,6,4
7,23,2703,4,1,3
7,23,2396,4,2,2
7,23,1943,0,0,0
7,23,3801,46,24,22
7,23,4120,28,11,17
7,23,1959,18,9,9
7,23,4324,9,5,4
7,23,2116,0,0,0
7,23,1058,1,1,0
7,23,3202,3,3,0
7,23,1707,4,3,1
7,24,3595,7,3,4
7,24,2320,4,2,2
7,24,1775,4,3,1
7,24,1358,2,0,2
7,24,1102,1,0,1
7,24,3481,6,3,3
7,25,3404,734,385,349
7,25,1437,318,140,178
7,25,1832,91,44,47
7,26,2990,4,3,1
7,26,512,159,79,80
7,26,2474,2,1,1
7,26,2107,10,5,5
7,26,3484,40,16,24
7,26,4317,15,7,8
7,26,2218,2,1,1
7,26,2291,3,3,0
7,26,2718,2,1,1
7,26,2905,2,1,1
7,26,2268,16,8,8
7,26,3241,5,2,3
7,26,3320,5,2,3
7,112,3349,184,98,86
7,112,5131,5,4,1
7,26,3436,17,11,6
7,26,3717,10,8,2
7,27,17291,176,88,88
7,27,4780,19,10,9
7,27,9536,67,34,33
7,27,5491,23,11,12
7,27,1901,3,1,2
7,27,2766,1,0,1
7,27,1361,6,4,2
7,27,1267,5,2,3
7,27,1431,10,5,5
7,27,3031,22,10,12
7,27,2430,7,5,2
7,27,4874,7,2,5
7,27,3316,1,0,1
7,27,3726,5,3,2
7,27,1534,0,0,0
7,27,2065,27,9,18
7,27,1525,2,0,2
7,27,1188,3,1,2
7,27,1451,6,3,3
7,27,1724,3,1,2
7,27,2188,1,0,1
7,27,3005,7,3,4
7,27,2065,3,1,2
7,27,1436,1,0,1
7,27,1637,0,0,0
7,27,2066,7,0,7
7,27,1464,5,2,3
7,27,2153,0,0,0
7,27,2481,35,19,16
7,28,1926,0,0,0
7,28,3177,6,4,2
7,28,1030,3,1,2
7,29,2048,9,7,2
7,29,2351,2,1,1
7,29,1003,1,1,0
7,30,2302,3,2,1
7,30,2381,3,1,2
7,30,3096,2,0,2
7,30,1986,10,4,6
7,30,708,0,0,0
7,30,3501,5,2,3
7,30,1842,4,2,2
7,30,2155,0,0,0
7,30,3091,17,5,12
7,30,2411,4,2,2
7,30,2997,1,1,0
7,30,1981,1,0,1
7,30,2044,9,6,3
7,30,1993,2,1,1
7,30,1371,0,0,0
7,30,1783,0,0,0
7,30,1431,1,0,1
7,31,3467,24,15,9
7,31,3264,7,4,3
7,31,3850,12,3,9
7,31,3644,6,2,4
7,31,2379,4,1,3
7,31,3730,8,3,5
7,31,4495,8,3,5
7,31,4460,3,1,2
7,31,3772,3,1,2
7,31,3613,4,3,1
7,31,2694,14,8,6
7,31,2719,2,2,0
7,31,2939,3,1,2
7,31,3243,5,2,3
7,31,2744,15,7,8
7,31,5363,7,3,4
7,31,1593,2,1,1
7,31,3507,8,4,4
7,31,4860,3,1,2
7,31,5895,126,59,67
7,31,3027,8,5,3
7,31,2995,3,2,1
7,31,3264,26,12,14
7,31,2599,18,9,9
7,31,2896,6,2,4
7,31,6617,1372,711,661
7,31,4489,9,3,6
7,32,2501,11,5,6
7,32,1767,0,0,0
7,32,1149,20,8,12
7,32,1063,9,0,9
7,32,1122,2,1,1
7,32,1218,2,2,0
7,32,1888,1,1,0
7,32,3401,10,4,6
7,32,2761,1,0,1
7,32,2114,1,0,1
7,32,2863,7,3,4
7,32,2176,11,5,6
7,33,4604,148,71,77
7,33,1914,1042,519,523
7,34,6045,26,10,16
7,34,10036,31,17,14
7,34,6831,17,8,9
7,34,4759,5,3,2
7,34,1448,0,0,0
7,34,887,0,0,0
7,34,2486,2,2,0
7,34,2369,2,2,0
7,34,1540,0,0,0
7,34,3475,12,6,6
7,34,854,0,0,0
7,34,1495,1,0,1
7,34,2048,1,1,0
7,34,1588,2,1,1
7,34,204,1,0,1
7,34,3544,9,6,3
7,34,2418,4,2,2
7,34,1213,4,3,1
7,34,1429,0,0,0
7,34,1677,1,0,1
7,34,1872,2,2,0
7,34,2033,3,0,3
7,34,1857,1,1,0
7,34,1226,5,2,3
7,34,3971,8,4,4
7,34,4434,2,1,1
7,34,1811,0,0,0
7,35,2744,37,18,19
7,35,1541,17,9,8
7,35,2866,30,8,22
7,35,3084,4,1,3
7,36,3524,23,12,11
7,36,1834,2,0,2
7,36,2282,0,0,0
7,37,3661,13,5,8
7,37,2161,17,11,6
7,37,2234,6,3,3
7,37,2913,2,0,2
7,37,1287,2,0,2
7,37,2238,9,5,4
7,37,2868,0,0,0
7,37,2316,8,4,4
7,37,3580,11,4,7
7,37,877,1,1,0
7,37,670,3,0,3
7,37,991,3,2,1
7,37,3040,10,5,5
7,37,2694,7,3,4
7,37,3772,7,1,6
7,37,1110,12,5,7
7,38,2856,7,4,3
7,38,2725,1,0,1
7,38,3319,39,21,18
7,38,2847,7,3,4
7,38,3633,11,6,5
7,38,3050,7,2,5
7,38,2348,16,6,10
7,38,2711,33,15,18
7,38,1156,7,6,1
7,38,3067,13,8,5
7,39,2252,39,21,18
7,39,997,1,0,1
7,39,2238,1,0,1
7,39,1089,0,0,0
7,39,1975,5,2,3
7,39,2838,7,2,5
7,39,1854,3,2,1
7,39,1939,3,1,2
7,39,3332,2,1,1
7,39,2833,8,4,4
7,39,2972,51,31,20
7,40,3489,19,10,9
7,40,2799,16,9,7
7,40,1512,4,2,2
7,40,1256,30,20,10
7,40,4393,30,17,13
7,40,832,11,8,3
7,40,999,8,3,5
7,40,1797,2,2,0
7,40,1067,9,4,5
7,40,2152,17,7,10
7,40,5148,12,4,8
7,40,664,6,2,4
7,40,3403,9,2,7
7,40,4280,25,8,17
7,40,1399,0,0,0
7,40,861,1,1,0
7,40,1484,1,1,0
7,40,2334,8,2,6
7,40,2637,7,4,3
7,40,1846,4,1,3
7,40,1443,2,2,0
7,40,2842,6,2,4
7,40,2868,16,7,9
7,40,1288,4,1,3
7,40,659,0,0,0
7,41,5007,10,6,4
7,41,1088,1,0,1
7,41,3587,2,1,1
7,41,3118,5,3,2
7,41,2662,5,5,0
7,41,2719,24,12,12
7,41,3344,1,1,0
7,41,3579,35,20,15
7,41,1729,1,0,1
7,41,2871,7,3,4
7,41,3344,4,2,2
7,41,2025,2,1,1
7,41,2934,4,2,2
7,41,2520,2,2,0
7,42,1758,4,1,3
7,42,3834,5,2,3
7,42,2790,4,3,1
7,42,3239,15,7,8
7,43,2160,53,29,24
7,43,3027,33,17,16
7,43,1769,7,3,4
7,43,1177,2,1,1
7,43,726,13,3,10
7,43,2194,209,112,97
7,44,2060,2,1,1
7,44,3058,5,2,3
7,44,4045,61,29,32
7,44,2630,3,1,2
7,44,3394,694,358,336
7,44,3135,55,27,28
7,44,3614,8,4,4
7,44,3324,6,2,4
7,44,2925,7,3,4
7,45,2865,6,3,3
7,45,3560,408,200,208
7,46,1772,30,12,18
7,46,2908,3,3,0
7,46,1603,6,5,1
7,46,2815,9,6,3
7,46,2773,5,2,3
7,46,2859,13,5,8
7,46,3041,10,6,4
7,46,646,1,0,1
7,46,853,1,0,1
7,46,1772,4,0,4
7,46,1180,2,1,1
7,46,1572,0,0,0
7,46,1366,8,1,7
7,46,2245,5,4,1
7,46,2354,10,5,5
7,46,1388,0,0,0
7,46,1472,6,3,3
7,46,1018,2,2,0
7,46,908,0,0,0
7,46,1267,0,0,0
7,46,2253,25,11,14
7,46,1107,1,0,1
7,46,1484,7,4,3
7,46,1378,1,0,1
7,47,4160,155,65,90
7,47,3744,6,6,0
7,47,4660,86,36,50
7,47,2235,10,4,6
7,47,2870,3,1,2
7,47,5154,9,3,6
7,47,2234,2,1,1
7,48,1434,8,3,5
7,48,1490,6,3,3
7,48,1955,16,9,7
7,48,1710,20,9,11
7,48,1285,8,4,4
7,48,2652,12,4,8
7,48,486,1,1,0
7,48,3788,40,16,24
7,48,1725,0,0,0
7,48,1492,2,1,1
7,48,1221,4,4,0
7,48,1304,22,10,12
7,48,1377,11,5,6
7,49,3589,15,3,12
7,49,1611,0,0,0
7,49,3524,5,3,2
7,118,4959,19,10,9
7,49,3804,4,1,3
7,49,2965,3,0,3
7,49,2802,3,1,2
7,49,4832,3,3,0
7,49,3058,37,22,15
7,49,2725,2,1,1
7,50,554,38,24,14
7,50,1663,6,3,3
7,50,1006,1,0,1
7,50,1012,1,1,0
7,50,869,0,0,0
7,51,2426,27,4,23
7,51,1545,14,7,7
7,51,2606,4,3,1
7,51,2384,11,8,3
7,51,1499,12,6,6
7,51,1783,15,5,10
7,51,1686,8,2,6
7,51,2291,2,2,0
7,51,3174,8,2,6
7,51,711,1,1,0
7,51,1526,5,4,1
7,51,1491,2,0,2
7,51,1556,3,2,1
7,51,422,0,0,0
7,51,2025,1,1,0
7,51,2969,3,1,2
7,51,3068,6,3,3
7,51,2013,3,3,0
7,51,1828,2,1,1
7,51,3057,10,6,4
7,52,3666,50,25,25
7,52,3964,8,4,4
7,52,6047,10,5,5
7,52,4119,8,4,4
7,52,4816,11,6,5
7,52,4103,23,14,9
7,52,3864,23,12,11
7,52,4178,47,24,23
7,52,3723,12,8,4
7,52,2488,2,0,2
7,52,2669,1,1,0
7,52,4619,14,5,9
7,52,4195,1,0,1
7,52,4403,13,4,9
7,52,5067,3,3,0
7,52,2917,13,5,8
7,52,2933,6,3,3
7,52,4236,5,0,5
7,52,4213,16,8,8
7,52,2868,8,2,6
7,52,4217,9,3,6
7,52,4056,21,9,12
7,52,4123,6,1,5
7,52,3645,8,4,4
7,52,3801,2,1,1
7,52,5873,1,1,0
7,52,3865,4,4,0
7,52,1803,0,0,0
7,114,4610,7,4,3
7,114,2163,122,67,55
7,52,3195,6,0,6
7,52,2711,8,5,3
7,52,4367,24,9,15
7,52,3195,8,1,7
7,52,2404,7,3,4
7,52,1975,7,3,4
7,52,1342,2,1,1
7,114,3051,186,92,94
7,114,2619,139,69,70
7,114,3575,627,301,326
7,52,2471,15,5,10
7,53,2559,20,9,11
7,53,1012,3,1,2
7,53,1785,0,0,0
7,53,1237,1,0,1
7,53,1362,1,1,0
7,54,3020,3,2,1
7,54,3709,20,9,11
7,54,3412,3,2,1
7,54,678,0,0,0
7,54,1230,8,2,6
7,54,1830,104,51,53
7,54,1744,6,2,4
7,54,2175,1,1,0
7,54,2204,13,5,8
7,54,2281,1,1,0
7,54,1386,2,0,2
7,54,1302,3,0,3
7,54,1386,1,0,1
7,54,1097,4,0,4
7,54,1037,0,0,0
7,55,4153,33,16,17
7,55,2426,9,5,4
7,56,1705,110,47,63
7,56,2856,0,0,0
7,56,4256,1,1,0
7,56,4964,4,2,2
7,56,2557,4,2,2
7,57,7536,10,4,6
7,57,1463,7,2,5
7,57,2732,6,4,2
7,57,2650,2,1,1
7,57,1264,4,2,2
7,57,5911,16,9,7
7,57,3600,2,1,1
7,57,1856,3,1,2
7,57,1363,6,1,5
7,57,4136,2,0,2
7,57,1924,3,1,2
7,57,1828,2,1,1
7,57,602,1,1,0
7,57,1886,1,1,0
7,57,2387,8,3,5
7,57,1201,0,0,0
7,57,1360,2,0,2
7,57,1826,3,0,3
7,57,6880,30,17,13
7,57,1032,3,2,1
7,57,3428,2,2,0
7,57,4198,5,3,2
7,57,2733,0,0,0
7,57,1749,4,0,4
7,57,2846,8,4,4
7,57,1613,3,2,1
7,58,4765,151,70,81
7,59,3385,126,68,58
7,59,12469,35,18,17
7,59,3116,30,15,15
7,59,6089,29,17,12
7,59,5578,57,37,20
7,59,13261,81,38,43
7,59,535,0,0,0
7,59,1906,0,0,0
7,59,2039,19,5,14
7,59,1203,17,6,11
7,59,2687,15,3,12
7,59,2447,12,4,8
7,59,2021,14,6,8
7,59,3237,5,2,3
7,59,2861,1,0,1
7,59,2630,5,2,3
7,59,2972,9,3,6
7,59,5110,8,4,4
7,59,4012,5,2,3
7,59,11872,82,39,43
7,59,3454,7,3,4
7,59,1535,12,10,2
7,59,1973,6,4,2
7,59,4601,45,18,27
7,59,4066,7,2,5
7,59,2734,2,1,1
7,59,10838,77,38,39
7,59,8331,54,23,31
7,59,3953,49,18,31
7,59,4437,4,3,1
7,59,4306,7,4,3
7,59,3262,25,15,10
7,59,5656,75,38,37
7,59,5077,58,32,26
7,59,4002,5,1,4
7,59,1332,2,1,1
7,59,492,0,0,0
7,59,3764,3,0,3
7,59,3673,1,1,0
7,59,3829,6,3,3
7,59,5846,12,4,8
7,59,3585,406,208,198
7,59,5128,7,3,4
7,59,4887,19,7,12
7,59,4342,20,11,9
7,59,5107,16,4,12
7,59,3336,20,3,17
7,59,5179,15,4,11
7,59,3919,3,1,2
7,59,2405,3,1,2
7,113,3330,0,0,0
7,113,4670,8,5,3
7,113,4176,3,1,2
7,59,6227,4,3,1
7,59,3380,17,10,7
7,59,2172,19,9,10
7,115,2471,4,2,2
7,113,3462,9,5,4
7,115,1637,5,4,1
7,115,5074,65,32,33
7,115,1625,1,0,1
7,113,4549,9,2,7
7,113,3416,25,6,19
7,115,2074,13,8,5
7,59,1439,0,0,0
7,60,5608,527,273,254
7,60,3480,32,17,15
7,60,5084,8,2,6
7,61,5722,314,162,152
7,61,2011,13,8,5
7,61,7045,83,37,46
7,61,3310,9,2,7
7,61,1990,53,29,24
7,61,4673,42,19,23
7,61,1427,3,3,0
7,61,4316,24,13,11
7,61,3220,17,9,8
7,61,8376,24,12,12
7,61,6400,10,4,6
7,61,2139,0,0,0
7,61,4033,3,1,2
7,61,4020,16,6,10
7,61,2467,44,23,21
7,61,5996,51,29,22
7,61,1088,0,0,0
7,61,3763,77,40,37
7,61,1369,2,0,2
7,61,2439,66,33,33
7,61,1673,1,0,1
7,61,1823,3,1,2
7,61,1275,1,1,0
7,61,2910,12,5,7
7,61,2123,1,0,1
7,61,2015,5,0,5
7,61,2417,8,4,4
7,62,3693,43,21,22
7,62,1349,27,14,13
7,62,2826,39,18,21
7,62,683,1,0,1
7,62,2187,2,2,0
7,62,1128,3,1,2
7,62,1781,7,2,5
7,62,768,3,1,2
7,62,435,1,0,1
7,63,2556,41,21,20
7,63,1492,1,1,0
7,64,3030,10,4,6
7,64,5006,14,6,8
7,64,2363,1,0,1
7,64,1843,4,3,1
7,64,3342,23,11,12
7,64,2699,426,203,223
7,64,1887,11,2,9
7,64,3627,4,2,2
7,64,530,4,1,3
7,64,1219,2,0,2
7,64,2060,1,0,1
7,64,2198,9,3,6
7,64,3976,13,5,8
7,64,2803,6,4,2
7,64,4350,10,4,6
7,64,4569,15,10,5
7,64,720,2,1,1
7,64,2419,0,0,0
7,64,2515,10,3,7
7,65,4909,43,17,26
7,65,10293,35,16,19
7,65,2782,13,5,8
7,65,15687,153,93,60
7,65,3008,137,78,59
7,65,6682,33,15,18
7,65,3714,231,113,118
7,65,4467,645,337,308
7,65,3057,7,4,3
7,65,2670,6,5,1
7,65,1588,6,2,4
7,65,2713,6,3,3
7,65,2388,2,0,2
7,65,2326,3,2,1
7,65,1901,7,3,4
7,65,3365,27,11,16
7,65,1160,2,2,0
7,65,3632,5,2,3
7,65,3311,21,8,13
7,65,4003,12,6,6
7,65,4212,1,0,1
7,65,989,5,1,4
7,65,1125,2,0,2
7,65,2849,2,1,1
7,65,2360,3,2,1
7,65,2825,18,6,12
7,65,3558,30,17,13
7,65,5306,7,3,4
7,65,3285,6,2,4
7,65,5462,59,29,30
7,65,3016,2,0,2
7,66,709,1,0,1
7,66,3842,10,3,7
7,66,4979,8,3,5
7,66,2644,4,2,2
7,66,2243,11,5,6
7,66,6490,9,4,5
7,66,2587,0,0,0
7,66,5275,36,18,18
7,67,3522,4,1,3
7,67,1962,1,0,1
7,67,1430,1,0,1
7,67,916,1,0,1
7,67,3517,17,6,11
7,68,5080,16,7,9
7,68,971,4,2,2
7,68,2241,11,7,4
7,68,1240,3,2,1
7,68,622,33,20,13
7,68,4653,7,1,6
7,68,1217,21,10,11
7,68,2493,6,4,2
7,68,1612,5,2,3
7,68,1030,0,0,0
7,68,1384,8,4,4
7,68,834,11,3,8
7,68,1067,44,19,25
7,68,1502,0,0,0
7,68,109,0,0,0
7,68,281,4,0,4
7,68,2552,14,5,9
7,68,1992,17,9,8
7,69,3681,25,16,9
7,69,728,0,0,0
7,69,2979,24,11,13
7,69,2314,14,10,4
7,69,1062,5,3,2
7,69,1307,2,2,0
7,69,7825,24,12,12
7,69,720,1,1,0
7,69,1536,6,4,2
7,69,2348,3,1,2
7,69,2336,2,1,1
7,69,1603,9,4,5
7,69,1186,0,0,0
7,69,2575,4,2,2
7,69,1835,161,86,75
7,69,763,2,1,1
7,69,2362,6,3,3
7,69,1326,1,0,1
7,69,1414,3,1,2
7,69,734,0,0,0
7,69,2103,4,2,2
7,69,1403,4,2,2
7,69,1738,7,5,2
7,69,1498,3,1,2
7,69,2054,6,3,3
7,69,1586,16,7,9
7,70,4139,8,0,8
7,70,2103,4,2,2
7,70,2175,27,12,15
7,70,2117,11,2,9
7,70,2272,6,2,4
7,71,3306,26,9,17
7,71,1928,2,1,1
7,71,5840,6,4,2
7,71,3585,9,4,5
7,71,2676,73,38,35
7,71,1836,2,0,2
7,120,5910,17,5,12
7,120,2808,0,0,0
7,71,6707,23,10,13
7,71,3077,301,153,148
7,72,4002,72,30,42
7,72,3123,87,38,49
7,72,3472,5,3,2
7,73,3261,24,10,14
7,73,1246,19,10,9
7,73,671,0,0,0
7,73,912,14,6,8
7,73,1204,16,5,11
7,73,1562,85,43,42
7,73,1413,1,1,0
7,73,1759,0,0,0
7,73,1804,8,4,4
7,73,4207,17,9,8
7,73,1555,4,1,3
7,73,2193,0,0,0
7,73,4044,23,10,13
7,73,2312,1,1,0
7,73,1812,2,1,1
7,73,923,4,2,2
7,73,2800,7,5,2
7,74,2026,10,6,4
7,74,3236,8,3,5
7,74,1371,0,0,0
7,74,1360,6,2,4
7,74,1320,12,6,6
7,74,998,1,1,0
7,74,4639,15,7,8
7,74,1010,1,0,1
7,74,4678,62,30,32
7,74,3368,1,1,0
7,74,2693,5,3,2
7,74,2082,2,1,1
7,75,3177,59,30,29
7,75,2965,6,3,3
7,75,3513,5,1,4
7,75,3044,6,2,4
7,75,2665,6,4,2
7,75,4153,5,3,2
7,75,4102,1,0,1
7,75,2611,7,3,4
7,75,2477,4,3,1
7,75,1810,3,1,2
7,76,3720,34,20,14
7,76,1268,56,27,29
7,76,1811,2,1,1
7,76,1514,3,3,0
7,76,3228,11,7,4
7,76,2352,15,10,5
7,76,4438,11,3,8
7,76,2579,39,23,16
7,76,4449,143,65,78
7,76,1875,4,2,2
7,76,3200,105,53,52
7,76,3490,178,87,91
7,76,2422,1383,698,685
7,76,2346,3,3,0
7,76,3562,7,3,4
7,76,3044,2,1,1
7,76,3392,3,2,1
7,76,2807,76,43,33
7,76,1923,3,1,2
7,76,5322,5,2,3
7,76,4222,6,2,4
7,77,6052,46,21,25
7,77,20033,315,156,159
7,77,7112,24,8,16
7,77,4378,17,6,11
7,77,1206,1,1,0
7,77,5739,150,78,72
7,77,7505,35,18,17
7,77,6096,78,42,36
7,77,1709,14,7,7
7,77,799,9,4,5
7,77,2475,11,6,5
7,77,4242,32,20,12
7,77,3174,76,41,35
7,77,3107,20,9,11
7,77,3179,33,15,18
7,77,3312,8,5,3
7,77,8728,97,49,48
7,77,1390,9,2,7
7,77,1113,10,7,3
7,77,848,8,5,3
7,77,2200,20,14,6
7,77,3132,21,9,12
7,77,2611,14,5,9
7,77,812,10,6,4
7,77,517,4,2,2
7,77,452,12,5,7
7,77,1234,28,14,14
7,77,2797,14,7,7
7,77,6209,207,114,93
7,77,5054,153,89,64
7,77,1818,19,8,11
7,77,1223,17,11,6
7,77,1536,3,1,2
7,77,4919,13,8,5
7,77,4249,41,21,20
7,77,6955,57,28,29
7,77,8898,1170,618,552
7,77,8794,808,418,390
7,77,3584,25,11,14
7,77,1494,3,1,2
7,77,3137,4,2,2
7,77,3383,12,7,5
7,77,20930,155,81,74
7,77,3695,20,12,8
7,77,2289,5,3,2
7,77,3055,21,12,9
7,77,863,2,0,2
7,77,115,0,0,0
7,77,1671,28,11,17
7,77,633,3,2,1
7,78,4148,26,14,12
7,78,2353,14,9,5
7,78,2863,3,2,1
7,78,4840,21,9,12
7,78,1368,0,0,0
7,78,3060,218,117,101
7,78,802,14,9,5
7,78,2506,14,4,10
7,78,2353,11,6,5
7,78,3098,16,10,6
7,78,3921,7,3,4
7,78,4342,12,8,4
7,79,813,0,0,0
7,79,110,0,0,0
7,79,3922,5,1,4
7,79,4578,3,3,0
7,79,4506,189,104,85
7,79,2350,10,3,7
7,79,10066,12,7,5
7,80,3873,4,2,2
7,80,3133,274,131,143
7,81,2961,3,1,2
7,81,3692,7,4,3
7,124,686,1,0,1
7,81,1244,2,1,1
7,81,2149,0,0,0
7,124,2620,9,3,6
7,124,3633,13,2,11
7,119,1634,1,0,1
7,119,2681,3,1,2
7,124,2346,6,4,2
7,81,345,2,1,1
7,81,3308,0,0,0
7,81,2032,7,2,5
7,81,1247,4,4,0
7,81,2926,2,1,1
7,81,1639,1,1,0
7,124,2365,3,0,3
7,81,3121,2,1,1
7,82,3696,8,4,4
7,82,3707,61,30,31
7,82,6907,6,2,4
7,82,2116,49,20,29
7,82,1651,3,0,3
7,82,7010,49,20,29
7,117,5721,388,198,190
7,82,2165,0,0,0
7,82,3399,3,0,3
7,82,2545,13,6,7
7,82,3280,2,1,1
7,82,4450,8,2,6
7,82,5021,6,4,2
7,82,4227,5,2,3
7,82,2575,1,0,1
7,83,3044,2,1,1
7,83,3071,10,3,7
7,83,3137,12,7,5
7,83,6063,20,12,8
7,84,3276,29,16,13
7,84,1958,6,3,3
7,84,2822,4,2,2
7,84,1467,0,0,0
7,84,2769,117,54,63
7,84,3523,16,10,6
7,84,2051,8,4,4
7,85,3364,14,5,9
7,85,1711,2,1,1
7,85,3641,26,10,16
7,86,3046,32,13,19
7,86,2719,17,8,9
7,86,1321,1,0,1
7,86,3616,169,97,72
7,87,2980,17,6,11
7,87,8190,43,19,24
7,87,2816,7,3,4
7,87,3432,6,0,6
7,87,1616,3,0,3
7,87,4192,9,3,6
7,87,2926,6,4,2
7,88,2874,3,0,3
7,88,929,1,1,0
7,88,2695,3,3,0
7,88,6229,6,5,1
7,88,3380,5,2,3
7,88,3069,21,8,13
7,88,1486,3,1,2
7,88,3678,17,7,10
7,88,1561,67,33,34
7,88,1771,5,2,3
7,88,2432,93,46,47
7,88,1765,493,226,267
7,88,3024,19,7,12
7,88,2051,19,13,6
7,88,1088,5,1,4
7,88,1712,3,1,2
7,88,1499,1,1,0
7,89,2955,4,3,1
7,90,3206,215,104,111
7,90,980,15,9,6
7,90,8591,214,98,116
7,90,2385,25,13,12
7,90,2134,64,29,35
7,90,7879,47,22,25
7,90,1616,47,21,26
7,90,2255,108,50,58
7,90,1647,70,35,35
7,90,1266,12,5,7
7,90,4380,21,12,9
7,90,1022,48,18,30
7,90,1566,180,71,109
7,90,812,10,7,3
7,90,3535,27,13,14
7,90,3694,21,5,16
7,90,1603,30,15,15
7,90,773,9,5,4
7,90,773,27,11,16
7,90,942,20,9,11
7,90,1244,29,13,16
7,90,1258,24,12,12
7,90,526,8,4,4
7,90,525,2,1,1
7,90,1022,13,4,9
7,90,715,14,5,9
7,90,1240,9,4,5
7,90,1053,12,6,6
7,90,3254,22,11,11
7,90,1819,22,10,12
7,90,1720,25,8,17
7,90,1098,35,19,16
7,90,479,30,14,16
7,90,422,3,0,3
7,90,1018,14,4,10
7,90,1289,132,61,71
7,90,389,0,0,0
7,90,1019,5,2,3
7,90,1646,58,24,34
7,90,285,12,5,7
7,90,734,23,10,13
7,90,1092,52,25,27
7,90,561,1,0,1
7,90,903,10,8,2
7,90,1590,29,15,14
7,90,3092,13,7,6
7,90,3783,43,14,29
7,90,1493,15,7,8
7,90,879,2,1,1
7,90,836,14,8,6
7,90,386,0,0,0
7,90,653,7,5,2
7,90,524,13,6,7
7,90,536,2,1,1
7,90,1235,23,9,14
7,90,1082,9,4,5
7,90,2449,47,25,22
7,90,2096,8,0,8
7,90,959,14,5,9
7,90,589,4,3,1
7,90,1258,1,0,1
7,90,1614,3,3,0
7,90,1736,1,1,0
7,90,2776,5,2,3
7,90,1248,12,3,9
7,90,1705,10,5,5
7,90,3753,30,19,11
7,90,2217,5,2,3
7,90,2806,44,22,22
7,90,5952,29,11,18
7,90,2982,35,14,21
7,90,1700,11,2,9
7,90,2978,29,15,14
7,90,2822,23,7,16
7,90,20867,136,64,72
7,90,2097,5,3,2
7,90,5204,19,7,12
7,90,7309,45,19,26
7,90,2172,7,4,3
7,90,1446,2,2,0
7,90,3052,4,1,3
7,90,1384,1,0,1
7,90,274,0,0,0
7,90,1145,1,0,1
7,90,728,2,2,0
7,90,2496,5,3,2
7,90,1950,2,0,2
7,90,705,1,1,0
7,90,1562,3,3,0
7,90,1458,4,2,2
7,90,1135,0,0,0
7,90,727,3,1,2
7,90,1242,1,0,1
7,90,2281,8,3,5
7,90,1652,7,5,2
7,90,1623,3,2,1
7,90,1614,5,3,2
7,90,1070,138,67,71
7,90,1224,0,0,0
7,90,739,3,1,2
7,90,1412,4,3,1
7,90,1787,2,2,0
7,90,555,4,2,2
7,90,2209,11,7,4
7,90,2619,27,13,14
7,90,976,6,2,4
7,90,1641,2,0,2
7,90,3022,3,2,1
7,90,3497,5,2,3
7,90,1684,4,1,3
7,90,9521,56,25,31
7,90,1754,3,1,2
7,90,4096,13,7,6
7,90,2771,8,6,2
7,90,3598,4,3,1
7,90,2708,2,2,0
7,90,1095,6,3,3
7,90,1603,8,5,3
7,90,8016,136,68,68
7,90,914,3,1,2
7,90,8023,43,19,24
7,90,3083,62,27,35
7,90,1362,7,5,2
7,90,2010,2,2,0
7,90,1359,3,0,3
7,90,2898,15,7,8
7,90,1534,15,3,12
7,90,3153,9,5,4
7,90,2195,2,1,1
7,90,5473,37,18,19
7,90,2918,11,6,5
7,90,2034,5,0,5
7,90,2166,4,2,2
7,91,2625,8,2,6
7,91,2012,1,0,1
7,92,4324,14,7,7
7,92,1857,14,6,8
7,92,1513,8,3,5
7,92,3002,7,1,6
7,92,3254,4,3,1
7,93,2173,7,4,3
7,93,625,1,1,0
7,93,1543,4,0,4
7,123,2104,4,2,2
7,123,891,1,0,1
7,93,2283,115,65,50
7,93,1978,100,45,55
7,93,1015,339,173,166
7,123,1954,0,0,0
7,123,2088,2,1,1
7,123,1526,2,1,1
7,93,1308,54,27,27
7,93,1461,163,87,76
7,93,3418,40,17,23
7,93,736,1,0,1
7,93,2877,8,3,5
7,93,1096,1,1,0
7,123,1471,5,1,4
7,123,2360,2,1,1
7,123,1752,10,5,5
7,123,1373,7,4,3
7,123,2052,10,5,5
7,123,2571,6,4,2
7,123,1894,3,2,1
7,123,1673,4,2,2
7,123,138,1,0,1
7,93,1973,11,3,8
7,94,1831,6,3,3
7,94,2699,2,1,1
7,94,1237,1,0,1
7,94,2633,42,23,19
7,94,1025,0,0,0
7,94,1566,2,1,1
7,94,4142,8,2,6
7,94,3089,7,3,4
7,94,2915,8,5,3
7,94,2941,2,2,0
7,94,3088,1,0,1
7,94,1903,6,4,2
7,94,5636,9,4,5
7,94,3618,17,10,7
7,94,5556,9,5,4
7,94,1979,1,1,0
7,95,3397,6,2,4
7,95,7546,20,11,9
7,95,2503,12,7,5
7,95,3599,3,0,3
7,95,2107,13,8,5
7,95,6631,41,22,19
7,95,8364,34,13,21
7,95,2390,4,3,1
7,95,9162,87,47,40
7,95,3507,24,14,10
7,96,2023,1,1,0
7,96,3243,4,2,2
7,96,1987,0,0,0
7,96,3133,3,2,1
7,96,3837,6,3,3
7,96,1863,1,1,0
7,96,3917,7,0,7
7,96,3727,39,18,21
7,96,3535,4,2,2
7,96,2567,5,3,2
7,96,4983,18,9,9
7,96,4626,21,8,13
7,96,6077,12,6,6
7,96,4601,5,2,3
7,96,5140,10,4,6
7,96,3916,6,3,3
7,96,5038,1,1,0
7,96,3844,17,10,7
7,96,3697,2,1,1
7,96,2636,10,4,6
7,96,4075,27,15,12
7,96,3812,6,4,2
7,97,1053,7,3,4
7,97,2254,22,11,11
7,97,1406,8,4,4
7,97,6709,39,17,22
7,97,6303,20,7,13
7,97,1052,10,2,8
7,97,1239,2,0,2
7,97,1199,7,4,3
7,97,518,0,0,0
7,97,704,4,2,2
7,97,1006,4,1,3
7,97,1189,2,0,2
7,97,3608,9,6,3
7,97,5193,18,10,8
7,97,765,6,2,4
7,97,3171,5,2,3
7,97,3496,7,2,5
7,97,850,1,1,0
7,97,2089,1,1,0
7,97,619,5,2,3
7,97,1910,0,0,0
7,97,1091,8,2,6
7,97,3305,29,15,14
7,97,4132,447,226,221
7,97,3318,8,5,3
7,97,2645,4,1,3
7,97,3070,13,6,7
7,97,1354,7,5,2
7,97,1349,0,0,0
7,97,3058,9,4,5
7,97,3876,5,2,3
7,97,3048,7,3,4
7,97,2173,4,1,3
7,97,1311,1,0,1
7,97,2085,11,4,7
7,97,2021,6,3,3
7,97,749,6,2,4
7,97,1721,1,0,1
7,97,631,3,2,1
7,97,1952,9,3,6
7,97,766,10,7,3
7,97,1197,2,1,1
7,97,1107,2,2,0
7,98,1568,0,0,0
7,99,862,16,10,6
7,99,4098,3,2,1
7,99,1507,24,13,11
7,99,961,2,1,1
7,99,5525,22,9,13
7,99,2053,10,6,4
7,99,1628,9,6,3
7,99,2770,7,5,2
7,99,1816,15,9,6
7,99,2701,2,0,2
7,99,2836,3,1,2
7,99,3503,5,1,4
7,99,3178,2,1,1
7,99,2624,1,1,0
7,99,2859,45,27,18
7,99,2123,2,0,2
7,99,2677,1,0,1
7,99,2209,1,1,0
7,99,1903,1,1,0
7,99,2187,2,1,1
7,99,2837,3,2,1
7,99,893,9,3,6
7,99,1921,3,3,0
7,99,1838,2,0,2
7,99,2563,20,6,14
7,99,2716,6,1,5
7,99,2372,4,2,2
7,99,2233,0,0,0
7,99,839,1,0,1
7,99,1134,0,0,0
7,99,1598,1,0,1
7,99,522,0,0,0
7,99,4037,2,2,0
7,99,3790,11,3,8
7,99,1919,12,7,5
7,99,1342,1,0,1
7,100,2811,1,0,1
7,100,2525,7,1,6
7,100,3005,13,9,4
7,100,4254,13,5,8
7,100,4694,13,5,8
7,100,1972,1,1,0
7,100,4250,6,3,3
7,100,3592,11,6,5
7,100,3030,10,3,7
7,100,2009,3,3,0
7,100,3629,18,6,12
7,100,3694,5,4,1
7,101,830,2,1,1
7,101,1541,4,2,2
7,101,1093,1,0,1
7,101,2035,9,1,8
7,101,1968,9,6,3
7,101,1458,7,2,5
7,101,3294,7,4,3
7,101,3149,3,3,0
7,101,1237,4,2,2
7,101,1307,0,0,0
7,101,1220,20,10,10
7,101,4058,6,5,1
7,101,2705,6,4,2
7,101,1957,19,9,10
7,101,3307,110,62,48
7,101,616,8,5,3
7,101,955,3,2,1
7,101,1586,547,285,262
7,101,1348,354,180,174
7,101,2934,277,146,131
7,101,886,0,0,0
7,101,1041,4,2,2
7,102,17408,132,76,56
7,102,4809,10,6,4
7,102,4977,18,7,11
7,102,4544,147,77,70
7,102,3027,76,44,32
7,102,6274,14,5,9
7,102,7490,22,12,10
7,102,8424,42,18,24
7,102,4511,266,147,119
7,102,3190,28,12,16
7,102,2968,24,9,15
7,102,4219,35,22,13
7,102,6064,149,76,73
7,102,22003,507,258,249
7,102,4700,97,50,47
7,102,2559,15,7,8
7,102,2378,34,20,14
7,102,2789,30,16,14
7,102,1112,4,1,3
7,102,9843,45,20,25
7,102,3470,35,18,17
7,102,3207,76,37,39
7,102,3976,10,6,4
7,102,1922,11,7,4
7,102,1587,56,31,25
7,102,1914,47,26,21
7,102,4600,32,20,12
7,102,2246,21,6,15
7,102,2582,30,13,17
7,102,2085,11,5,6
7,102,2171,18,10,8
7,102,2966,23,13,10
7,102,1057,3,2,1
7,102,2865,46,26,20
7,102,2705,118,65,53
7,102,14549,112,58,54
7,102,2245,5,1,4
7,102,10660,158,81,77
7,102,3045,37,19,18
7,102,1128,9,3,6
7,102,1344,1,0,1
7,102,2104,59,25,34
7,102,1557,35,18,17
7,102,1713,64,40,24
7,102,2377,21,14,7
7,102,1428,6,3,3
7,102,1545,81,45,36
7,102,1221,104,51,53
7,102,1864,8,2,6
7,102,1396,17,8,9
7,102,2458,7,5,2
7,102,1583,17,11,6
7,102,1675,31,10,21
7,102,1387,14,7,7
7,102,3619,78,38,40
7,102,3997,40,16,24
7,102,3484,18,14,4
7,102,4185,11,3,8
7,102,3067,62,30,32
7,102,4422,66,35,31
7,102,1705,4,2,2
7,102,1050,1,1,0
7,102,1821,10,6,4
7,102,753,1,0,1
7,102,1463,9,3,6
7,102,1341,3,1,2
7,102,980,13,7,6
7,102,973,4,2,2
7,102,1452,5,1,4
7,102,2993,41,26,15
7,102,1615,14,6,8
7,102,852,26,15,11
7,102,778,16,7,9
7,102,578,127,69,58
7,102,553,11,7,4
7,102,843,7,4,3
7,102,889,4,1,3
7,102,849,3,3,0
7,102,1484,44,18,26
7,102,1711,52,28,24
7,102,1828,18,8,10
7,102,3506,81,43,38
7,102,2446,16,6,10
7,102,1117,7,3,4
7,102,964,11,2,9
7,102,1835,13,6,7
7,102,1721,22,12,10
7,102,1211,19,10,9
7,102,1203,7,4,3
7,102,1068,5,3,2
7,102,831,2,2,0
7,102,686,8,4,4
7,102,592,11,6,5
7,102,669,1,0,1
7,102,1210,24,15,9
7,102,1455,45,19,26
7,102,2492,24,14,10
7,102,1157,5,2,3
7,102,1483,10,6,4
7,102,4952,47,21,26
7,102,2442,6,2,4
7,102,1794,26,16,10
7,102,3876,47,29,18
7,102,2717,53,26,27
7,102,1940,15,10,5
7,102,1307,6,2,4
7,102,583,4,3,1
7,102,557,1,0,1
7,102,1730,54,25,29
7,102,1686,7,3,4
7,102,1870,16,7,9
7,102,1764,5,4,1
7,102,1765,27,14,13
7,102,3483,12,6,6
7,102,1847,15,8,7
7,102,1329,11,6,5
7,102,2344,13,6,7
7,102,1857,9,4,5
7,102,1353,3,2,1
7,102,1495,5,3,2
7,102,1562,3,2,1
7,102,1477,7,3,4
7,102,1969,41,20,21
7,102,2076,11,3,8
7,102,1924,4,3,1
7,102,6100,33,12,21
7,102,5009,19,13,6
7,102,3269,35,19,16
7,102,2044,8,2,6
7,102,3003,7,3,4
7,102,7730,37,19,18
7,102,18442,151,83,68
7,102,23169,372,191,181
7,102,4150,66,30,36
7,102,12695,121,67,54
7,102,1864,1,1,0
7,102,7033,18,10,8
7,102,13986,116,55,61
7,102,4476,18,12,6
7,102,5411,15,7,8
7,102,14833,345,149,196
7,102,11461,303,147,156
7,102,8069,54,28,26
7,102,7626,368,193,175
7,102,4217,28,13,15
7,102,430,1,1,0
7,102,580,0,0,0
7,102,1571,50,25,25
7,103,2752,15,6,9
7,103,790,0,0,0
7,103,1000,11,6,5
7,103,1511,3,2,1
7,103,1202,0,0,0
7,103,1103,2,1,1
7,103,990,1,1,0
7,103,1614,2,1,1
7,103,3844,6,4,2
7,103,3862,16,5,11
7,103,1785,4,2,2
7,103,1338,2,2,0
7,103,1317,0,0,0
7,103,1002,1,1,0
7,103,1775,3,2,1
7,103,3973,5,5,0
7,104,3719,6,5,1
7,104,1063,1,1,0
7,104,1768,0,0,0
7,104,1331,2,1,1
7,104,2882,2,1,1
7,104,3315,0,0,0
7,104,2305,3,2,1
7,105,3158,3,3,0
7,105,2069,11,4,7
7,105,1110,1,1,0
7,105,2166,1,1,0
7,105,1772,0,0,0
7,105,1503,3,0,3
7,105,2827,6,2,4
7,105,1403,0,0,0
7,106,2300,2,1,1
7,106,721,18,10,8
7,106,1609,19,9,10
7,106,1940,4,2,2
7,106,1907,14,7,7
7,106,1604,59,32,27
7,106,1605,8,4,4
7,106,2024,12,9,3
7,106,1668,10,4,6
7,106,2641,7,4,3
7,106,5460,18,5,13
7,106,5307,9,4,5
7,106,5596,26,18,8
7,106,3584,7,3,4
7,106,4489,8,7,1
7,106,1340,1,1,0
7,106,3183,1,1,0
7,106,1152,2,0,2
7,106,3224,19,6,13
7,106,2231,2,1,1
7,106,2403,5,2,3
7,106,1894,10,6,4
7,106,2713,4,2,2
7,106,818,2,0,2
7,106,4359,8,3,5
7,106,1674,0,0,0
7,107,3529,12,6,6
7,107,3223,22,15,7
7,107,2262,3,2,1
7,107,3381,27,17,10
7,107,1300,30,12,18
7,107,1034,13,5,8
7,107,913,5,1,4
7,107,1398,51,24,27
7,107,895,1,0,1
7,107,3156,5,1,4
7,107,1610,0,0,0
7,107,2231,3,0,3
7,107,889,21,5,16
7,107,2247,24,11,13
7,107,1266,9,4,5
7,107,1292,3,3,0
7,108,4379,28,16,12
7,108,2540,80,42,38
7,108,2875,23,15,8
7,108,3615,7,3,4
7,121,3113,42,23,19
7,121,3892,2,1,1
7,121,2635,21,11,10
7,121,2815,0,0,0
7,108,1590,0,0,0
7,121,3132,25,11,14
7,108,1627,1,0,1
7,108,1987,3,3,0
7,108,3844,7,3,4
7,108,4938,8,4,4
7,108,748,3,2,1
7,108,3221,3,1,2
7,108,2620,12,3,9
7,108,5525,44,20,24
7,108,1485,7,1,6
7,108,2704,9,6,3
7,108,1718,3,2,1
7,108,2880,2,2,0
7,108,2221,7,3,4
7,108,3340,6,4,2
7,108,2610,20,8,12
7,108,2019,6,2,4
7,108,3274,22,13,9
7,109,4182,90,43,47
7,109,1541,4,2,2
7,109,3350,10,7,3
7,109,2128,6,2,4
7,109,2003,32,20,12
7,109,631,0,0,0
7,109,1093,2,2,0
7,109,6016,24,11,13
7,109,1357,7,5,2
7,109,1214,3,1,2
7,109,1609,8,3,5
7,109,3244,4,2,2
7,109,1501,23,14,9
7,109,1805,29,13,16
7,109,1745,10,5,5
7,109,8757,30,17,13
7,109,1741,8,4,4
7,109,979,6,3,3
7,109,2766,6,2,4
7,109,744,1,0,1
7,109,1705,10,9,1
7,109,2192,9,4,5
7,109,2186,1,1,0
7,109,1733,3,2,1
7,109,2285,4,2,2
7,109,2607,9,5,4
7,109,2780,1,0,1
7,109,3138,9,3,6
7,109,2410,5,3,2
7,109,2807,16,6,10
7,109,3085,11,6,5
7,109,1305,13,7,6
7,109,1856,2,1,1
7,109,1304,4,2,2
7,109,3312,22,9,13
7,109,1737,82,47,35
7,109,2169,10,5,5
7,109,1661,1,0,1
7,109,2291,4,1,3
7,109,3331,0,0,0
7,109,2177,3,1,2
7,109,2617,3,1,2
7,109,2575,19,7,12
7,109,1711,7,4,3
7,109,1213,1,0,1
7,109,4280,4,1,3
7,110,4186,35,19,16
7,110,2793,8,4,4
7,110,4394,15,7,8
7,110,1501,3,3,0
7,110,3339,26,11,15
7,110,2145,3,2,1
7,110,4725,26,14,12
7,110,2380,3,3,0
7,110,2439,10,1,9
7,110,4705,14,6,8
7,110,4306,16,10,6
7,110,3118,9,4,5
7,110,882,2,2,0
7,111,2590,14,8,6
7,111,2160,7,5,2
7,111,2557,3,1,2
7,111,3986,20,10,10
7,111,2196,1,0,1
7,111,4405,15,8,7
7,111,3011,8,3,5
7,111,2344,0,0,0
7,111,3000,6,3,3
7,111,3046,3,2,1
7,111,3778,217,105,112
7,111,1221,2,2,0
7,111,5175,4,3,1
7,111,2846,5,3,2
7,111,2996,5,4,1
7,102,2174,92,47,45
7,102,652,7,4,3
7,102,689,41,18,23
7,102,527,0,0,0
7,102,1109,4,1,3
7,102,632,1,1,0
7,102,997,23,7,16
7,102,812,2,2,0
7,102,653,5,3,2
7,102,612,198,112,86
7,102,716,192,120,72
7,102,797,58,37,21
7,102,1050,2,1,1
7,102,1354,112,65,47
7,102,855,6,3,3
7,102,813,4,0,4
7,102,810,143,82,61
7,102,780,4,2,2
7,102,840,3,3,0
7,102,629,2,2,0
7,102,1000,0,0,0
7,102,569,9,6,3
7,102,520,495,232,263
7,102,614,4,3,1
7,102,482,0,0,0
7,102,958,11,4,7
7,102,638,5,4,1
7,102,1498,8,2,6
7,102,566,1,1,0
7,102,515,240,135,105
7,102,306,200,100,100
7,102,684,0,0,0
7,102,595,2,1,1
7,102,644,591,314,277
7,102,1073,9,4,5
7,102,688,1,0,1
7,102,628,1,1,0
7,102,809,6,4,2
7,102,929,5,2,3
7,102,600,3,2,1
7,102,765,6,0,6
7,102,1379,10,3,7
7,102,677,7,4,3
7,102,774,9,3,6
7,102,985,4,2,2
7,102,652,10,7,3
7,90,1017,12,7,5
7,90,1733,7,4,3
7,90,1278,15,9,6
7,90,1647,3,1,2
7,90,2602,2,0,2
7,90,1539,21,10,11
7,90,1495,4,2,2
7,90,1351,22,11,11
7,90,1299,3,2,1
7,90,1493,16,8,8
7,90,1327,5,1,4
7,90,1473,1,0,1
7,90,1238,0,0,0
7,90,1851,45,25,20
7,90,825,0,0,0
7,90,1375,0,0,0
7,90,2079,156,85,71
7,90,337,0,0,0
7,90,1054,0,0,0
7,90,1094,5,0,5
7,90,1080,5,3,2
7,90,1667,222,121,101
7,90,1108,0,0,0
7,90,706,3,1,2
7,90,576,163,86,77
7,90,1632,9,6,3
7,90,1832,36,12,24
7,90,1215,2,1,1
7,90,1324,216,115,101
7,90,2123,20,9,11
7,90,1827,10,3,7
7,90,1475,8,1,7
7,90,1762,30,14,16
7,90,992,3,0,3
7,90,1444,18,9,9
7,90,1764,8,7,1
7,102,1018,1,0,1
7,102,795,0,0,0
7,102,927,2,0,2
7,102,1178,7,2,5
7,102,1007,0,0,0
7,102,2630,15,5,10
7,102,1069,51,26,25
7,102,1580,0,0,0
7,102,1252,1,0,1
7,102,2219,12,7,5
7,102,2996,6,3,3
7,102,732,3,1,2
7,102,2537,15,11,4
7,102,1019,1,1,0
7,102,802,4,2,2
7,102,734,1,1,0
7,102,1880,4,3,1
7,102,2636,4,1,3
7,102,663,0,0,0
7,102,1036,2,1,1
7,102,771,17,8,9
7,102,697,4,2,2
7,102,708,22,10,12
7,102,536,14,9,5
7,102,516,0,0,0
7,102,747,0,0,0
7,102,838,3,2,1
7,102,620,0,0,0
7,102,2426,12,8,4
7,102,638,1,0,1
7,102,852,11,5,6
7,102,1027,0,0,0
7,102,1259,2,1,1
7,102,891,8,3,5
7,102,1614,8,4,4
7,90,864,1,0,1
7,90,994,0,0,0
7,124,0,0,0,0
7,65,5810,36,18,18
7,65,1146,1,0,1
7,65,4673,5,2,3
7,65,1503,4,1,3
7,14,1120,44,19,25
7,14,4357,16,9,7
7,26,592,1,0,1
7,26,2318,3,3,0
7,26,1085,3,1,2
7,31,562,0,0,0
7,31,4391,6,3,3
7,31,1800,2,0,2
7,31,1418,1,1,0
7,31,1724,4,2,2
7,31,2103,9,2,7
7,31,6114,57,32,25
7,31,1288,1,1,0
7,31,1377,0,0,0
7,31,433,0,0,0
7,31,1085,0,0,0
7,31,2467,0,0,0
7,31,3239,133,65,68
7,31,1821,1,1,0
7,31,1362,0,0,0
7,31,2788,74,36,38
7,31,3949,10,2,8
7,59,746,1,0,1
7,59,1058,4,1,3
7,59,441,2,1,1
7,59,1516,1,1,0
7,59,1292,5,3,2
7,59,607,1,0,1
7,59,4494,3,2,1
7,59,900,11,4,7
7,62,2401,68,39,29
7,62,1748,2,1,1
7,73,4493,5,3,2
7,73,3687,40,21,19
7,73,2939,18,5,13
7,78,4725,9,5,4
7,78,1840,3,1,2
7,23,1767,4,3,1
7,23,0,0,0,0
7,23,1900,1,0,1
7,77,3081,15,7,8
7,77,2213,41,25,16
7,77,3642,34,20,14
7,77,3124,24,11,13
7,77,2036,31,19,12
7,79,3207,2,0,2
7,79,1687,2,1,1
7,79,1159,0,0,0
7,79,1970,1,0,1
7,79,5769,5,0,5
7,27,4186,10,6,4
7,27,3270,9,5,4
7,27,3500,17,3,14
7,27,6303,45,21,24
7,27,3700,19,11,8
7,61,765,1,1,0
7,61,1590,97,52,45
7,61,2571,8,4,4
7,61,1369,0,0,0
7,98,4097,2,1,1
7,98,1060,6,3,3
7,98,667,0,0,0
7,102,2776,13,6,7
7,102,1624,12,8,4
7,102,1325,1,0,1
7,102,2627,17,8,9
7,1,1183,806,400,406
7,1,4876,31,15,16
7,32,2637,5,2,3
7,32,2750,5,4,1
7,51,3172,5,1,4
7,51,2656,5,3,2
7,19,2922,35,19,16
7,19,3014,22,13,9
7,34,3786,1,0,1
7,34,1777,36,16,20
7,34,2166,13,2,11
7,102,2015,4,2,2
7,102,2104,43,14,29
7,108,2046,6,2,4
7,108,2412,7,4,3
7,41,2469,2,1,1
7,41,3755,5,4,1
7,52,3804,6,4,2
7,52,2183,3,1,2
7,35,1831,2,2,0
7,35,758,0,0,0
7,35,1881,8,2,6
7,90,2718,17,5,12
7,90,2268,22,13,9
7,57,4982,1,0,1
7,57,2131,9,4,5
8,1,1326,2,0,2
8,1,708,2,1,1
8,1,1136,3,2,1
8,1,927,11,5,6
8,1,1095,2,0,2
8,1,3107,7,2,5
8,1,1229,2,1,1
8,1,1643,1,0,1
8,1,376,0,0,0
8,1,85,8,4,4
8,1,228,3,0,3
8,1,577,0,0,0
8,1,620,0,0,0
8,1,842,2,1,1
8,1,731,2,0,2
8,2,4662,444,235,209
8,2,1598,11,3,8
8,2,2493,8,3,5
8,2,951,2,1,1
8,2,584,2,1,1
8,2,790,4,3,1
8,2,836,1,1,0
8,2,1050,4,1,3
8,2,580,5,3,2
8,2,843,8,6,2
8,2,1132,4,2,2
8,2,1728,7,4,3
8,2,220,3,1,2
8,2,168,5,4,1
8,2,649,7,1,6
8,2,1179,87,41,46
8,2,2078,10,2,8
8,2,232,2,0,2
8,2,93,0,0,0
8,2,141,0,0,0
8,3,1381,0,0,0
8,3,1204,4,4,0
8,3,1002,3,1,2
8,3,1099,7,4,3
8,3,355,0,0,0
8,3,135,1,1,0
8,3,184,0,0,0
8,3,146,0,0,0
8,3,355,0,0,0
8,3,236,0,0,0
8,3,165,0,0,0
8,3,178,1,1,0
8,3,306,0,0,0
8,3,615,4,2,2
8,3,705,0,0,0
8,3,431,3,1,2
8,4,1163,11,4,7
8,4,362,12,4,8
8,4,22861,205,81,124
8,5,2162,9,4,5
8,5,1870,4,1,3
8,5,699,5,1,4
8,5,772,0,0,0
8,5,2609,5,0,5
8,5,474,3,2,1
8,5,753,7,2,5
8,5,1143,4,0,4
8,5,217,0,0,0
8,5,502,0,0,0
8,5,1650,4,1,3
8,5,353,0,0,0
8,5,2392,3,3,0
8,5,640,1,0,1
8,5,499,0,0,0
8,5,1208,0,0,0
8,5,1391,7,3,4
8,5,1040,3,2,1
8,5,1201,2,2,0
8,5,631,0,0,0
8,5,3951,12,7,5
8,6,549,2,0,2
8,6,725,4,3,1
8,6,300,1,0,1
8,6,357,1,0,1
8,6,84,0,0,0
8,6,474,0,0,0
8,6,396,1,0,1
8,6,228,2,1,1
8,6,349,4,2,2
8,6,121,0,0,0
8,6,161,1,1,0
8,6,179,1,1,0
8,6,258,1,1,0
8,6,215,1,0,1
8,6,245,2,0,2
8,6,348,1,1,0
8,6,435,0,0,0
8,6,474,0,0,0
8,7,1557,3,0,3
8,7,1400,13,10,3
8,7,474,3,1,2
8,7,436,0,0,0
8,7,1171,0,0,0
8,7,681,0,0,0
8,7,661,1,0,1
8,7,486,2,1,1
8,7,1524,4,1,3
8,7,1723,4,1,3
8,7,661,2,1,1
8,7,2291,1,0,1
8,7,2532,7,6,1
8,7,776,1,0,1
8,8,1620,49,23,26
8,8,1352,3,1,2
8,8,520,0,0,0
8,8,1185,14,6,8
8,8,1059,18,8,10
8,8,1404,3,2,1
8,8,1158,2,1,1
8,8,975,2,1,1
8,8,461,0,0,0
8,8,874,0,0,0
8,8,880,1,0,1
8,9,149,87,43,44
8,9,586,30,19,11
8,9,2133,129,70,59
8,9,2458,84,32,52
8,9,806,1,0,1
8,9,1829,3,1,2
8,9,2290,95,50,45
8,9,1004,30,15,15
8,9,1781,21,18,3
8,9,1529,8,5,3
8,9,3158,24,9,15
8,9,660,4,2,2
8,9,337,2,2,0
8,9,144,4,2,2
8,9,480,0,0,0
8,9,212,30,11,19
8,9,321,6,3,3
8,9,1043,3,2,1
8,9,340,153,79,74
8,9,764,3,1,2
8,9,854,2,1,1
8,9,435,0,0,0
8,10,617,0,0,0
8,10,957,0,0,0
8,10,809,2,1,1
8,10,473,3,2,1
8,10,1860,3,0,3
8,10,507,2,0,2
8,10,325,0,0,0
8,10,1752,19,6,13
8,10,1289,47,24,23
8,10,1443,7,2,5
8,10,437,1,1,0
8,10,1129,6,3,3
8,10,1156,5,4,1
8,10,1105,2,1,1
8,10,614,0,0,0
8,10,1322,4,1,3
8,10,184,0,0,0
8,10,520,1,0,1
8,10,1469,4,3,1
8,10,1313,6,2,4
8,10,828,2,0,2
8,10,320,1,1,0
8,10,269,0,0,0
8,10,2243,185,88,97
8,10,1282,3,1,2
8,10,934,1,0,1
8,11,591,8,2,6
8,11,611,5,2,3
8,11,431,5,3,2
8,11,563,2,1,1
8,11,320,1,0,1
8,11,449,0,0,0
8,11,479,3,3,0
8,11,411,0,0,0
8,11,471,0,0,0
8,11,489,1,1,0
8,11,1230,2,0,2
8,11,771,1,1,0
8,11,618,5,1,4
8,11,608,4,1,3
8,11,593,1,0,1
8,11,625,5,1,4
8,11,1980,9,5,4
8,11,6223,49,26,23
8,11,801,0,0,0
8,11,1681,6,1,5
8,11,911,5,2,3
8,11,1706,21,7,14
8,11,1115,1,1,0
8,11,156,4,2,2
8,11,1561,27,17,10
8,11,1065,9,7,2
8,11,2273,32,11,21
8,11,3332,49,28,21
8,11,3499,2,1,1
8,11,3918,6,3,3
8,11,2103,17,5,12
8,11,2221,133,70,63
8,11,486,14,5,9
8,11,363,4,2,2
8,11,291,15,9,6
8,11,772,11,4,7
8,11,486,13,6,7
8,11,1195,27,14,13
8,11,552,7,3,4
8,11,801,6,0,6
8,11,511,4,3,1
8,11,346,0,0,0
8,12,1534,11,6,5
8,12,459,1,1,0
8,12,370,2,1,1
8,12,195,0,0,0
8,12,648,2,0,2
8,12,152,0,0,0
8,12,216,2,1,1
8,12,23,0,0,0
8,12,417,3,1,2
8,12,89,0,0,0
8,12,336,1,0,1
8,12,333,0,0,0
8,12,1069,0,0,0
8,12,513,1,0,1
8,12,282,0,0,0
8,12,483,4,2,2
8,13,973,4,2,2
8,13,743,0,0,0
8,13,1054,0,0,0
8,13,4075,44,24,20
8,13,681,11,7,4
8,13,1391,1,1,0
8,13,307,1,0,1
8,13,852,2,1,1
8,13,309,10,4,6
8,13,176,0,0,0
8,13,200,0,0,0
8,13,1079,3,1,2
8,13,43,0,0,0
8,14,1054,3,2,1
8,14,199,0,0,0
8,14,239,0,0,0
8,14,204,0,0,0
8,14,144,0,0,0
8,14,95,0,0,0
8,14,106,0,0,0
8,15,762,2,1,1
8,15,51,3,1,2
8,15,157,1,0,1
8,15,267,2,0,2
8,16,1408,2,0,2
8,16,343,3,2,1
8,16,393,2,0,2
8,16,800,3,2,1
8,16,669,0,0,0
8,17,2164,13,7,6
8,17,5575,61,37,24
8,17,589,1,0,1
8,17,806,14,7,7
8,17,3838,69,31,38
8,17,7806,144,67,77
8,17,1423,5,2,3
8,17,1822,8,5,3
8,17,3560,26,10,16
8,17,1064,2,1,1
8,17,910,4,2,2
8,17,547,0,0,0
8,17,969,5,4,1
8,17,4217,19,11,8
8,17,1025,2,2,0
8,17,5246,36,17,19
8,17,764,6,3,3
8,17,1388,2,2,0
8,17,820,13,6,7
8,17,946,2,1,1
8,17,620,3,1,2
8,17,299,4,1,3
8,17,244,0,0,0
8,17,382,15,6,9
8,17,440,5,2,3
8,17,928,5,1,4
8,17,17383,578,291,287
8,17,244,2,2,0
8,17,391,5,1,4
8,17,680,14,6,8
8,17,467,22,12,10
8,17,753,5,3,2
8,17,440,1,0,1
8,17,446,3,0,3
8,17,1319,8,3,5
8,17,5348,27,15,12
8,17,6838,23,9,14
8,17,1620,5,2,3
8,17,481,22,7,15
8,17,974,10,3,7
8,17,1168,5,2,3
8,17,693,5,2,3
8,17,332,7,3,4
8,17,672,5,3,2
8,17,484,12,6,6
8,17,408,185,91,94
8,17,520,6,2,4
8,17,545,47,22,25
8,17,997,59,21,38
8,17,766,1,0,1
8,17,2547,20,10,10
8,17,865,0,0,0
8,17,1608,87,45,42
8,17,868,43,20,23
8,17,1012,51,21,30
8,17,1210,1,1,0
8,17,1450,3,2,1
8,17,481,6,3,3
8,17,673,158,86,72
8,17,5246,38,21,17
8,17,1034,4,3,1
8,17,4774,12,9,3
8,17,2915,13,4,9
8,17,2148,20,6,14
8,17,1883,3,2,1
8,17,1294,4,2,2
8,17,983,1,1,0
8,17,3130,88,44,44
8,17,1448,3,0,3
8,17,1790,6,2,4
8,17,1360,6,3,3
8,17,901,17,8,9
8,17,2643,24,11,13
8,17,995,2,1,1
8,17,288,1,1,0
8,17,398,0,0,0
8,17,938,151,72,79
8,17,2302,321,159,162
8,17,868,6,5,1
8,17,744,5,3,2
8,17,267,3,2,1
8,17,486,8,3,5
8,17,186,0,0,0
8,17,463,2,1,1
8,17,761,5,0,5
8,17,351,0,0,0
8,17,1447,3,3,0
8,17,95,1,1,0
8,17,159,0,0,0
8,17,82,1,0,1
8,17,2236,15,8,7
8,17,3141,36,13,23
8,17,1624,14,7,7
8,17,301,2,0,2
8,17,3439,8,5,3
8,17,3513,53,28,25
8,17,592,3,2,1
8,17,79,0,0,0
8,17,5391,27,13,14
8,17,225,1,0,1
8,17,126,2,0,2
8,17,127,5,1,4
8,17,194,0,0,0
8,17,117,0,0,0
8,17,676,8,4,4
8,17,315,0,0,0
8,17,248,1,0,1
8,17,261,0,0,0
8,17,8237,45,20,25
8,17,2573,41,22,19
8,17,882,6,3,3
8,17,2122,13,4,9
8,18,267,0,0,0
8,18,307,1,0,1
8,18,88,0,0,0
8,18,72,0,0,0
8,18,435,0,0,0
8,18,406,0,0,0
8,18,315,0,0,0
8,18,385,3,0,3
8,18,221,0,0,0
8,18,367,3,1,2
8,18,400,2,1,1
8,18,292,0,0,0
8,18,400,1,0,1
8,19,789,7,5,2
8,19,1033,12,5,7
8,19,650,4,1,3
8,19,873,23,13,10
8,19,688,5,3,2
8,19,758,3,1,2
8,19,837,1,0,1
8,19,753,2,0,2
8,19,1386,12,5,7
8,19,972,8,4,4
8,19,918,7,2,5
8,19,804,4,2,2
8,19,865,5,2,3
8,19,695,1,1,0
8,19,815,4,3,1
8,19,690,0,0,0
8,19,842,1,1,0
8,19,636,2,1,1
8,19,1110,19,6,13
8,19,641,11,6,5
8,19,802,19,10,9
8,19,663,15,8,7
8,19,557,14,12,2
8,19,951,7,3,4
8,19,646,4,3,1
8,19,581,3,2,1
8,19,714,3,2,1
8,19,773,0,0,0
8,19,323,3,2,1
8,19,461,6,2,4
8,19,481,9,3,6
8,19,558,7,3,4
8,19,223,6,0,6
8,19,208,0,0,0
8,19,479,1,0,1
8,19,645,3,1,2
8,19,649,2,1,1
8,19,911,2,2,0
8,19,1159,4,2,2
8,19,787,7,3,4
8,19,656,9,7,2
8,19,643,9,5,4
8,19,547,12,5,7
8,19,431,0,0,0
8,19,651,28,14,14
8,19,595,3,1,2
8,19,499,4,4,0
8,19,410,7,3,4
8,19,693,25,9,16
8,19,200,5,3,2
8,19,587,16,11,5
8,19,295,9,4,5
8,19,416,4,0,4
8,19,860,7,4,3
8,19,528,9,4,5
8,19,455,2,1,1
8,19,471,2,1,1
8,19,510,1,0,1
8,19,918,6,4,2
8,19,753,5,2,3
8,19,635,5,2,3
8,19,710,20,13,7
8,19,1025,11,6,5
8,19,810,1,1,0
8,19,895,8,6,2
8,19,623,8,3,5
8,19,1023,5,2,3
8,19,464,10,4,6
8,19,453,48,22,26
8,19,669,8,3,5
8,19,683,0,0,0
8,19,569,20,11,9
8,19,432,1,0,1
8,19,642,0,0,0
8,19,790,2,0,2
8,19,777,0,0,0
8,19,715,6,3,3
8,19,529,7,3,4
8,19,879,8,7,1
8,19,851,0,0,0
8,19,866,1,1,0
8,19,857,9,3,6
8,19,715,5,2,3
8,19,933,12,6,6
8,19,2853,26,9,17
8,19,1550,8,5,3
8,19,875,8,3,5
8,19,721,3,1,2
8,19,1521,5,2,3
8,19,656,23,15,8
8,19,1322,9,5,4
8,19,1243,8,3,5
8,19,1129,7,5,2
8,19,1162,15,7,8
8,19,770,0,0,0
8,19,847,0,0,0
8,19,529,0,0,0
8,19,722,1,0,1
8,19,711,3,1,2
8,19,548,24,10,14
8,19,1386,12,7,5
8,19,394,5,2,3
8,19,629,8,5,3
8,19,594,5,1,4
8,19,662,15,8,7
8,19,648,14,8,6
8,19,868,1,0,1
8,19,1489,6,3,3
8,19,650,1,1,0
8,19,628,11,6,5
8,19,751,51,30,21
8,19,1207,42,26,16
8,19,1182,14,6,8
8,19,1197,20,10,10
8,19,469,18,10,8
8,19,668,4,1,3
8,19,781,33,19,14
8,19,590,174,90,84
8,19,628,12,5,7
8,19,771,18,10,8
8,19,695,8,5,3
8,19,450,5,1,4
8,19,593,8,4,4
8,19,558,4,2,2
8,19,505,7,4,3
8,19,921,15,10,5
8,19,1101,8,4,4
8,19,956,17,13,4
8,19,1032,3,1,2
8,19,668,13,6,7
8,19,1005,1,0,1
8,19,960,7,3,4
8,19,2169,84,47,37
8,19,1030,4,2,2
8,19,1677,15,8,7
8,19,2679,40,19,21
8,19,3279,61,37,24
8,19,3629,14,9,5
8,19,2892,13,4,9
8,19,5767,186,105,81
8,19,1028,9,3,6
8,19,3120,26,12,14
8,19,1023,5,3,2
8,19,730,0,0,0
8,19,602,6,1,5
8,19,445,23,12,11
8,19,807,28,15,13
8,19,633,45,19,26
8,19,748,58,32,26
8,19,1116,39,22,17
8,19,868,0,0,0
8,19,901,7,2,5
8,19,1089,11,5,6
8,19,324,0,0,0
8,19,1603,3,0,3
8,19,1004,11,7,4
8,19,1095,4,3,1
8,19,714,1,0,1
8,19,982,10,6,4
8,19,788,12,5,7
8,19,701,2,1,1
8,19,1758,13,6,7
8,19,4222,33,17,16
8,19,1370,26,16,10
8,19,1029,28,11,17
8,19,655,13,6,7
8,19,1026,8,4,4
8,19,1564,6,1,5
8,19,1132,10,6,4
8,19,1122,3,3,0
8,19,2856,18,11,7
8,19,812,0,0,0
8,19,2816,0,0,0
8,19,2453,6,2,4
8,19,834,3,2,1
8,19,690,4,2,2
8,19,1498,0,0,0
8,19,816,6,2,4
8,19,1031,6,3,3
8,19,919,3,1,2
8,19,880,3,1,2
8,19,1910,22,11,11
8,19,1134,2,1,1
8,19,1159,167,83,84
8,19,885,9,3,6
8,19,953,9,2,7
8,19,691,1,1,0
8,19,680,15,7,8
8,19,987,5,3,2
8,19,1212,6,1,5
8,19,1319,9,5,4
8,19,2325,6,2,4
8,19,822,2,1,1
8,19,991,2,1,1
8,19,15303,84,42,42
8,19,1012,18,5,13
8,19,955,11,7,4
8,19,1133,6,2,4
8,19,1559,13,8,5
8,19,1047,7,4,3
8,19,1156,16,9,7
8,19,790,5,1,4
8,19,2476,31,20,11
8,19,3282,6,5,1
8,19,753,0,0,0
8,19,1070,9,5,4
8,19,22762,241,114,127
8,19,14798,118,56,62
8,19,7671,28,17,11
8,19,1958,18,3,15
8,19,1163,9,4,5
8,19,1459,36,15,21
8,19,1807,146,70,76
8,19,1102,4,1,3
8,19,1136,4,4,0
8,19,1018,6,5,1
8,19,4438,84,48,36
8,19,539,14,5,9
8,19,4353,209,103,106
8,19,934,327,158,169
8,19,855,466,239,227
8,19,2011,7,3,4
8,19,866,2,0,2
8,19,729,6,1,5
8,19,789,99,49,50
8,19,817,72,34,38
8,19,959,1,0,1
8,19,938,9,4,5
8,19,1532,33,19,14
8,19,723,14,3,11
8,19,578,7,3,4
8,19,787,2,2,0
8,19,707,15,7,8
8,19,843,56,32,24
8,19,890,26,16,10
8,19,977,6,3,3
8,19,16569,256,134,122
8,19,949,44,20,24
8,19,2039,136,78,58
8,19,749,9,4,5
8,19,801,0,0,0
8,19,1304,12,9,3
8,19,1076,5,3,2
8,19,588,0,0,0
8,19,826,3,2,1
8,19,463,0,0,0
8,19,736,2,1,1
8,19,585,3,0,3
8,19,7477,153,80,73
8,19,1091,5,3,2
8,19,793,7,6,1
8,19,677,1,0,1
8,19,967,1,0,1
8,19,584,16,8,8
8,19,688,3,2,1
8,19,893,10,5,5
8,19,3576,655,330,325
8,19,576,1,0,1
8,19,562,18,11,7
8,19,548,2,0,2
8,19,468,3,2,1
8,19,765,3,3,0
8,19,588,1,0,1
8,19,706,2,1,1
8,19,1244,4,0,4
8,19,1557,12,6,6
8,19,623,8,6,2
8,19,604,2,0,2
8,19,1048,4,2,2
8,19,818,4,4,0
8,19,898,6,3,3
8,19,758,8,4,4
8,19,772,3,1,2
8,19,864,13,8,5
8,19,700,18,9,9
8,19,564,9,3,6
8,19,462,7,2,5
8,19,708,3,2,1
8,19,941,6,4,2
8,19,580,2,2,0
8,19,568,2,1,1
8,19,590,1,0,1
8,19,989,2,2,0
8,19,2324,23,14,9
8,19,793,10,6,4
8,19,1013,8,4,4
8,19,1153,35,18,17
8,19,724,24,10,14
8,19,559,7,3,4
8,19,1044,1,0,1
8,19,1006,9,5,4
8,19,1046,37,16,21
8,19,506,4,1,3
8,19,894,17,10,7
8,19,712,19,11,8
8,19,538,5,4,1
8,19,784,3,2,1
8,19,1737,29,16,13
8,19,942,21,12,9
8,19,1246,12,3,9
8,19,549,54,32,22
8,19,640,1,1,0
8,19,571,6,2,4
8,19,634,3,1,2
8,19,723,6,3,3
8,19,124,1,0,1
8,19,436,1,1,0
8,19,1157,14,5,9
8,19,1438,5,2,3
8,19,743,3,2,1
8,19,1226,6,5,1
8,19,2402,12,4,8
8,19,3396,72,38,34
8,19,1140,5,2,3
8,19,1042,10,3,7
8,19,893,7,4,3
8,19,961,1,1,0
8,19,840,4,2,2
8,19,1060,77,38,39
8,19,2025,122,56,66
8,19,1696,26,13,13
8,19,639,23,16,7
8,19,661,9,6,3
8,19,595,6,4,2
8,19,894,3,2,1
8,19,638,6,4,2
8,19,634,0,0,0
8,19,659,9,3,6
8,19,999,2,0,2
8,19,762,5,4,1
8,19,1232,1,1,0
8,19,609,4,2,2
8,19,458,1,0,1
8,19,877,10,6,4
8,19,2147,26,15,11
8,19,544,1,1,0
8,19,519,2,2,0
8,19,678,12,5,7
8,19,683,2,1,1
8,19,871,6,2,4
8,19,831,8,5,3
8,19,626,20,14,6
8,19,982,55,31,24
8,19,526,0,0,0
8,19,504,0,0,0
8,19,511,2,1,1
8,19,877,5,3,2
8,19,2950,29,13,16
8,19,13089,117,50,67
8,19,536,1,1,0
8,19,862,12,7,5
8,19,825,10,5,5
8,19,1145,1,0,1
8,19,1205,7,4,3
8,19,1384,7,2,5
8,19,1195,25,14,11
8,19,864,8,5,3
8,19,809,6,4,2
8,19,497,7,3,4
8,19,559,2,1,1
8,19,789,16,8,8
8,19,1390,22,9,13
8,19,1374,5,2,3
8,19,650,12,5,7
8,19,496,2,0,2
8,19,902,1,1,0
8,19,985,1,0,1
8,19,916,2,1,1
8,19,1111,25,13,12
8,19,1217,5,3,2
8,19,292,2,1,1
8,19,921,16,7,9
8,19,1060,19,13,6
8,19,1105,9,3,6
8,19,657,4,2,2
8,19,611,13,7,6
8,19,1000,6,3,3
8,19,608,4,3,1
8,19,740,12,7,5
8,19,751,12,7,5
8,19,577,6,6,0
8,19,1188,9,5,4
8,19,1263,7,2,5
8,19,995,4,1,3
8,19,1162,9,2,7
8,19,584,12,9,3
8,19,1011,32,15,17
8,19,820,13,10,3
8,19,263,6,1,5
8,19,800,2,2,0
8,19,598,10,7,3
8,19,491,9,4,5
8,19,564,3,2,1
8,19,476,7,4,3
8,19,1046,10,3,7
8,19,1343,4,2,2
8,19,524,6,2,4
8,19,448,1,0,1
8,19,1127,23,14,9
8,19,11879,164,76,88
8,19,993,11,8,3
8,19,997,5,3,2
8,19,826,5,2,3
8,19,670,7,4,3
8,19,812,7,4,3
8,19,300,0,0,0
8,19,493,0,0,0
8,19,722,3,1,2
8,19,728,37,17,20
8,19,420,9,3,6
8,19,573,2,1,1
8,19,1022,27,20,7
8,19,574,2,0,2
8,19,693,13,7,6
8,19,420,0,0,0
8,19,78,0,0,0
8,19,412,8,2,6
8,19,3108,20,12,8
8,19,749,7,6,1
8,19,782,4,1,3
8,19,972,5,4,1
8,19,715,12,9,3
8,19,536,2,1,1
8,19,805,12,9,3
8,19,720,2,1,1
8,19,432,7,2,5
8,19,553,14,7,7
8,19,570,3,1,2
8,19,404,2,0,2
8,19,475,1,0,1
8,19,691,15,7,8
8,19,878,8,5,3
8,19,2256,19,11,8
8,19,3355,33,18,15
8,19,1053,22,10,12
8,19,773,14,7,7
8,19,963,39,16,23
8,19,380,1,0,1
8,19,438,17,10,7
8,19,1291,4,2,2
8,19,3790,16,8,8
8,19,10496,72,32,40
8,19,2360,6,2,4
8,19,7999,144,67,77
8,19,1232,10,8,2
8,19,695,1,0,1
8,19,8979,95,40,55
8,19,698,0,0,0
8,19,775,6,4,2
8,19,2773,67,21,46
8,19,599,7,1,6
8,19,883,40,21,19
8,19,1105,12,5,7
8,19,780,15,9,6
8,19,864,7,3,4
8,19,457,3,1,2
8,19,1646,78,48,30
8,19,831,0,0,0
8,19,620,5,1,4
8,19,1244,10,3,7
8,19,672,22,13,9
8,19,1137,14,5,9
8,19,798,8,4,4
8,19,1604,75,33,42
8,19,1480,55,26,29
8,19,1600,8,2,6
8,19,2047,58,31,27
8,19,1352,30,12,18
8,19,1389,2,1,1
8,19,1591,4,2,2
8,19,1670,13,7,6
8,19,2768,180,82,98
8,19,1756,35,14,21
8,19,1865,53,20,33
8,19,9918,863,427,436
8,19,1577,27,11,16
8,19,531,4,2,2
8,19,202,5,2,3
8,19,71,0,0,0
8,19,1062,17,8,9
8,19,724,14,6,8
8,19,550,6,3,3
8,19,132,0,0,0
8,19,559,2,0,2
8,19,968,8,2,6
8,19,6751,48,22,26
8,19,567,82,44,38
8,19,558,64,33,31
8,19,2035,29,18,11
8,19,235,1,0,1
8,19,248,1,1,0
8,19,353,0,0,0
8,19,432,0,0,0
8,19,566,3,3,0
8,19,855,11,6,5
8,19,487,5,3,2
8,19,916,325,174,151
8,19,611,3,1,2
8,20,1917,8,4,4
8,20,699,0,0,0
8,20,1358,1,0,1
8,20,274,3,1,2
8,20,205,0,0,0
8,20,456,0,0,0
8,20,164,0,0,0
8,20,868,1,0,1
8,21,792,3,0,3
8,21,794,2,1,1
8,21,1781,4,3,1
8,21,567,4,2,2
8,21,854,0,0,0
8,21,433,6,3,3
8,21,742,6,3,3
8,21,479,1,1,0
8,21,564,1,0,1
8,21,539,1,1,0
8,21,414,0,0,0
8,21,647,5,2,3
8,21,691,1,1,0
8,21,532,0,0,0
8,21,488,0,0,0
8,21,351,2,1,1
8,21,461,1,0,1
8,21,352,0,0,0
8,21,474,0,0,0
8,21,370,1,1,0
8,21,425,0,0,0
8,21,307,14,8,6
8,21,147,0,0,0
8,21,4659,21,10,11
8,21,3675,3,1,2
8,21,2584,9,3,6
8,21,487,1,1,0
8,21,166,3,2,1
8,21,343,3,0,3
8,21,525,1,1,0
8,21,447,3,3,0
8,21,882,14,6,8
8,21,1185,4,1,3
8,21,581,1,0,1
8,21,272,2,1,1
8,21,3842,100,42,58
8,21,718,5,3,2
8,21,650,12,3,9
8,21,711,13,9,4
8,21,742,0,0,0
8,21,475,2,0,2
8,21,781,14,5,9
8,21,2962,16,7,9
8,21,420,1,0,1
8,21,508,4,3,1
8,21,4208,76,32,44
8,21,811,1,0,1
8,21,661,7,3,4
8,21,899,4,2,2
8,21,609,9,4,5
8,21,955,14,6,8
8,21,929,11,3,8
8,21,724,6,0,6
8,21,518,1,0,1
8,21,522,0,0,0
8,21,989,2,1,1
8,21,536,1,1,0
8,21,676,0,0,0
8,21,568,1,0,1
8,21,722,0,0,0
8,21,548,2,2,0
8,21,3490,274,158,116
8,21,3508,11,3,8
8,21,653,2,1,1
8,21,384,3,2,1
8,21,726,1,1,0
8,21,702,0,0,0
8,21,862,2,0,2
8,21,749,0,0,0
8,21,13370,88,41,47
8,21,1168,9,5,4
8,21,752,2,1,1
8,21,805,7,3,4
8,21,876,18,7,11
8,21,1509,36,17,19
8,21,771,3,1,2
8,21,2037,10,5,5
8,21,567,1,1,0
8,21,1375,16,6,10
8,21,4802,61,30,31
8,21,1735,17,9,8
8,21,585,4,3,1
8,21,770,4,1,3
8,21,471,1,0,1
8,21,7666,431,209,222
8,21,559,4,2,2
8,21,875,2,1,1
8,21,433,10,2,8
8,21,136,1,0,1
8,21,516,4,1,3
8,21,193,5,2,3
8,21,3394,13,7,6
8,21,2927,92,40,52
8,21,1156,2,1,1
8,21,490,2,1,1
8,21,608,6,2,4
8,21,483,0,0,0
8,21,418,2,0,2
8,21,1310,23,14,9
8,21,3510,10,2,8
8,21,339,1,0,1
8,21,1155,3,0,3
8,21,2882,7,4,3
8,21,9956,30,12,18
8,21,773,5,2,3
8,21,938,5,2,3
8,21,1117,8,3,5
8,21,1595,2,0,2
8,22,524,2,1,1
8,22,404,1,0,1
8,22,292,0,0,0
8,22,225,0,0,0
8,22,154,1,1,0
8,22,330,0,0,0
8,22,176,0,0,0
8,22,325,0,0,0
8,23,1152,5,2,3
8,23,2657,81,48,33
8,23,2838,4,2,2
8,24,1204,0,0,0
8,24,813,1,0,1
8,24,342,0,0,0
8,24,434,0,0,0
8,24,593,1,0,1
8,24,192,0,0,0
8,24,178,0,0,0
8,25,561,0,0,0
8,25,447,0,0,0
8,25,846,4,4,0
8,25,484,0,0,0
8,25,433,2,1,1
8,25,684,0,0,0
8,25,1010,18,10,8
8,25,564,14,4,10
8,25,361,4,1,3
8,25,119,0,0,0
8,25,172,0,0,0
8,25,187,0,0,0
8,25,492,0,0,0
8,25,117,0,0,0
8,25,556,1,1,0
8,26,464,0,0,0
8,26,228,0,0,0
8,26,143,0,0,0
8,26,105,0,0,0
8,26,222,0,0,0
8,26,163,8,4,4
8,26,75,0,0,0
8,26,90,0,0,0
8,26,38,0,0,0
8,26,70,0,0,0
8,26,599,0,0,0
8,26,156,3,2,1
8,26,98,0,0,0
8,27,1761,14,2,12
8,27,1906,0,0,0
8,27,1916,2,1,1
8,27,567,0,0,0
8,27,485,0,0,0
8,27,1260,2,1,1
8,27,434,3,1,2
8,27,2688,0,0,0
8,27,1610,10,8,2
8,27,2259,9,3,6
8,27,1871,36,21,15
8,27,2086,5,1,4
8,27,1266,2,0,2
8,27,2214,14,5,9
8,27,531,3,3,0
8,27,2235,25,9,16
8,27,2463,7,2,5
8,27,1024,67,39,28
8,27,1414,2,1,1
8,27,2172,13,5,8
8,27,760,1,0,1
8,27,185,1,0,1
8,27,698,1,0,1
8,27,583,1,1,0
8,27,374,1,0,1
8,27,1423,8,3,5
8,27,900,2,2,0
8,27,273,5,3,2
8,27,244,2,1,1
8,27,716,3,2,1
8,27,569,2,0,2
8,27,572,0,0,0
8,27,2016,217,106,111
8,27,349,0,0,0
8,27,176,0,0,0
8,27,1405,3,0,3
8,27,6272,42,18,24
8,27,322,0,0,0
8,27,475,7,4,3
8,27,452,0,0,0
8,27,712,1,0,1
8,27,217,1,0,1
8,27,286,1,1,0
8,28,513,0,0,0
8,28,309,1,0,1
8,28,837,2,0,2
8,28,299,1,0,1
8,28,671,71,41,30
8,28,506,0,0,0
8,28,127,0,0,0
8,28,942,13,7,6
8,29,921,7,3,4
8,29,6422,58,35,23
8,29,383,1,0,1
8,29,1595,8,7,1
8,29,3258,3,1,2
8,29,2106,11,6,5
8,29,2943,17,10,7
8,29,1876,2,2,0
8,29,2652,14,7,7
8,29,1338,104,51,53
8,29,1938,99,48,51
8,29,1169,2,1,1
8,29,1891,3,1,2
8,29,1245,11,3,8
8,29,691,2,1,1
8,29,150,0,0,0
8,29,694,1,0,1
8,29,1076,2,1,1
8,29,1055,5,2,3
8,29,2009,14,7,7
8,29,593,3,1,2
8,29,380,1,0,1
8,29,870,0,0,0
8,29,3468,6,3,3
8,29,1890,11,6,5
8,29,1687,4,4,0
8,29,339,0,0,0
8,29,1196,1,1,0
8,29,837,1,0,1
8,29,2121,4,2,2
8,29,147,0,0,0
8,30,2054,4,2,2
8,30,1354,2,1,1
8,30,1123,2,2,0
8,30,1171,137,69,68
8,30,1361,4,1,3
8,30,493,20,10,10
8,30,330,1,0,1
8,30,989,0,0,0
8,30,190,0,0,0
8,30,579,0,0,0
8,30,252,1,1,0
8,30,250,0,0,0
8,30,213,0,0,0
8,30,155,0,0,0
8,31,1937,5,4,1
8,31,728,4,2,2
8,31,1216,5,2,3
8,31,936,5,2,3
8,31,913,4,3,1
8,31,1957,31,16,15
8,31,1339,8,4,4
8,31,772,7,2,5
8,31,896,0,0,0
8,31,463,2,1,1
8,31,310,2,0,2
8,31,319,0,0,0
8,31,480,8,4,4
8,31,775,8,4,4
8,31,704,3,2,1
8,31,331,60,32,28
8,31,1030,1,0,1
8,31,783,1,1,0
8,31,620,3,0,3
8,31,230,2,1,1
8,31,136,1,0,1
8,31,60,1,0,1
8,31,207,0,0,0
8,31,158,0,0,0
8,31,86,0,0,0
8,31,246,1,0,1
8,31,285,1,1,0
8,31,340,2,1,1
8,31,468,0,0,0
8,31,588,1,1,0
8,31,834,66,25,41
8,31,472,0,0,0
8,31,315,1,1,0
8,31,1341,29,11,18
8,31,458,2,1,1
8,31,839,26,12,14
8,31,218,1,0,1
8,31,145,1,0,1
8,31,428,0,0,0
8,31,375,7,3,4
8,31,447,0,0,0
8,31,170,0,0,0
8,31,697,0,0,0
8,31,571,0,0,0
8,31,237,0,0,0
8,31,150,0,0,0
8,31,345,0,0,0
8,31,983,2,0,2
8,31,2053,9,3,6
8,31,111,0,0,0
8,31,296,0,0,0
8,31,507,2,0,2
8,31,153,0,0,0
8,31,577,3,1,2
8,31,668,1,0,1
8,31,149,0,0,0
8,31,89,1,1,0
8,31,517,1,1,0
8,31,162,1,0,1
8,31,551,11,6,5
8,31,209,1,1,0
8,31,195,1,0,1
8,31,131,0,0,0
8,31,220,0,0,0
8,31,62,0,0,0
8,31,157,0,0,0
8,31,168,0,0,0
8,32,1964,5,2,3
8,32,1323,2,1,1
8,32,1779,83,43,40
8,32,1362,7,0,7
8,32,752,6,2,4
8,32,886,4,3,1
8,32,2869,3,3,0
8,32,2274,4,2,2
8,32,2378,3,0,3
8,32,824,3,2,1
8,32,1083,1,0,1
8,32,907,4,2,2
8,32,989,6,3,3
8,32,4455,63,25,38
8,32,1536,6,3,3
8,32,5706,11,5,6
8,32,892,0,0,0
8,32,1254,1,1,0
8,32,1313,8,6,2
8,32,878,1,1,0
8,32,170,0,0,0
8,32,716,0,0,0
8,32,1187,1,0,1
8,32,983,0,0,0
8,32,2715,68,32,36
8,32,2849,34,13,21
8,32,583,1,1,0
8,32,856,1,1,0
8,32,1288,4,2,2
8,32,892,2,0,2
8,32,7661,9,5,4
8,32,1723,9,6,3
8,32,1547,69,38,31
8,32,614,0,0,0
8,32,1334,8,5,3
8,32,962,0,0,0
8,32,1061,0,0,0
8,32,626,0,0,0
8,32,302,0,0,0
8,32,504,0,0,0
8,32,2261,10,4,6
8,32,424,12,7,5
8,32,891,1,0,1
8,32,767,3,1,2
8,32,204,1,0,1
8,32,440,0,0,0
8,32,629,4,0,4
8,32,476,0,0,0
8,32,463,0,0,0
8,32,208,1,1,0
8,32,375,0,0,0
8,32,520,32,18,14
8,32,2188,10,5,5
8,32,2201,1,1,0
8,32,321,2,1,1
8,32,390,0,0,0
8,32,949,5,1,4
8,32,326,0,0,0
8,32,625,0,0,0
8,32,737,7,2,5
8,32,511,2,1,1
8,32,915,4,2,2
8,32,1024,2,0,2
8,32,555,0,0,0
8,32,134,0,0,0
8,32,406,0,0,0
8,32,365,1,0,1
8,32,1240,0,0,0
8,32,1091,4,1,3
8,32,853,3,0,3
8,32,1376,171,98,73
8,32,2024,15,10,5
8,32,877,4,2,2
8,32,2127,35,18,17
8,32,1303,2,1,1
8,32,600,176,104,72
8,32,1297,1,1,0
8,32,448,0,0,0
8,32,115,0,0,0
8,32,3144,15,8,7
8,32,855,0,0,0
8,32,882,0,0,0
8,32,3745,259,113,146
8,32,129,0,0,0
8,32,166,1,0,1
8,32,2201,6,1,5
8,32,8929,40,18,22
8,33,507,0,0,0
8,33,356,1,1,0
8,34,411,0,0,0
8,34,349,0,0,0
8,34,1229,1,0,1
8,34,155,0,0,0
8,34,61,0,0,0
8,34,288,0,0,0
8,34,22,0,0,0
8,34,28,0,0,0
8,34,244,0,0,0
8,34,470,0,0,0
8,34,529,0,0,0
8,34,230,0,0,0
8,34,946,3,1,2
8,34,226,4,1,3
8,35,1291,2,0,2
8,35,582,3,2,1
8,35,1534,12,5,7
8,35,704,3,0,3
8,35,2695,12,4,8
8,35,891,5,1,4
8,35,1443,0,0,0
8,35,144,0,0,0
8,35,684,0,0,0
8,35,449,0,0,0
8,35,319,0,0,0
8,35,233,0,0,0
8,36,1360,10,4,6
8,36,1119,1,0,1
8,36,794,1,1,0
8,36,816,0,0,0
8,36,592,0,0,0
8,36,537,1,0,1
8,36,1091,30,10,20
8,36,515,0,0,0
8,36,779,0,0,0
8,36,604,3,0,3
8,36,676,28,16,12
8,36,2294,2,0,2
8,36,1106,0,0,0
8,36,839,1,1,0
8,36,585,2,2,0
8,36,866,5,3,2
8,36,972,4,1,3
8,36,690,1,1,0
8,36,1766,2,1,1
8,36,1971,2,2,0
8,36,5774,21,12,9
8,36,581,5,2,3
8,36,958,1,0,1
8,36,999,4,3,1
8,36,4157,14,7,7
8,36,2651,5,4,1
8,36,548,0,0,0
8,36,373,0,0,0
8,36,475,0,0,0
8,36,826,7,2,5
8,36,385,3,2,1
8,36,768,1,0,1
8,36,1164,0,0,0
8,36,651,13,4,9
8,36,334,6,3,3
8,36,247,2,1,1
8,37,8424,571,293,278
8,37,5558,121,57,64
8,37,2118,1,0,1
8,37,765,1,0,1
8,37,1306,1,0,1
8,37,1651,5,3,2
8,37,5956,240,121,119
8,37,929,1,1,0
8,37,1115,8,6,2
8,37,1039,1,0,1
8,37,1006,4,2,2
8,37,606,15,6,9
8,37,634,3,0,3
8,37,889,17,10,7
8,37,648,8,4,4
8,37,294,4,2,2
8,37,423,0,0,0
8,37,417,12,4,8
8,37,370,2,0,2
8,37,215,1,1,0
8,37,152,11,4,7
8,37,312,9,6,3
8,37,453,13,3,10
8,37,365,0,0,0
8,37,463,2,1,1
8,37,494,4,2,2
8,37,476,7,3,4
8,37,293,5,3,2
8,37,247,0,0,0
8,37,539,18,7,11
8,37,364,1,0,1
8,37,625,0,0,0
8,37,451,13,7,6
8,37,471,5,1,4
8,37,692,19,11,8
8,37,521,36,17,19
8,37,596,41,20,21
8,37,1010,10,5,5
8,37,591,2,1,1
8,37,767,6,2,4
8,37,609,5,3,2
8,37,505,1,0,1
8,37,637,28,15,13
8,37,354,9,3,6
8,37,523,40,24,16
8,37,1772,7,2,5
8,37,1103,6,2,4
8,37,2003,15,9,6
8,37,1516,5,0,5
8,37,754,22,11,11
8,37,525,8,6,2
8,37,575,3,2,1
8,37,850,3,1,2
8,37,450,3,1,2
8,37,866,5,1,4
8,37,869,15,9,6
8,37,430,0,0,0
8,37,665,1,1,0
8,37,582,1,0,1
8,37,1165,3,2,1
8,37,847,7,5,2
8,37,633,87,37,50
8,37,517,20,10,10
8,37,404,41,25,16
8,37,636,15,8,7
8,37,359,9,5,4
8,37,390,3,2,1
8,37,428,1,1,0
8,37,455,13,7,6
8,37,206,17,5,12
8,37,432,5,1,4
8,37,331,4,2,2
8,37,517,2,1,1
8,37,505,3,0,3
8,37,51,0,0,0
8,37,212,26,13,13
8,37,294,24,11,13
8,37,293,0,0,0
8,37,420,19,9,10
8,37,697,0,0,0
8,37,922,11,5,6
8,37,760,2,1,1
8,37,809,6,3,3
8,37,950,4,3,1
8,37,921,3,2,1
8,37,1157,23,13,10
8,37,2979,20,9,11
8,37,1962,15,5,10
8,37,876,4,2,2
8,37,867,1,1,0
8,37,614,4,3,1
8,37,429,31,13,18
8,37,663,26,19,7
8,37,666,9,3,6
8,37,729,4,2,2
8,37,606,5,3,2
8,37,482,1,0,1
8,37,501,0,0,0
8,37,313,1,0,1
8,37,469,66,33,33
8,37,246,7,5,2
8,37,303,1,1,0
8,37,316,13,5,8
8,37,501,1,1,0
8,37,243,1,0,1
8,37,341,0,0,0
8,37,213,12,3,9
8,37,319,5,2,3
8,37,117,0,0,0
8,37,242,1,0,1
8,37,300,8,4,4
8,37,424,3,1,2
8,37,651,32,12,20
8,37,718,2,1,1
8,37,1377,19,13,6
8,37,635,8,6,2
8,37,557,0,0,0
8,37,587,0,0,0
8,37,1131,7,4,3
8,37,612,0,0,0
8,37,737,1,1,0
8,37,592,2,1,1
8,37,3234,23,9,14
8,37,3990,57,21,36
8,37,1085,3,2,1
8,37,891,59,29,30
8,37,603,2,1,1
8,37,487,0,0,0
8,37,350,2,0,2
8,37,481,8,5,3
8,37,653,7,5,2
8,37,425,12,4,8
8,37,1567,9,6,3
8,37,917,19,11,8
8,37,1121,26,9,17
8,37,5226,51,24,27
8,37,4299,47,24,23
8,37,775,9,4,5
8,37,8360,63,33,30
8,37,6601,48,24,24
8,37,2465,5,4,1
8,37,568,4,4,0
8,37,444,4,2,2
8,37,1736,25,11,14
8,37,1235,7,4,3
8,37,608,5,5,0
8,37,1070,27,16,11
8,37,782,9,2,7
8,37,1217,45,21,24
8,37,590,14,5,9
8,37,1603,0,0,0
8,37,1197,1,1,0
8,37,1068,4,3,1
8,37,1072,13,6,7
8,37,3017,10,6,4
8,37,911,16,7,9
8,37,352,6,1,5
8,37,640,3,0,3
8,37,878,5,2,3
8,37,676,25,12,13
8,37,439,2,0,2
8,37,644,1,1,0
8,37,491,6,4,2
8,37,650,3,2,1
8,37,528,2,2,0
8,37,425,11,6,5
8,37,326,18,11,7
8,37,459,2,1,1
8,37,594,4,1,3
8,37,588,9,5,4
8,37,547,0,0,0
8,37,1020,17,5,12
8,37,1277,8,3,5
8,37,612,3,0,3
8,37,3609,62,28,34
8,37,1041,11,4,7
8,37,1434,17,3,14
8,37,1007,1,0,1
8,37,840,14,6,8
8,37,1323,10,6,4
8,37,446,9,5,4
8,37,471,7,4,3
8,37,504,2,1,1
8,37,523,4,1,3
8,37,431,1,0,1
8,37,503,9,3,6
8,37,459,19,9,10
8,37,358,30,15,15
8,37,523,25,10,15
8,37,611,6,4,2
8,37,616,18,9,9
8,37,200,0,0,0
8,37,733,22,9,13
8,37,498,7,4,3
8,37,1201,9,3,6
8,37,629,4,2,2
8,37,464,10,5,5
8,37,2623,9,5,4
8,37,432,6,3,3
8,37,1758,25,15,10
8,37,492,3,2,1
8,37,638,5,4,1
8,37,436,6,1,5
8,37,248,8,4,4
8,37,732,8,1,7
8,37,796,4,0,4
8,37,499,0,0,0
8,37,637,5,5,0
8,37,845,4,2,2
8,37,638,4,1,3
8,37,550,5,1,4
8,37,970,9,3,6
8,37,1055,19,9,10
8,37,720,13,6,7
8,37,1130,71,37,34
8,37,1042,10,6,4
8,37,582,0,0,0
8,37,744,352,177,175
8,37,12184,794,422,372
8,37,684,20,8,12
8,37,297,1,1,0
8,37,599,4,2,2
8,37,1358,8,7,1
8,37,641,2,1,1
8,37,503,0,0,0
8,37,1046,15,11,4
8,37,645,4,1,3
8,37,734,6,1,5
8,37,549,13,6,7
8,37,626,2,1,1
8,37,967,0,0,0
8,37,953,6,2,4
8,37,409,0,0,0
8,37,719,24,9,15
8,37,506,10,7,3
8,37,687,23,11,12
8,37,597,2,1,1
8,37,621,1,0,1
8,37,421,6,3,3
8,37,563,5,2,3
8,37,710,2,1,1
8,37,1017,15,4,11
8,37,1306,14,7,7
8,37,503,5,1,4
8,37,590,2,0,2
8,37,535,7,3,4
8,37,425,0,0,0
8,37,428,1,0,1
8,37,665,11,8,3
8,37,955,2,2,0
8,37,597,7,3,4
8,37,873,0,0,0
8,37,682,44,14,30
8,37,455,1,1,0
8,37,1383,6,2,4
8,37,1266,29,9,20
8,37,1049,24,14,10
8,37,716,18,10,8
8,37,2520,19,5,14
8,37,17772,216,99,117
8,37,1666,4,3,1
8,37,683,4,3,1
8,37,709,9,3,6
8,37,930,9,4,5
8,37,648,8,2,6
8,37,795,13,8,5
8,37,712,3,1,2
8,37,302,8,3,5
8,37,1285,8,5,3
8,37,1555,9,6,3
8,37,8026,114,56,58
8,37,352,2,1,1
8,37,766,2,0,2
8,37,699,10,7,3
8,37,535,7,4,3
8,37,495,2,1,1
8,37,708,3,0,3
8,37,1222,5,2,3
8,37,1567,8,6,2
8,37,1020,5,1,4
8,37,1451,8,3,5
8,37,2721,24,14,10
8,37,11007,87,50,37
8,37,2020,35,16,19
8,37,748,3,1,2
8,37,466,0,0,0
8,37,671,11,5,6
8,37,1001,1,0,1
8,37,1276,6,4,2
8,37,700,1,0,1
8,37,586,1,1,0
8,37,746,7,5,2
8,37,892,8,5,3
8,37,817,7,4,3
8,37,394,3,3,0
8,37,607,16,7,9
8,37,952,6,4,2
8,37,522,4,3,1
8,37,346,0,0,0
8,37,455,1,1,0
8,37,747,1,0,1
8,37,661,6,2,4
8,37,909,56,26,30
8,37,524,11,5,6
8,37,423,11,6,5
8,37,1248,32,17,15
8,37,646,4,0,4
8,37,1342,8,5,3
8,37,2018,32,13,19
8,37,2400,22,11,11
8,37,7548,99,50,49
8,37,755,169,82,87
8,37,2364,147,71,76
8,37,456,0,0,0
8,37,855,32,17,15
8,37,522,7,4,3
8,37,627,5,3,2
8,37,211,4,2,2
8,37,217,1,1,0
8,37,4941,68,26,42
8,37,875,17,11,6
8,37,2207,30,15,15
8,37,936,16,11,5
8,37,915,4,3,1
8,37,593,19,14,5
8,37,1798,25,8,17
8,37,1167,16,8,8
8,37,493,6,3,3
8,37,933,3,2,1
8,37,7075,183,89,94
8,37,2535,61,28,33
8,37,3574,65,36,29
8,37,2113,32,12,20
8,37,8030,179,96,83
8,37,543,4,3,1
8,37,790,0,0,0
8,37,481,8,5,3
8,37,367,7,4,3
8,37,1933,6,4,2
8,37,1481,34,19,15
8,37,664,0,0,0
8,37,1111,10,3,7
8,37,853,9,0,9
8,37,825,5,2,3
8,37,996,7,3,4
8,37,556,7,2,5
8,37,482,1,0,1
8,37,14081,202,98,104
8,37,840,5,3,2
8,37,1053,6,3,3
8,37,928,9,5,4
8,37,630,15,8,7
8,37,527,5,0,5
8,37,1051,3,2,1
8,37,1538,4,0,4
8,37,354,0,0,0
8,37,581,1,0,1
8,37,781,5,4,1
8,37,874,25,8,17
8,37,957,14,8,6
8,37,649,29,13,16
8,37,605,5,2,3
8,37,1029,9,3,6
8,37,383,1,0,1
8,37,535,2,1,1
8,37,934,15,9,6
8,37,656,0,0,0
8,37,428,12,7,5
8,37,936,10,6,4
8,37,1645,30,14,16
8,37,1593,15,5,10
8,37,919,9,6,3
8,37,831,4,3,1
8,37,620,25,13,12
8,37,1061,3,1,2
8,37,652,6,3,3
8,37,618,2,0,2
8,37,441,3,1,2
8,37,627,5,1,4
8,37,569,2,1,1
8,37,689,3,1,2
8,37,599,13,8,5
8,37,854,6,4,2
8,37,835,18,9,9
8,37,686,0,0,0
8,37,770,7,3,4
8,37,875,9,6,3
8,37,937,46,20,26
8,37,767,73,33,40
8,37,982,5,3,2
8,37,897,9,6,3
8,37,621,18,12,6
8,37,536,0,0,0
8,37,558,13,7,6
8,37,675,27,15,12
8,37,788,19,8,11
8,37,828,8,7,1
8,37,750,12,8,4
8,37,808,3,3,0
8,37,786,3,2,1
8,37,767,9,5,4
8,37,4101,70,36,34
8,37,7908,195,88,107
8,37,960,8,4,4
8,37,968,4,2,2
8,37,1067,8,4,4
8,37,1061,17,7,10
8,37,825,3,1,2
8,37,559,31,14,17
8,37,1131,8,5,3
8,37,614,7,3,4
8,37,594,5,3,2
8,37,1340,15,7,8
8,37,1469,11,8,3
8,37,657,8,5,3
8,37,696,7,2,5
8,37,705,20,10,10
8,37,699,8,2,6
8,37,727,10,5,5
8,37,920,4,1,3
8,37,814,0,0,0
8,37,816,1,0,1
8,37,806,8,5,3
8,37,587,19,9,10
8,37,597,0,0,0
8,37,517,8,5,3
8,37,3047,9,5,4
8,37,798,2,1,1
8,37,859,6,2,4
8,37,1014,3,1,2
8,37,809,3,1,2
8,37,566,3,2,1
8,37,1509,5,1,4
8,37,2515,33,20,13
8,37,761,3,2,1
8,37,1139,2,1,1
8,37,545,0,0,0
8,37,458,0,0,0
8,37,493,1,0,1
8,37,435,0,0,0
8,37,706,3,2,1
8,37,900,11,4,7
8,37,606,2,1,1
8,37,1803,18,7,11
8,37,1163,16,8,8
8,37,557,1,1,0
8,37,1882,15,8,7
8,37,645,27,15,12
8,37,433,2,2,0
8,37,494,5,2,3
8,37,527,6,1,5
8,37,538,4,1,3
8,37,3317,3,2,1
8,37,3071,8,5,3
8,37,2696,20,11,9
8,37,1112,14,7,7
8,37,590,12,5,7
8,37,725,20,9,11
8,37,1077,5,1,4
8,37,598,1,0,1
8,37,9707,51,25,26
8,37,1006,24,11,13
8,37,2657,35,14,21
8,37,6532,103,47,56
8,37,489,3,0,3
8,37,1697,14,8,6
8,37,2820,7,2,5
8,37,935,45,19,26
8,37,646,10,3,7
8,37,563,38,19,19
8,37,579,6,5,1
8,37,704,204,110,94
8,37,796,6,2,4
8,37,852,39,14,25
8,37,861,86,47,39
8,37,968,9,4,5
8,37,1249,2,2,0
8,37,1111,5,1,4
8,37,1245,8,4,4
8,37,435,0,0,0
8,37,916,3,2,1
8,37,1593,10,4,6
8,37,1052,4,1,3
8,37,971,34,14,20
8,37,819,0,0,0
8,37,902,45,30,15
8,37,939,10,3,7
8,37,8751,67,34,33
8,37,294,6,0,6
8,37,14687,104,50,54
8,37,864,14,6,8
8,37,1073,2,1,1
8,37,1929,78,35,43
8,37,929,2,0,2
8,37,882,2,2,0
8,37,764,1,1,0
8,37,966,1,1,0
8,37,743,0,0,0
8,37,1014,1,0,1
8,37,888,21,14,7
8,37,893,2,1,1
8,37,1468,4,2,2
8,37,2687,58,30,28
8,37,2953,24,11,13
8,37,726,10,3,7
8,37,1559,6,2,4
8,37,3460,31,20,11
8,37,980,24,12,12
8,37,933,2,2,0
8,37,3468,15,10,5
8,37,543,2,0,2
8,37,687,4,1,3
8,37,1682,7,2,5
8,37,6254,37,21,16
8,37,2093,66,28,38
8,37,1760,53,28,25
8,37,825,2,0,2
8,37,17225,254,112,142
8,37,1123,6,3,3
8,37,839,4,1,3
8,37,849,20,5,15
8,37,1476,7,6,1
8,37,1550,21,7,14
8,37,893,3,2,1
8,37,461,0,0,0
8,37,772,2,0,2
8,37,418,1,1,0
8,37,628,2,0,2
8,37,646,15,6,9
8,37,515,1,0,1
8,37,500,4,2,2
8,37,492,7,3,4
8,37,427,10,5,5
8,37,440,1,0,1
8,37,352,3,0,3
8,37,296,6,1,5
8,37,397,0,0,0
8,37,394,0,0,0
8,37,290,0,0,0
8,37,304,1,0,1
8,37,425,12,5,7
8,37,464,1,0,1
8,37,323,0,0,0
8,37,582,2,1,1
8,37,482,1,0,1
8,37,567,11,5,6
8,37,1579,625,313,312
8,37,805,357,170,187
8,37,720,9,5,4
8,37,665,0,0,0
8,37,991,6,4,2
8,37,691,3,2,1
8,37,525,4,1,3
8,37,509,0,0,0
8,37,583,8,4,4
8,37,416,15,10,5
8,37,449,12,5,7
8,37,571,36,16,20
8,37,891,24,9,15
8,37,611,7,3,4
8,37,743,5,2,3
8,37,475,4,0,4
8,37,495,0,0,0
8,37,628,43,26,17
8,37,695,34,19,15
8,37,750,3,1,2
8,37,834,24,12,12
8,37,658,27,9,18
8,37,455,11,4,7
8,37,556,1,1,0
8,37,519,2,1,1
8,37,534,3,2,1
8,37,976,8,4,4
8,37,644,0,0,0
8,37,471,4,3,1
8,37,909,2,1,1
8,37,589,5,3,2
8,37,929,8,3,5
8,37,900,5,2,3
8,37,1186,3,1,2
8,37,2091,15,8,7
8,37,901,3,1,2
8,37,1247,7,2,5
8,37,754,2,2,0
8,37,1080,12,3,9
8,37,828,1,0,1
8,37,763,4,2,2
8,37,518,0,0,0
8,37,506,32,15,17
8,37,825,30,11,19
8,37,618,26,13,13
8,37,752,32,16,16
8,37,684,10,3,7
8,37,569,2,1,1
8,37,807,5,1,4
8,37,634,6,5,1
8,37,682,21,11,10
8,37,668,19,12,7
8,37,696,1,0,1
8,37,663,12,6,6
8,37,1002,11,6,5
8,37,1117,6,2,4
8,37,825,2,1,1
8,37,952,213,102,111
8,37,630,11,4,7
8,37,741,9,5,4
8,37,403,0,0,0
8,37,511,1,1,0
8,37,608,1,0,1
8,37,655,248,123,125
8,37,1377,6,2,4
8,37,874,12,5,7
8,37,658,2,1,1
8,37,911,9,4,5
8,37,811,6,3,3
8,37,443,3,1,2
8,37,641,4,1,3
8,37,755,5,4,1
8,37,469,0,0,0
8,37,563,3,1,2
8,37,977,2,1,1
8,37,922,5,2,3
8,37,591,1,0,1
8,37,750,1,1,0
8,37,1342,6,5,1
8,37,1727,4,2,2
8,37,3076,52,32,20
8,37,3664,46,19,27
8,37,2803,7,5,2
8,37,2986,8,4,4
8,37,996,2,1,1
8,37,408,1,1,0
8,37,1173,3,0,3
8,37,937,8,6,2
8,37,875,1,0,1
8,37,605,5,4,1
8,37,784,0,0,0
8,37,3272,14,3,11
8,37,697,6,4,2
8,37,670,0,0,0
8,37,821,11,4,7
8,37,699,21,10,11
8,37,1322,9,5,4
8,37,602,13,8,5
8,37,544,10,5,5
8,37,655,113,59,54
8,37,935,11,3,8
8,37,727,210,101,109
8,37,609,20,11,9
8,37,908,23,12,11
8,37,1215,12,4,8
8,37,772,10,2,8
8,37,625,5,1,4
8,37,867,170,81,89
8,37,936,8,3,5
8,37,733,2,2,0
8,37,645,6,4,2
8,37,676,25,12,13
8,37,915,12,5,7
8,37,622,11,4,7
8,37,501,9,3,6
8,37,1004,3,2,1
8,37,1073,5,2,3
8,37,639,5,2,3
8,37,1083,11,5,6
8,37,719,2,1,1
8,37,911,7,4,3
8,37,590,4,2,2
8,37,598,3,1,2
8,37,632,7,2,5
8,37,698,2,1,1
8,37,580,0,0,0
8,37,936,22,12,10
8,37,989,5,1,4
8,37,1680,72,31,41
8,37,1378,1,0,1
8,37,1328,1,1,0
8,37,1548,6,3,3
8,37,1791,17,7,10
8,37,1678,4,2,2
8,37,1379,18,7,11
8,37,1109,18,8,10
8,37,336,83,40,43
8,37,1231,3,1,2
8,37,875,7,1,6
8,37,653,163,80,83
8,37,1039,50,25,25
8,37,542,243,130,113
8,37,709,52,23,29
8,37,837,3,0,3
8,37,731,0,0,0
8,37,2617,103,50,53
8,37,8246,72,27,45
8,37,1583,98,51,47
8,37,613,20,11,9
8,37,1407,7,3,4
8,37,575,7,4,3
8,37,640,59,32,27
8,37,533,99,50,49
8,37,1302,9,5,4
8,37,809,7,3,4
8,37,1143,21,8,13
8,37,2741,8,3,5
8,37,3983,17,7,10
8,37,848,4,3,1
8,37,1377,13,6,7
8,37,1620,13,8,5
8,37,1103,47,20,27
8,37,655,0,0,0
8,37,870,8,2,6
8,37,939,6,4,2
8,37,771,7,6,1
8,37,3372,18,10,8
8,37,957,4,3,1
8,37,1261,7,4,3
8,37,667,1,0,1
8,37,564,3,1,2
8,37,1187,4,4,0
8,37,696,2,1,1
8,37,814,2,0,2
8,37,768,5,2,3
8,37,1029,2,2,0
8,37,557,0,0,0
8,37,641,1,1,0
8,37,1626,22,11,11
8,37,1308,0,0,0
8,37,986,6,4,2
8,37,3735,28,21,7
8,37,1124,3,1,2
8,37,685,0,0,0
8,37,1252,5,1,4
8,37,1028,13,7,6
8,37,855,4,3,1
8,37,1094,11,4,7
8,37,527,2,1,1
8,37,741,13,7,6
8,37,693,1,1,0
8,37,1239,3,0,3
8,37,1230,2,1,1
8,37,1119,2,1,1
8,37,567,17,7,10
8,37,605,1,0,1
8,37,506,4,1,3
8,37,1372,7,4,3
8,37,2452,262,141,121
8,37,1275,5,3,2
8,37,1508,25,11,14
8,37,735,9,3,6
8,37,663,19,11,8
8,37,1125,45,24,21
8,37,1123,88,36,52
8,37,1287,12,4,8
8,37,1181,5,1,4
8,37,864,1,1,0
8,37,1234,11,6,5
8,37,930,5,3,2
8,37,772,4,4,0
8,37,644,18,8,10
8,37,695,11,6,5
8,37,1399,8,4,4
8,37,6477,33,22,11
8,37,2605,15,8,7
8,37,440,4,2,2
8,37,2565,54,23,31
8,37,3028,27,15,12
8,37,1552,12,6,6
8,37,714,28,13,15
8,37,10125,126,65,61
8,37,2607,30,14,16
8,37,3992,69,32,37
8,38,1055,103,56,47
8,38,1066,42,9,33
8,38,459,36,15,21
8,38,1155,2,1,1
8,38,602,1,0,1
8,38,599,0,0,0
8,39,1249,1,1,0
8,39,1009,2,1,1
8,39,321,0,0,0
8,39,259,0,0,0
8,39,530,0,0,0
8,39,616,0,0,0
8,39,127,0,0,0
8,40,819,0,0,0
8,40,2140,38,16,22
8,40,1155,8,5,3
8,40,592,2,0,2
8,40,758,2,0,2
8,40,721,5,5,0
8,40,476,2,1,1
8,40,477,0,0,0
8,40,444,5,4,1
8,40,573,7,6,1
8,40,488,12,8,4
8,40,1075,22,11,11
8,40,2340,5,1,4
8,40,662,3,0,3
8,40,257,1,1,0
8,40,808,1,1,0
8,40,934,7,3,4
8,40,284,1,0,1
8,40,281,0,0,0
8,40,263,0,0,0
8,40,204,1,1,0
8,40,193,0,0,0
8,40,386,1,0,1
8,40,331,4,3,1
8,40,335,0,0,0
8,40,644,4,3,1
8,40,852,13,5,8
8,40,847,4,2,2
8,40,382,0,0,0
8,40,248,8,4,4
8,40,300,0,0,0
8,40,250,0,0,0
8,40,610,0,0,0
8,40,483,1,0,1
8,40,74,0,0,0
8,40,9,0,0,0
8,40,668,0,0,0
8,40,370,0,0,0
8,40,114,0,0,0
8,40,27,8,4,4
8,40,336,0,0,0
8,40,439,5,4,1
8,40,312,2,1,1
8,40,40,0,0,0
8,40,313,4,2,2
8,40,311,0,0,0
8,40,526,12,7,5
8,41,795,1,1,0
8,41,86,0,0,0
8,41,160,0,0,0
8,41,51,0,0,0
8,41,112,0,0,0
8,42,424,1,0,1
8,42,421,1,1,0
8,42,120,0,0,0
8,42,66,0,0,0
8,42,124,0,0,0
8,43,174,0,0,0
8,43,1056,3,1,2
8,43,469,0,0,0
8,43,310,0,0,0
8,43,123,0,0,0
8,43,315,1,0,1
8,43,368,2,0,2
8,44,1943,0,0,0
8,44,906,0,0,0
8,44,561,1,0,1
8,44,157,0,0,0
8,44,171,0,0,0
8,44,92,0,0,0
8,44,287,0,0,0
8,44,196,0,0,0
8,45,3146,20,10,10
8,45,1568,12,4,8
8,45,2486,18,6,12
8,45,3267,67,35,32
8,45,1959,19,11,8
8,45,577,2,0,2
8,45,1745,25,10,15
8,45,468,1,0,1
8,45,620,0,0,0
8,45,599,2,0,2
8,45,539,4,2,2
8,45,594,4,3,1
8,45,1003,10,4,6
8,45,613,5,3,2
8,45,2129,9,2,7
8,45,1376,2,1,1
8,45,1155,0,0,0
8,45,1187,5,3,2
8,45,492,1,0,1
8,45,1502,4,2,2
8,45,1930,3,2,1
8,45,1872,5,3,2
8,45,363,52,29,23
8,45,1434,0,0,0
8,45,816,1,0,1
8,45,579,4,0,4
8,45,1017,5,3,2
8,45,874,3,1,2
8,45,931,13,7,6
8,45,701,1,0,1
8,45,1156,6,2,4
8,45,816,2,1,1
8,45,421,1,1,0
8,45,1481,4,2,2
8,45,3113,22,9,13
8,46,1901,7,3,4
8,46,324,1,0,1
8,46,1070,6,2,4
8,46,751,3,1,2
8,46,566,1,0,1
8,46,741,0,0,0
8,46,1444,3,2,1
8,46,2097,2,1,1
8,47,1920,8,3,5
8,47,156,0,0,0
8,47,413,1,0,1
8,47,32,0,0,0
8,47,1050,3,3,0
8,47,378,0,0,0
8,47,109,0,0,0
8,47,689,0,0,0
8,48,809,2,1,1
8,48,454,2,0,2
8,48,115,2,0,2
8,48,991,3,1,2
8,48,988,8,2,6
8,48,328,5,2,3
8,48,364,3,3,0
8,48,503,2,2,0
8,48,501,0,0,0
8,48,579,2,1,1
8,48,829,1,1,0
8,48,1072,3,2,1
8,48,1323,7,5,2
8,48,912,6,2,4
8,48,716,0,0,0
8,48,1264,0,0,0
8,48,86,1,0,1
8,48,117,0,0,0
8,48,341,1,1,0
8,48,1386,3,1,2
8,48,102,3,0,3
8,48,106,1,1,0
8,48,297,0,0,0
8,48,1628,12,7,5
8,48,248,0,0,0
8,48,194,0,0,0
8,48,1046,9,6,3
8,48,90,0,0,0
8,48,591,0,0,0
8,48,251,0,0,0
8,48,175,0,0,0
8,48,150,0,0,0
8,48,322,0,0,0
8,48,94,0,0,0
8,48,314,0,0,0
8,48,371,0,0,0
8,48,629,0,0,0
8,48,243,0,0,0
8,48,67,0,0,0
8,48,369,0,0,0
8,48,401,5,3,2
8,48,193,1,0,1
8,48,215,2,2,0
8,48,536,4,2,2
8,48,383,3,1,2
8,49,1749,8,2,6
8,49,101,0,0,0
8,49,638,0,0,0
8,49,525,1,1,0
8,49,584,0,0,0
8,50,1709,8,6,2
8,50,906,5,2,3
8,50,5831,141,64,77
8,50,926,6,2,4
8,50,657,4,1,3
8,50,1106,16,10,6
8,50,434,0,0,0
8,50,264,0,0,0
8,50,293,1,0,1
8,50,449,7,4,3
8,50,797,0,0,0
8,50,1890,22,8,14
8,50,659,4,3,1
8,50,575,6,4,2
8,50,485,4,2,2
8,50,360,0,0,0
8,50,459,1,0,1
8,50,603,0,0,0
8,50,1490,25,14,11
8,50,1166,84,44,40
8,50,1432,239,133,106
8,50,563,65,34,31
8,50,645,252,125,127
8,50,655,6,4,2
8,50,551,5,2,3
8,50,443,2,2,0
8,50,687,5,3,2
8,50,637,1,0,1
8,50,474,1,0,1
8,50,545,1,0,1
8,50,780,3,1,2
8,50,514,5,3,2
8,50,600,6,2,4
8,50,1161,1,0,1
8,50,5407,28,9,19
8,50,933,3,3,0
8,50,704,5,1,4
8,50,432,1,0,1
8,50,469,14,6,8
8,50,610,14,6,8
8,50,418,12,6,6
8,50,1149,9,5,4
8,50,1251,3,1,2
8,50,1037,3,3,0
8,50,4088,24,12,12
8,50,497,2,0,2
8,50,634,0,0,0
8,50,476,0,0,0
8,50,1204,6,4,2
8,50,821,75,48,27
8,50,2732,15,7,8
8,50,1163,13,9,4
8,50,2560,1,1,0
8,50,310,2,1,1
8,50,1315,5,1,4
8,50,589,0,0,0
8,50,952,2,1,1
8,50,581,2,1,1
8,50,878,4,1,3
8,50,986,0,0,0
8,50,629,1,1,0
8,50,1004,0,0,0
8,50,766,119,55,64
8,50,316,4,2,2
8,51,504,0,0,0
8,51,125,2,1,1
8,51,338,10,6,4
8,51,209,0,0,0
8,51,234,1,0,1
8,51,2433,37,20,17
8,51,1470,42,19,23
8,51,537,0,0,0
8,51,16,0,0,0
8,51,530,0,0,0
8,51,785,1,0,1
8,51,407,2,0,2
8,51,370,0,0,0
8,51,143,0,0,0
8,52,651,8,2,6
8,52,134,0,0,0
8,52,831,14,4,10
8,52,668,4,3,1
8,52,904,10,6,4
8,52,989,13,7,6
8,52,1518,11,7,4
8,52,367,2,2,0
8,52,518,1,0,1
8,52,686,12,7,5
8,52,1015,91,40,51
8,52,1706,19,10,9
8,52,1082,1,1,0
8,52,1079,81,42,39
8,52,1744,28,12,16
8,52,3248,69,40,29
8,52,3106,19,5,14
8,52,53,0,0,0
8,52,87,0,0,0
8,52,369,0,0,0
8,52,1310,5,3,2
8,52,525,5,4,1
8,52,597,3,2,1
8,52,91,0,0,0
8,52,220,0,0,0
8,52,229,7,2,5
8,52,518,6,2,4
8,52,261,10,5,5
8,53,601,2,1,1
8,53,648,1,1,0
8,53,1001,0,0,0
8,53,311,3,1,2
8,53,583,1,0,1
8,53,394,4,0,4
8,53,532,3,1,2
8,53,637,74,42,32
8,53,436,0,0,0
8,54,459,0,0,0
8,54,1628,12,7,5
8,54,4261,10,4,6
8,54,147,0,0,0
8,54,144,0,0,0
8,54,371,1,0,1
8,54,147,2,0,2
8,54,238,0,0,0
8,54,92,0,0,0
8,55,2427,112,57,55
8,55,741,103,47,56
8,55,748,2,0,2
8,55,2041,23,12,11
8,55,316,0,0,0
8,55,883,3,2,1
8,55,860,3,2,1
8,55,494,7,4,3
8,55,1176,3,1,2
8,55,1591,92,47,45
8,55,411,1,0,1
8,55,384,0,0,0
8,55,802,9,5,4
8,55,2252,7,3,4
8,55,706,0,0,0
8,55,986,1,0,1
8,56,752,1,1,0
8,56,649,3,1,2
8,56,212,0,0,0
8,56,478,0,0,0
8,57,608,0,0,0
8,57,736,1,0,1
8,57,81,0,0,0
8,57,362,2,0,2
8,57,74,1,1,0
8,57,235,1,0,1
8,57,151,0,0,0
8,58,602,0,0,0
8,58,555,1,0,1
8,58,649,1,1,0
8,58,329,1,0,1
8,58,127,0,0,0
8,58,365,0,0,0
8,58,104,0,0,0
8,59,1357,1,1,0
8,59,31,0,0,0
8,59,412,1,0,1
8,59,549,0,0,0
8,59,358,0,0,0
8,59,576,1,1,0
8,59,199,0,0,0
8,59,203,0,0,0
8,59,478,6,3,3
8,59,602,5,2,3
8,59,160,0,0,0
8,60,616,5,2,3
8,60,409,5,2,3
8,60,186,3,1,2
8,60,117,0,0,0
8,60,539,2,0,2
8,60,552,4,3,1
8,60,363,0,0,0
8,60,596,17,9,8
8,60,289,0,0,0
8,60,1805,2,1,1
8,60,562,1,0,1
8,60,315,24,12,12
8,60,595,96,49,47
8,60,1241,2,2,0
8,60,567,4,2,2
8,60,622,0,0,0
8,60,268,7,2,5
8,60,1423,5,2,3
8,60,286,3,0,3
8,60,204,13,5,8
8,61,279,0,0,0
8,61,428,0,0,0
8,61,229,0,0,0
8,61,197,0,0,0
8,61,96,0,0,0
8,61,391,0,0,0
8,61,183,0,0,0
8,61,382,0,0,0
8,61,178,0,0,0
8,61,228,0,0,0
8,61,119,0,0,0
8,61,561,0,0,0
8,61,164,0,0,0
8,62,1433,7,5,2
8,62,774,1,0,1
8,62,372,3,2,1
8,62,459,3,3,0
8,62,544,2,0,2
8,62,1009,10,7,3
8,62,216,0,0,0
8,62,1692,4,2,2
8,62,644,1,0,1
8,62,1484,9,7,2
8,62,1787,3,1,2
8,62,568,3,2,1
8,62,1965,3,1,2
8,62,962,5,4,1
8,62,207,0,0,0
8,62,724,2,0,2
8,62,484,0,0,0
8,62,869,2,2,0
8,62,1444,6,2,4
8,62,587,5,2,3
8,62,624,0,0,0
8,62,905,2,1,1
8,62,1315,1,0,1
8,62,929,1,0,1
8,62,906,7,3,4
8,62,840,13,6,7
8,62,1961,1,0,1
8,62,1308,4,1,3
8,62,567,1,0,1
8,62,501,2,0,2
8,62,374,0,0,0
8,62,1402,0,0,0
8,63,79,0,0,0
8,63,1418,2,1,1
8,63,256,3,3,0
8,63,148,0,0,0
8,63,180,4,2,2
8,63,509,1,0,1
8,63,140,0,0,0
8,63,395,0,0,0
8,63,262,1,0,1
8,63,215,3,0,3
8,63,125,1,0,1
8,63,1161,3,2,1
8,63,385,4,2,2
8,64,380,2,0,2
8,64,301,2,1,1
8,64,339,1,1,0
8,64,74,0,0,0
8,64,229,0,0,0
8,64,65,0,0,0
8,64,77,0,0,0
8,65,1344,2,1,1
8,65,169,0,0,0
8,65,882,0,0,0
8,65,2121,17,8,9
8,65,565,111,65,46
8,65,843,2,2,0
8,65,457,0,0,0
8,65,123,0,0,0
8,65,1193,2,1,1
8,65,492,1,0,1
8,65,966,0,0,0
8,65,1652,2,0,2
8,65,235,1,0,1
8,65,710,0,0,0
8,65,2186,6,5,1
8,65,429,1,0,1
8,66,1214,1,1,0
8,66,822,98,52,46
8,66,347,0,0,0
8,66,490,0,0,0
8,66,263,0,0,0
8,66,332,0,0,0
8,66,396,0,0,0
8,66,524,0,0,0
8,66,198,0,0,0
8,66,50,0,0,0
8,66,442,1,0,1
8,67,1424,7,5,2
8,67,989,4,1,3
8,67,175,2,0,2
8,67,100,0,0,0
8,67,191,0,0,0
8,67,205,0,0,0
8,67,116,1,0,1
8,67,574,0,0,0
8,67,159,0,0,0
8,67,94,0,0,0
8,67,517,0,0,0
8,67,234,1,0,1
8,37,12183,190,103,87
8,37,1415,37,18,19
8,37,4026,217,104,113
8,37,1814,22,17,5
8,37,1083,8,4,4
8,37,1000,7,4,3
8,37,1800,20,12,8
8,37,1224,10,3,7
8,37,1667,8,3,5
8,37,1674,17,9,8
8,37,568,2,0,2
8,37,1351,22,11,11
8,37,1281,6,1,5
8,37,944,24,6,18
8,37,1890,12,7,5
8,37,1503,1,1,0
8,37,1116,604,292,312
8,37,1082,176,94,82
8,37,1398,64,33,31
8,37,1030,12,5,7
8,37,1580,25,12,13
8,37,998,26,14,12
8,37,1990,45,18,27
8,37,3643,217,108,109
8,37,1021,19,8,11
8,37,1726,4,3,1
8,37,1243,0,0,0
8,37,1103,1,0,1
8,37,1267,11,6,5
8,37,1491,4,2,2
8,37,1382,6,2,4
8,37,1400,10,7,3
8,37,1157,1,1,0
8,37,1101,7,3,4
8,37,1048,46,28,18
8,37,1221,33,21,12
8,37,939,3,1,2
8,37,1295,11,5,6
8,37,1278,29,17,12
8,37,951,53,26,27
8,37,1220,49,24,25
8,37,3076,29,13,16
8,37,813,2,1,1
8,37,1112,3,2,1
8,37,1557,5,3,2
8,37,1198,3,1,2
8,37,958,11,9,2
8,37,1087,11,6,5
8,37,1517,21,9,12
8,37,2406,92,47,45
8,37,2967,25,12,13
8,37,537,12,5,7
8,37,1997,6,3,3
8,37,1365,16,7,9
8,37,1164,13,9,4
8,37,1516,7,6,1
8,37,1709,19,9,10
8,37,1565,12,5,7
8,37,1672,24,12,12
8,37,1312,41,18,23
8,37,1401,26,13,13
8,37,1214,32,11,21
8,37,1193,16,10,6
8,37,1486,26,13,13
8,37,2577,10,4,6
8,37,1211,20,12,8
8,37,1018,16,8,8
8,37,1727,77,44,33
8,37,1293,1,1,0
8,37,1251,3,1,2
8,37,7591,231,125,106
8,37,11204,404,195,209
8,37,1543,5,2,3
8,37,2313,11,9,2
8,37,2193,3,2,1
8,37,1549,9,4,5
8,37,1619,6,3,3
8,37,1389,11,6,5
8,37,1513,3,0,3
8,37,1908,9,6,3
8,37,1626,38,20,18
8,37,535,2,1,1
8,37,1553,3,0,3
8,37,1342,0,0,0
8,37,2307,2,0,2
8,37,2736,29,16,13
8,37,1952,28,11,17
8,37,826,227,109,118
8,37,1391,278,148,130
8,37,944,92,37,55
8,37,1002,265,139,126
8,37,1523,12,3,9
8,37,1395,3,1,2
8,37,1431,8,5,3
8,37,1360,22,9,13
8,37,1178,6,0,6
8,37,1405,26,12,14
8,37,1221,27,14,13
8,37,1385,7,3,4
8,37,3322,17,7,10
8,37,13127,204,93,111
8,37,853,15,10,5
8,37,1263,10,4,6
8,37,3157,56,26,30
8,37,21238,315,150,165
8,37,1043,9,4,5
8,37,1170,0,0,0
8,37,3772,117,68,49
8,37,3249,37,21,16
8,37,1237,7,3,4
8,37,18750,1656,849,807
8,37,997,2,0,2
8,37,14171,125,59,66
8,37,1577,10,5,5
8,37,1227,1,1,0
8,37,2148,11,5,6
8,37,1938,12,2,10
8,37,1489,21,9,12
8,37,3080,26,12,14
8,37,1228,37,23,14
8,37,3235,168,84,84
8,37,2698,16,5,11
8,37,675,15,6,9
8,37,1155,1,0,1
8,37,1173,1,1,0
8,37,609,0,0,0
8,37,553,14,8,6
8,37,559,79,42,37
8,37,855,14,10,4
8,37,1517,13,5,8
8,37,3100,43,20,23
8,37,1379,19,8,11
8,19,6780,104,52,52
8,19,1183,28,12,16
8,19,638,6,3,3
8,19,1246,17,6,11
8,19,6132,171,84,87
8,19,2017,46,10,36
8,19,1172,1,1,0
8,19,952,1,1,0
8,19,940,4,2,2
8,19,1184,71,41,30
8,19,1083,23,8,15
8,19,1229,1,0,1
8,19,1173,4,2,2
8,19,1014,14,8,6
8,19,2625,11,4,7
8,19,1566,5,3,2
8,19,1347,12,7,5
8,19,811,5,3,2
8,19,1274,8,4,4
8,19,633,4,3,1
8,19,1031,20,7,13
8,19,1070,7,4,3
8,19,860,2,0,2
8,19,1236,4,1,3
8,19,1200,24,12,12
8,19,1347,22,12,10
8,19,1372,0,0,0
8,19,1269,0,0,0
8,19,1136,2,1,1
8,19,1123,6,2,4
8,19,1333,11,3,8
8,19,1250,1,0,1
8,19,1140,8,3,5
8,19,1057,49,21,28
8,19,1003,18,7,11
8,19,843,1,1,0
8,19,1145,0,0,0
8,19,781,0,0,0
8,19,1222,6,3,3
8,19,1094,23,9,14
8,19,1192,8,5,3
8,19,1043,4,2,2
8,19,974,0,0,0
8,19,976,0,0,0
8,19,1018,5,2,3
8,19,1016,5,4,1
8,19,1018,7,2,5
8,19,1063,0,0,0
8,19,1148,11,3,8
8,19,1037,7,3,4
8,19,1078,9,6,3
8,19,1166,10,6,4
8,19,1144,8,6,2
8,19,952,2,2,0
8,19,1219,12,8,4
8,19,1218,20,8,12
8,19,1134,19,10,9
8,19,1080,19,9,10
8,19,1125,1,0,1
8,37,831,71,40,31
8,37,831,3,0,3
8,37,661,9,5,4
8,37,1067,3,0,3
8,37,1008,5,1,4
8,37,1159,8,3,5
8,37,1088,24,8,16
8,37,1083,10,6,4
8,37,928,17,5,12
8,37,1187,4,1,3
8,37,947,9,2,7
8,37,729,9,4,5
8,37,1996,22,10,12
8,37,2631,30,16,14
8,37,2224,24,12,12
8,37,2463,23,7,16
8,37,1579,74,39,35
8,37,1008,0,0,0
8,37,646,2,1,1
8,37,844,0,0,0
8,37,663,89,39,50
8,37,4764,23,12,11
8,37,657,56,22,34
8,37,1180,8,3,5
8,37,882,1,0,1
8,37,1101,9,4,5
8,37,3491,43,25,18
8,37,12325,419,212,207
8,37,1910,49,20,29
8,37,700,3,2,1
8,37,729,2,0,2
8,37,933,9,7,2
8,37,594,0,0,0
8,37,947,38,18,20
8,37,3443,117,55,62
8,37,749,38,19,19
8,37,1324,5,0,5
8,37,155,1,1,0
8,37,1288,15,7,8
8,37,375,2,0,2
8,37,522,2,0,2
8,37,1765,4,1,3
8,37,951,5,1,4
8,37,844,9,4,5
8,37,597,0,0,0
8,37,960,11,2,9
8,37,499,4,2,2
8,37,574,14,8,6
8,37,483,1,0,1
8,37,223,3,0,3
8,37,814,1,0,1
8,37,1058,14,7,7
8,37,516,18,8,10
8,37,448,6,3,3
8,37,741,30,17,13
8,37,807,11,5,6
8,37,1289,53,32,21
8,37,344,14,6,8
8,37,220,0,0,0
8,37,1471,10,6,4
8,37,227,5,3,2
8,37,335,4,2,2
8,37,1684,16,8,8
8,37,554,18,11,7
8,37,701,4,2,2
8,37,179,12,7,5
8,37,217,10,5,5
8,37,704,5,4,1
8,37,6533,53,22,31
8,37,470,1,1,0
8,37,1169,21,11,10
8,37,12558,479,226,253
8,37,685,2,0,2
8,37,5101,17,7,10
8,37,1033,3,2,1
8,37,544,6,2,4
8,37,967,4,2,2
8,37,990,3,2,1
8,37,476,2,0,2
8,37,503,1,1,0
8,37,21233,172,82,90
8,37,1047,2,1,1
8,37,90,0,0,0
8,37,1171,0,0,0
8,37,112,0,0,0
8,37,1057,6,3,3
8,37,1245,20,9,11
8,37,1212,4,1,3
8,37,1309,10,5,5
8,37,995,14,4,10
8,37,338,8,7,1
8,37,126,0,0,0
8,37,2223,90,40,50
8,37,515,0,0,0
8,37,778,0,0,0
8,37,3360,20,10,10
8,37,562,0,0,0
8,37,714,0,0,0
8,37,604,11,7,4
8,37,466,2,0,2
8,37,478,7,5,2
8,37,5072,197,99,98
8,37,592,6,3,3
8,37,752,1,1,0
8,37,729,4,2,2
8,37,758,10,6,4
8,37,378,3,1,2
8,37,1673,6,3,3
8,37,687,2,2,0
8,37,534,1,1,0
8,37,528,4,2,2
8,37,946,5,1,4
8,37,889,2,0,2
8,37,1167,15,7,8
8,37,830,24,13,11
8,37,3266,15,6,9
8,37,649,23,13,10
8,37,541,1,0,1
8,37,7977,243,120,123
8,37,644,4,1,3
8,37,611,13,8,5
8,37,455,7,4,3
8,37,888,22,11,11
8,37,912,66,28,38
8,37,1237,2,2,0
8,37,929,24,12,12
8,37,433,2,2,0
8,37,176,0,0,0
8,37,544,14,5,9
8,37,1114,41,21,20
8,37,723,18,8,10
8,37,163,0,0,0
8,37,299,22,10,12
8,37,285,9,3,6
8,37,537,3,3,0
8,37,510,0,0,0
8,37,178,6,3,3
8,37,219,0,0,0
8,37,467,7,3,4
8,37,511,3,2,1
8,37,318,8,2,6
8,37,579,35,14,21
8,37,440,21,14,7
8,37,532,12,8,4
8,37,515,30,16,14
8,37,429,11,5,6
8,37,424,10,6,4
8,37,510,13,8,5
8,37,418,0,0,0
8,37,480,0,0,0
8,37,518,4,3,1
8,37,359,0,0,0
8,37,316,0,0,0
8,37,307,1,0,1
8,37,398,3,2,1
8,37,469,4,3,1
8,37,328,1,0,1
8,37,558,0,0,0
8,37,230,1,1,0
8,37,440,1,1,0
8,37,428,0,0,0
8,37,510,7,1,6
8,37,537,3,0,3
8,37,502,13,6,7
8,37,418,0,0,0
8,37,558,0,0,0
8,37,729,2,2,0
8,37,427,0,0,0
8,37,392,5,2,3
8,37,546,1,1,0
8,37,343,2,1,1
8,37,477,4,3,1
8,37,402,4,2,2
8,37,615,1,0,1
8,37,504,3,2,1
8,37,895,13,9,4
8,37,774,8,5,3
8,37,517,3,1,2
8,37,571,3,1,2
8,37,634,4,2,2
8,37,628,2,1,1
8,37,637,0,0,0
8,37,921,31,14,17
8,37,393,0,0,0
8,37,882,51,24,27
8,37,620,0,0,0
8,37,531,1,0,1
8,37,706,3,3,0
8,37,176,0,0,0
8,37,382,11,3,8
8,37,264,1,0,1
8,37,253,1,1,0
8,37,290,18,9,9
8,37,574,29,17,12
8,37,604,56,28,28
8,37,344,3,1,2
8,37,438,76,41,35
8,37,524,144,70,74
8,37,812,2,0,2
8,37,894,4,2,2
8,37,794,14,8,6
8,37,846,0,0,0
8,37,1088,3,1,2
8,37,1505,10,4,6
8,37,969,2,2,0
8,37,965,15,6,9
8,37,1122,7,4,3
8,37,1300,70,38,32
8,37,1633,6,3,3
8,37,1459,42,21,21
8,37,1533,7,3,4
8,37,1530,10,4,6
8,37,1437,149,74,75
8,37,882,10,3,7
8,37,1121,1,1,0
8,37,1542,15,7,8
8,37,2217,33,16,17
8,37,1568,1,0,1
8,37,242,0,0,0
8,37,834,340,139,201
8,37,767,0,0,0
8,37,783,24,11,13
8,37,878,13,3,10
8,37,262,2,0,2
8,37,337,0,0,0
8,37,929,0,0,0
8,37,585,0,0,0
8,37,1050,7,2,5
8,37,914,2,1,1
8,37,933,12,7,5
8,37,792,2,1,1
8,37,2206,6,2,4
8,37,754,0,0,0
8,37,751,8,1,7
8,37,548,6,3,3
8,37,655,1,1,0
8,37,1354,24,12,12
8,37,797,3,3,0
8,37,487,0,0,0
8,37,885,3,1,2
8,37,66,0,0,0
8,37,2656,32,14,18
8,37,363,1,1,0
8,37,1165,8,3,5
8,37,914,19,10,9
8,37,1202,1,0,1
8,37,1347,15,5,10
8,37,1538,14,8,6
8,37,779,0,0,0
8,37,1313,12,7,5
8,37,2225,196,72,124
8,37,1198,11,6,5
8,37,1421,7,4,3
8,37,1428,3,1,2
8,37,1247,1,1,0
8,37,1152,20,8,12
8,37,1277,21,13,8
8,37,1190,27,15,12
8,37,1164,4,2,2
8,37,1058,3,2,1
8,37,1044,34,20,14
8,37,929,0,0,0
8,37,1148,20,9,11
8,37,1212,38,19,19
8,37,1387,94,40,54
8,37,1429,114,55,59
8,37,1146,2,2,0
8,37,1082,10,5,5
8,37,1334,9,4,5
8,37,1362,8,2,6
8,37,1366,17,9,8
8,37,1399,27,12,15
8,37,1766,210,106,104
8,37,1455,272,132,140
8,19,4773,133,62,71
8,19,3505,20,11,9
8,19,5245,227,112,115
8,19,1463,21,9,12
8,19,959,6,3,3
8,19,1309,28,11,17
8,19,1523,33,19,14
8,19,445,19,9,10
8,19,605,9,4,5
8,19,632,31,18,13
8,19,1094,18,8,10
8,19,906,11,6,5
8,19,494,18,7,11
8,19,668,2,1,1
8,19,769,12,4,8
8,19,1274,18,7,11
8,19,954,52,22,30
8,19,1185,13,5,8
8,19,774,22,10,12
8,19,1976,11,7,4
8,19,419,8,4,4
8,19,1115,0,0,0
8,19,473,5,1,4
8,19,1279,2,1,1
8,19,422,0,0,0
8,19,584,0,0,0
8,19,936,6,4,2
8,19,833,9,5,4
8,19,884,2,1,1
8,19,1526,72,29,43
8,19,1456,7,4,3
8,19,1329,1,0,1
8,19,1038,7,3,4
8,19,814,29,13,16
8,19,1018,74,35,39
8,19,1059,33,19,14
8,19,1208,14,6,8
8,19,2013,10,4,6
8,19,17836,623,307,316
8,19,763,5,4,1
8,19,651,5,2,3
8,2,4033,18,10,8
8,19,531,2,2,0
8,19,1136,5,3,2
8,19,5476,113,59,54
8,19,1083,26,10,16
8,19,2015,17,8,9
8,19,1209,15,5,10
8,19,6281,186,97,89
8,19,470,3,2,1
8,19,860,10,4,6
8,19,1479,10,4,6
8,19,1072,29,14,15
8,19,1073,1,0,1
8,19,1049,4,1,3
8,19,881,11,4,7
8,19,2946,37,22,15
8,19,3836,22,11,11
8,19,1229,7,2,5
8,19,1359,24,14,10
8,19,1281,11,4,7
8,19,1133,8,5,3
8,19,2109,18,8,10
8,19,1229,73,35,38
8,19,1308,4,1,3
8,19,1292,4,3,1
8,19,1815,12,4,8
8,19,1147,25,12,13
8,19,837,12,6,6
8,19,1170,8,6,2
8,19,970,11,9,2
8,19,1101,8,4,4
8,19,1171,9,6,3
8,19,1095,1,1,0
8,19,979,5,2,3
8,19,672,4,2,2
8,19,1195,1,1,0
8,19,1988,104,57,47
8,19,840,17,8,9
8,19,933,25,13,12
8,19,1419,26,11,15
8,19,1489,591,294,297
8,19,1347,46,21,25
8,19,1628,354,164,190
8,19,975,128,67,61
8,19,1456,384,192,192
8,19,1059,8,5,3
8,19,1138,3,1,2
8,19,2308,74,30,44
8,19,4434,24,12,12
8,19,2701,26,15,11
8,19,1261,21,10,11
8,19,3325,10,5,5
8,19,3446,26,15,11
8,19,3791,36,21,15
8,19,2095,99,55,44
8,19,1921,27,17,10
8,19,1891,12,7,5
8,19,2374,9,4,5
8,19,2167,17,5,12
8,19,2086,11,3,8
8,19,2157,6,1,5
8,19,4329,61,32,29
8,19,1918,1,1,0
8,19,1040,1,0,1
8,21,1927,20,8,12
8,21,3147,5,1,4
8,21,3912,113,59,54
8,19,3468,22,12,10
8,19,2911,128,65,63
8,19,1268,17,6,11
8,19,1123,9,5,4
8,19,1028,8,4,4
8,19,3472,95,49,46
8,19,1526,2,0,2
8,19,2240,11,5,6
8,19,753,7,4,3
8,19,3662,31,14,17
8,19,2514,25,18,7
8,19,1895,11,5,6
8,19,3304,133,69,64
8,19,2887,14,6,8
8,19,2043,8,6,2
8,19,4055,28,11,17
8,19,1933,8,2,6
8,19,2318,13,5,8
8,19,1831,15,7,8
8,19,1570,19,12,7
8,19,4825,113,68,45
9,2,872,36,19,17
9,2,1085,26,13,13
9,2,1186,6,1,5
9,2,1139,14,9,5
9,2,1169,34,19,15
9,2,947,16,11,5
9,2,858,3,3,0
9,2,1340,6,1,5
9,2,953,35,18,17
9,2,3905,55,28,27
9,2,700,11,5,6
9,2,699,19,8,11
9,2,959,238,134,104
9,2,763,17,11,6
9,2,785,17,9,8
9,2,1078,32,18,14
9,2,847,41,22,19
9,2,899,4,1,3
9,2,924,5,1,4
9,2,791,1,0,1
9,2,1251,5,0,5
9,2,1079,32,18,14
9,2,778,3,2,1
9,2,819,50,24,26
9,2,719,16,5,11
9,2,811,6,3,3
9,2,952,6,3,3
9,2,5928,103,48,55
9,2,946,34,18,16
9,2,2735,78,41,37
9,2,1017,14,6,8
9,2,869,21,11,10
9,2,771,17,11,6
9,2,685,18,9,9
9,2,823,28,16,12
9,2,934,55,25,30
9,2,724,150,77,73
9,2,716,70,31,39
9,2,1132,69,38,31
9,2,761,41,23,18
9,2,847,17,9,8
9,2,826,34,20,14
9,2,1217,77,38,39
9,2,846,73,43,30
9,2,901,12,4,8
9,2,631,52,28,24
9,2,948,102,54,48
9,2,1319,32,18,14
9,2,949,43,22,21
9,2,1097,25,13,12
9,2,1230,15,8,7
9,2,946,12,7,5
9,2,879,15,6,9
9,2,1220,39,18,21
9,2,1014,19,11,8
9,2,5470,106,66,40
9,2,1312,17,7,10
9,2,1685,82,42,40
9,2,1395,22,10,12
9,2,1553,32,19,13
9,2,1580,21,8,13
9,2,1137,8,5,3
9,2,1149,25,9,16
9,2,1540,51,25,26
9,2,1636,52,28,24
9,2,1411,34,17,17
9,2,1718,12,7,5
9,2,1732,28,13,15
9,2,1498,22,11,11
9,2,2305,14,7,7
9,2,1573,23,13,10
9,2,1767,21,12,9
9,2,1057,1,0,1
9,2,1000,24,13,11
9,2,891,119,57,62
9,2,1480,132,67,65
9,2,1226,18,13,5
9,2,1185,13,10,3
9,2,5295,98,50,48
9,2,1544,14,9,5
9,2,638,4,2,2
9,2,3130,72,41,31
9,2,1381,13,6,7
9,2,2049,29,17,12
9,2,877,18,8,10
9,2,1376,18,8,10
9,2,1512,41,24,17
9,2,1248,27,13,14
9,2,1832,26,11,15
9,2,1501,28,10,18
9,2,1038,18,8,10
9,2,1350,12,9,3
9,2,1028,24,8,16
9,2,1127,3,1,2
9,2,1306,3,1,2
9,2,1850,4,3,1
9,2,2412,8,1,7
9,2,783,2,1,1
9,2,1051,9,6,3
9,2,1242,46,21,25
9,2,1296,7,4,3
9,2,1153,7,4,3
9,2,1677,33,16,17
9,2,1007,22,6,16
9,2,913,12,7,5
9,2,1995,50,27,23
9,2,1528,29,17,12
9,2,1295,5,2,3
9,2,2007,13,9,4
9,2,797,24,13,11
9,2,1453,14,9,5
9,2,611,42,24,18
9,2,693,10,6,4
9,2,580,45,25,20
9,2,688,5,4,1
9,2,770,8,3,5
9,2,631,7,5,2
9,2,626,18,8,10
9,2,1374,4,3,1
9,2,839,2,2,0
9,2,956,13,4,9
9,2,1014,10,6,4
9,2,997,26,12,14
9,2,1077,5,4,1
9,2,2479,83,42,41
9,2,1325,40,19,21
9,2,1200,18,12,6
9,2,1519,40,22,18
9,2,1409,15,7,8
9,2,284,2,1,1
9,2,1059,29,14,15
9,2,935,18,9,9
9,2,1204,37,16,21
9,2,859,34,15,19
9,2,656,11,3,8
9,2,983,12,5,7
9,2,717,7,2,5
9,2,811,29,16,13
9,2,756,8,4,4
9,2,677,7,5,2
9,2,720,21,9,12
9,2,917,13,6,7
9,2,999,29,16,13
9,2,851,37,19,18
9,2,934,22,13,9
9,2,1179,84,48,36
9,2,1012,20,7,13
9,2,1097,1,0,1
9,2,358,1,1,0
9,2,583,2,0,2
9,2,504,20,9,11
9,2,457,5,1,4
9,2,479,10,5,5
9,2,852,11,5,6
9,2,1113,6,2,4
9,2,1082,31,18,13
9,2,653,3,2,1
9,2,528,8,2,6
9,2,1359,63,36,27
9,2,1053,28,16,12
9,2,998,31,19,12
9,2,1117,1,0,1
9,2,947,6,3,3
9,2,1235,1,1,0
9,2,1348,6,1,5
9,2,1169,7,3,4
9,2,1110,47,24,23
9,2,1212,22,11,11
9,2,1348,11,3,8
9,2,1310,7,2,5
9,2,1945,8,4,4
9,2,932,31,16,15
9,2,954,15,7,8
9,2,1033,18,9,9
9,2,2352,39,18,21
9,2,1223,15,6,9
9,2,1230,14,5,9
9,2,548,1,1,0
9,2,1095,9,6,3
9,2,942,24,11,13
9,2,741,11,5,6
9,2,600,0,0,0
9,2,1060,7,3,4
9,2,849,17,9,8
9,2,890,6,2,4
9,2,1397,17,8,9
9,2,3985,131,71,60
9,2,1234,4,2,2
9,2,1892,16,6,10
9,2,1172,6,1,5
9,2,1346,6,2,4
9,2,548,4,3,1
9,2,1747,51,21,30
9,2,1956,44,20,24
9,2,938,8,5,3
9,2,999,24,12,12
9,2,994,4,1,3
9,2,5309,73,29,44
9,2,1621,30,13,17
9,2,1965,14,8,6
9,2,1119,27,12,15
9,2,1408,70,33,37
9,2,1860,5,1,4
9,2,1265,179,99,80
9,2,1410,138,59,79
9,2,1102,20,13,7
9,2,1211,26,8,18
9,2,4393,79,37,42
9,2,861,7,3,4
9,2,1135,7,7,0
9,2,1492,32,20,12
9,2,1084,30,10,20
9,2,1428,45,22,23
9,2,1342,25,13,12
9,2,1218,24,14,10
9,2,1751,12,6,6
9,2,1344,41,19,22
9,2,1816,50,28,22
9,2,2593,11,7,4
9,2,1044,13,5,8
9,2,1537,31,12,19
9,2,1731,16,5,11
9,2,562,21,12,9
9,2,858,10,5,5
9,2,2579,57,26,31
9,2,1256,19,10,9
9,2,1097,27,10,17
9,2,1190,5,2,3
9,2,1330,4,4,0
9,2,1340,2,1,1
9,2,1377,7,3,4
9,2,1051,14,11,3
9,2,1476,23,13,10
9,2,417,4,2,2
9,2,1170,14,5,9
9,2,1568,27,16,11
9,2,2101,26,16,10
9,2,1091,20,8,12
9,2,1330,36,20,16
9,2,1656,32,15,17
9,2,2668,41,19,22
9,2,1461,29,17,12
9,2,1429,62,31,31
9,2,1014,33,18,15
9,2,1183,13,5,8
9,2,3451,53,22,31
9,2,2312,40,17,23
9,2,1768,12,7,5
9,2,1135,36,12,24
9,2,1400,8,4,4
9,2,1140,13,6,7
9,2,1373,24,14,10
9,2,1328,16,7,9
9,2,1340,13,6,7
9,2,1485,5,3,2
9,2,1646,2,2,0
9,2,1612,23,9,14
9,2,1469,37,24,13
9,2,1091,12,5,7
9,2,1204,23,10,13
9,2,1932,15,10,5
9,2,949,9,3,6
9,2,1246,22,11,11
9,2,1154,35,18,17
9,2,1171,29,13,16
9,2,1266,36,19,17
9,2,890,9,4,5
9,2,1120,6,3,3
9,2,1758,39,20,19
9,2,1316,12,5,7
9,2,1247,26,13,13
9,2,1223,42,20,22
9,2,1703,138,76,62
9,2,1311,22,12,10
9,2,1186,10,3,7
9,2,1213,9,5,4
9,2,1223,8,4,4
9,2,954,0,0,0
9,2,1065,3,2,1
9,2,903,3,3,0
9,2,1319,5,1,4
9,2,2514,32,18,14
9,2,1681,24,14,10
9,2,1149,17,11,6
9,2,1519,45,21,24
9,2,988,25,13,12
9,2,1756,7,4,3
9,2,1259,29,17,12
9,2,432,1,0,1
9,2,1020,28,15,13
9,2,553,37,16,21
9,2,973,25,12,13
9,2,957,21,9,12
9,2,445,10,4,6
9,2,436,0,0,0
9,2,363,18,11,7
9,2,503,50,31,19
9,2,456,9,4,5
9,2,718,1,1,0
9,2,3485,120,61,59
9,2,738,12,7,5
9,2,568,4,3,1
9,2,666,2,2,0
9,2,1211,1,0,1
9,2,960,3,3,0
9,2,681,6,2,4
9,2,543,10,4,6
9,2,3486,67,34,33
9,2,564,17,11,6
9,2,852,5,4,1
9,2,707,10,4,6
9,2,847,18,7,11
9,2,1469,39,23,16
9,2,1038,12,6,6
9,2,1113,5,0,5
9,2,931,0,0,0
9,2,881,14,6,8
9,2,1230,12,5,7
9,2,1443,9,3,6
9,2,1340,20,12,8
9,2,924,29,17,12
9,2,944,13,3,10
9,2,1055,28,16,12
9,2,826,2,1,1
9,2,788,2,2,0
9,2,1259,15,10,5
9,2,831,3,1,2
9,2,895,45,22,23
9,2,1089,42,22,20
9,2,935,42,18,24
9,2,945,30,15,15
9,2,900,11,5,6
9,2,981,18,12,6
9,2,1089,10,9,1
9,2,851,24,16,8
9,2,1111,36,18,18
9,2,917,7,3,4
9,2,847,11,2,9
9,2,873,8,4,4
9,2,1103,6,3,3
9,2,1165,48,23,25
9,2,731,28,17,11
9,2,867,16,7,9
9,2,1146,11,4,7
9,3,1587,88,43,45
9,3,391,2,1,1
9,3,2028,23,12,11
9,3,2800,44,22,22
9,3,1090,11,7,4
9,3,1326,9,1,8
9,3,2413,17,8,9
9,3,1585,10,5,5
9,3,1959,5,1,4
9,3,5302,109,52,57
9,3,3271,83,47,36
9,3,2180,19,9,10
9,3,2340,37,18,19
9,3,1479,18,11,7
9,3,989,20,11,9
9,3,1618,30,12,18
9,3,1613,10,6,4
9,3,1516,26,17,9
9,3,2127,21,12,9
9,3,2606,48,24,24
9,3,1987,25,16,9
9,3,2294,21,13,8
9,3,3060,26,11,15
9,3,2369,35,14,21
9,3,1159,29,15,14
9,3,494,2,2,0
9,3,2299,21,10,11
9,3,1514,11,4,7
9,3,1795,6,3,3
9,3,1913,22,13,9
9,3,766,10,3,7
9,3,1783,62,29,33
9,3,1737,51,25,26
9,3,1903,12,4,8
9,3,1552,13,7,6
9,3,1321,16,6,10
9,3,2326,5,2,3
9,3,2460,18,11,7
9,3,1905,389,201,188
9,3,2608,54,31,23
9,3,2254,16,4,12
9,3,1907,12,7,5
9,3,856,32,19,13
9,3,1758,49,24,25
9,3,1308,7,4,3
9,3,2716,39,20,19
9,3,1654,38,20,18
9,3,2492,9,4,5
9,3,2601,6,1,5
9,3,1892,11,3,8
9,3,2065,18,7,11
9,3,952,8,3,5
9,3,2445,100,55,45
9,3,1449,45,26,19
9,3,2115,25,12,13
9,3,1720,19,10,9
9,3,1694,23,14,9
9,3,1966,27,17,10
9,3,1923,39,18,21
9,3,2495,46,21,25
9,3,1082,6,1,5
9,3,2091,22,10,12
9,3,1891,12,5,7
9,3,1120,27,16,11
9,3,2062,13,3,10
9,3,1533,13,7,6
9,3,1826,20,11,9
9,3,1554,12,3,9
9,3,1241,23,13,10
9,3,1388,17,8,9
9,3,1436,11,5,6
9,3,2952,104,53,51
9,3,2548,25,13,12
9,3,2343,20,10,10
9,3,1738,13,6,7
9,3,1629,30,14,16
9,3,1948,11,7,4
9,3,1590,23,11,12
9,3,1245,10,5,5
9,3,1050,11,5,6
9,3,1931,22,9,13
9,3,1071,18,7,11
9,3,1607,40,23,17
9,3,2380,67,38,29
9,3,1683,43,23,20
9,3,2191,12,4,8
9,3,1512,9,6,3
9,3,1693,12,6,6
9,3,1964,26,14,12
9,3,2130,103,57,46
9,3,2015,11,7,4
9,3,2303,52,27,25
9,3,2067,33,14,19
9,3,2089,34,17,17
9,3,2546,23,13,10
9,3,1525,28,18,10
9,3,2612,38,23,15
9,3,1687,20,8,12
9,3,1888,8,5,3
9,3,2586,13,5,8
9,3,1977,11,7,4
9,3,1491,11,6,5
9,3,2084,22,13,9
9,3,1465,41,21,20
9,3,2187,44,18,26
9,3,1419,33,15,18
9,3,1135,11,8,3
9,3,2591,19,9,10
9,3,2491,40,19,21
9,3,1728,11,5,6
9,3,1322,54,28,26
9,3,1805,165,93,72
9,3,1356,19,13,6
9,3,1033,12,8,4
9,3,1084,23,10,13
9,3,1055,44,22,22
9,3,808,30,19,11
9,3,1217,45,24,21
9,3,990,18,13,5
9,3,1042,17,11,6
9,3,1088,101,58,43
9,3,1360,19,7,12
9,3,1053,20,9,11
9,3,1119,7,4,3
9,3,1055,12,7,5
9,3,1463,23,8,15
9,3,4852,40,15,25
9,3,1190,20,12,8
9,3,2059,41,17,24
9,3,1231,2,1,1
9,3,1235,11,7,4
9,3,1891,29,15,14
9,3,1389,38,19,19
9,3,1521,30,17,13
9,3,0,0,0,0
9,3,1212,61,32,29
9,3,807,5,1,4
9,3,2011,50,24,26
9,3,626,3,1,2
9,3,1587,9,2,7
9,3,2350,21,9,12
9,3,1187,40,18,22
9,3,1698,23,14,9
9,3,1636,20,7,13
9,3,1596,8,7,1
9,3,1958,17,8,9
9,3,946,13,5,8
9,3,856,19,11,8
9,3,1659,7,4,3
9,3,1511,6,3,3
9,3,2344,14,7,7
9,3,1078,9,5,4
9,3,1206,5,4,1
9,3,1063,20,13,7
9,3,1678,13,3,10
9,3,1283,20,7,13
9,3,1492,54,27,27
9,3,1309,31,21,10
9,3,1809,10,5,5
9,3,1495,9,8,1
9,3,770,1,0,1
9,3,648,14,8,6
9,3,995,42,24,18
9,3,879,9,5,4
9,3,803,6,3,3
9,3,1839,30,16,14
9,3,853,6,4,2
9,3,619,26,11,15
9,3,930,3,0,3
9,3,1071,10,5,5
9,3,1297,6,3,3
9,3,1374,9,4,5
9,3,776,45,22,23
9,3,647,47,25,22
9,3,1701,64,36,28
9,3,1196,33,15,18
9,3,1232,20,11,9
9,3,891,9,1,8
9,3,1408,10,6,4
9,3,619,6,5,1
9,3,865,57,27,30
9,3,1558,37,19,18
9,3,1176,29,16,13
9,3,1550,20,7,13
9,3,1068,26,15,11
9,3,1632,37,17,20
9,3,1929,51,31,20
9,3,1240,30,15,15
9,3,1243,21,11,10
9,3,1263,25,13,12
9,3,1347,30,18,12
9,3,1947,50,31,19
9,3,1292,31,13,18
9,3,1609,26,15,11
9,3,1754,28,15,13
9,3,1614,38,17,21
9,3,1556,110,53,57
9,3,1029,20,10,10
9,3,1264,12,4,8
9,3,1278,23,12,11
9,3,1411,29,16,13
9,3,2768,38,19,19
9,3,1181,6,1,5
9,3,883,16,11,5
9,3,1011,33,18,15
9,3,989,42,25,17
9,3,1238,11,7,4
9,3,1165,14,6,8
9,3,1676,15,11,4
9,3,987,20,9,11
9,3,812,5,3,2
9,3,2956,29,15,14
9,3,1450,10,7,3
9,3,1868,5,3,2
9,3,1709,14,9,5
9,3,1668,9,4,5
9,3,1282,27,12,15
9,3,1856,43,23,20
9,3,1290,2,1,1
9,3,1308,10,4,6
9,3,668,13,3,10
9,3,864,15,8,7
9,3,1166,15,4,11
9,3,1299,63,35,28
9,3,1401,24,9,15
9,3,1608,5,1,4
9,3,2272,9,7,2
9,3,1415,6,3,3
9,3,2229,37,17,20
9,3,655,1,1,0
9,3,1029,13,5,8
9,3,4722,130,56,74
9,3,1215,30,15,15
9,3,762,6,6,0
9,3,1088,2,1,1
9,3,1284,18,8,10
9,3,1761,39,21,18
9,3,1783,38,19,19
9,3,1811,46,22,24
9,3,973,31,18,13
9,3,1219,13,5,8
9,3,1417,18,8,10
9,3,1852,65,31,34
9,3,780,31,17,14
9,3,1061,14,9,5
9,3,1794,18,11,7
9,3,4835,49,22,27
9,3,1436,17,10,7
9,3,1358,26,7,19
9,3,1458,5,4,1
9,3,1601,27,15,12
9,3,1492,5,3,2
9,3,1693,21,11,10
9,3,1202,10,4,6
9,3,1584,33,14,19
9,3,1472,18,11,7
9,3,1351,19,7,12
9,3,1888,65,33,32
9,3,1617,12,4,8
9,3,1534,14,7,7
9,3,1372,17,9,8
9,3,1730,4,2,2
9,3,1446,11,7,4
9,3,1999,29,17,12
9,3,1756,43,25,18
9,3,1699,26,12,14
9,3,1497,29,13,16
9,3,1212,18,10,8
9,3,519,19,13,6
9,3,1104,31,15,16
9,3,1418,17,9,8
9,3,1625,19,10,9
9,3,935,29,13,16
9,3,2452,110,55,55
9,3,945,23,13,10
9,3,1599,21,13,8
9,3,1352,4,1,3
9,3,1707,18,10,8
9,3,2115,26,15,11
9,3,1410,21,17,4
9,3,822,2,1,1
9,3,1480,16,8,8
9,3,1198,5,2,3
9,3,1255,9,5,4
9,3,1370,15,6,9
9,3,983,11,2,9
9,3,1404,7,5,2
9,3,816,31,15,16
9,3,1124,4,2,2
9,3,1142,9,6,3
9,3,1448,53,32,21
9,3,1433,19,12,7
9,3,2540,21,11,10
9,3,1178,30,14,16
9,3,1332,29,16,13
9,3,1559,5,4,1
9,3,1393,14,6,8
9,3,1075,19,10,9
9,3,1066,15,8,7
9,3,1988,8,4,4
9,3,2417,46,29,17
9,3,2734,60,33,27
9,3,1112,16,8,8
9,3,954,47,27,20
9,3,1020,7,5,2
9,3,1710,65,32,33
9,3,1364,30,17,13
9,3,1633,37,16,21
9,3,1312,87,44,43
9,3,1288,6,3,3
9,3,1199,36,15,21
9,3,1352,33,20,13
9,3,1274,12,6,6
9,3,1335,26,12,14
9,3,1439,29,15,14
9,3,1410,15,6,9
9,3,1508,32,18,14
9,3,1529,12,10,2
9,3,1276,14,7,7
9,3,2892,66,37,29
9,3,2536,72,41,31
9,3,1557,23,10,13
9,3,1452,29,14,15
9,3,1846,10,7,3
9,3,1698,13,10,3
9,3,1426,28,12,16
9,3,2473,50,26,24
9,3,1234,130,62,68
9,3,1414,15,6,9
9,3,1143,15,9,6
9,3,1950,16,6,10
9,3,977,26,11,15
9,3,2133,34,18,16
9,3,2186,111,57,54
9,3,1334,2,2,0
9,3,870,1,0,1
9,3,960,15,9,6
9,3,834,32,16,16
9,3,657,1,1,0
9,3,1044,33,18,15
9,3,941,5,2,3
9,3,1835,46,18,28
9,3,1364,2,2,0
9,3,1939,24,12,12
9,3,1298,15,7,8
9,3,1444,55,30,25
9,3,1171,1,1,0
9,3,970,25,12,13
9,3,218,0,0,0
9,3,1992,21,8,13
9,3,1223,19,12,7
9,3,1712,22,12,10
9,3,895,15,10,5
9,3,987,24,12,12
9,3,1460,65,40,25
9,3,1176,53,25,28
9,3,902,11,6,5
9,3,1113,24,14,10
9,3,410,10,3,7
9,3,1323,141,69,72
9,3,1161,26,8,18
9,3,1113,36,22,14
9,3,1300,33,19,14
9,3,1063,22,14,8
9,3,1290,37,19,18
9,3,1111,16,6,10
9,3,747,10,5,5
9,3,1807,30,21,9
9,3,1936,101,51,50
9,3,1489,78,40,38
9,3,1028,13,8,5
9,3,621,35,20,15
9,3,1525,40,19,21
9,3,1695,45,30,15
9,3,1134,14,5,9
9,3,34,0,0,0
9,3,1736,30,21,9
9,3,871,35,17,18
9,3,1358,17,10,7
9,3,1376,19,12,7
9,3,1099,8,4,4
9,3,1450,11,8,3
9,3,1810,10,5,5
9,3,1475,29,20,9
9,3,720,16,7,9
9,3,773,37,22,15
9,3,1259,19,10,9
9,3,1088,31,18,13
9,3,1117,10,5,5
9,3,1270,47,30,17
9,3,1560,57,30,27
9,3,808,40,26,14
9,3,1516,53,29,24
9,3,959,8,5,3
9,3,828,7,5,2
9,3,682,12,6,6
9,3,1133,56,31,25
9,3,910,19,8,11
9,3,740,40,21,19
9,3,915,21,6,15
9,3,2490,14,12,2
9,3,2128,48,32,16
9,4,4636,46,17,29
9,4,6221,93,60,33
9,4,3390,27,16,11
9,4,3424,28,14,14
9,4,752,6,1,5
9,4,5515,53,34,19
9,4,1369,64,34,30
9,4,2413,19,10,9
9,4,1690,18,11,7
9,4,787,3,0,3
9,4,1799,9,7,2
9,4,3920,57,31,26
9,4,3101,29,17,12
9,4,7841,195,82,113
9,4,1185,3,0,3
9,4,952,9,5,4
9,4,1501,4,0,4
9,4,1455,33,13,20
9,4,3390,30,15,15
9,4,3500,20,9,11
9,4,6167,230,118,112
9,4,1528,8,3,5
9,4,1290,16,9,7
9,4,2634,15,6,9
9,4,1228,6,1,5
9,4,2396,27,12,15
9,4,2234,23,14,9
9,4,11980,160,68,92
9,4,2943,29,11,18
9,4,1277,27,11,16
9,4,1208,10,4,6
9,4,1347,4,1,3
9,4,534,0,0,0
9,4,4999,42,24,18
9,4,2165,21,11,10
9,4,1776,12,7,5
9,4,1758,26,16,10
9,4,1703,16,11,5
9,4,1809,14,7,7
9,4,6799,42,20,22
9,4,3313,64,25,39
9,4,2487,8,1,7
9,4,2431,18,5,13
9,4,2211,44,24,20
9,4,1952,40,22,18
9,4,1583,21,12,9
9,4,2693,71,33,38
9,4,1785,39,23,16
9,4,3943,26,16,10
9,4,2595,17,10,7
9,4,3923,25,13,12
9,4,3444,105,61,44
9,4,3838,99,51,48
9,4,1737,10,6,4
9,4,3153,39,20,19
9,4,4368,87,47,40
9,4,1550,11,6,5
9,4,1429,33,17,16
9,4,7697,51,22,29
9,4,9226,64,36,28
9,4,2219,14,8,6
9,4,2471,11,5,6
9,4,2467,23,7,16
9,4,4430,106,51,55
9,4,2271,9,5,4
9,4,2190,92,46,46
9,4,2385,13,6,7
9,4,4267,165,78,87
9,4,1933,15,6,9
9,4,1934,30,8,22
9,4,808,20,10,10
9,4,685,6,4,2
9,4,989,7,4,3
9,4,738,23,10,13
9,5,3578,10,7,3
9,5,3481,117,63,54
9,5,2761,2,1,1
9,5,3229,10,6,4
9,5,2111,15,9,6
9,5,2112,39,15,24
9,5,5115,120,56,64
9,5,2377,105,54,51
9,5,1860,34,16,18
9,5,2396,20,11,9
9,5,2596,18,9,9
9,5,1943,8,3,5
9,5,4480,16,8,8
9,5,2518,12,8,4
9,5,2258,34,20,14
9,5,1646,20,10,10
9,5,1887,6,2,4
9,5,1691,11,5,6
9,5,2000,22,10,12
9,5,1849,45,24,21
9,5,2639,86,50,36
9,5,3324,57,30,27
9,5,2479,26,14,12
9,5,1921,5,4,1
9,5,1537,52,33,19
9,5,1837,44,19,25
9,5,1547,3,1,2
9,5,2173,18,7,11
9,5,2506,4,1,3
9,5,2223,42,22,20
9,5,1754,4,2,2
9,5,6811,88,40,48
9,5,1746,28,15,13
9,5,2013,25,12,13
9,5,1539,10,5,5
9,5,2215,23,11,12
9,5,1819,5,3,2
9,5,1674,8,4,4
9,5,3501,9,6,3
9,5,3086,3,2,1
9,5,1701,21,11,10
9,5,832,0,0,0
9,5,1652,12,7,5
9,5,1696,3,1,2
9,5,8771,164,82,82
9,5,1753,4,2,2
9,5,1733,14,7,7
9,5,1750,6,3,3
9,5,1358,5,2,3
9,5,9759,14,7,7
9,5,2009,10,6,4
9,5,1538,7,4,3
9,5,1470,32,13,19
9,5,1953,54,24,30
9,5,2326,91,48,43
9,5,4109,42,21,21
9,5,3899,46,22,24
9,5,2391,14,8,6
9,5,2181,15,7,8
9,5,2017,10,6,4
9,5,2633,42,19,23
9,5,2143,67,29,38
9,5,2289,11,5,6
9,5,1656,24,13,11
9,5,1447,9,5,4
9,5,1473,49,24,25
9,5,2192,2,0,2
9,5,1906,16,6,10
9,5,1406,23,13,10
9,5,1718,40,22,18
9,5,2089,76,48,28
9,5,1779,26,13,13
9,5,2293,36,14,22
9,5,2553,48,23,25
9,5,4105,39,22,17
9,5,2782,14,6,8
9,5,1811,3,1,2
9,5,1781,9,5,4
9,5,1628,18,6,12
9,5,1976,8,2,6
9,5,1631,54,29,25
9,5,1507,40,18,22
9,5,1602,45,22,23
9,5,1743,6,5,1
9,5,2045,11,6,5
9,5,2300,8,7,1
9,5,1346,8,3,5
9,5,1697,8,5,3
9,5,2970,13,6,7
9,5,2831,30,17,13
9,5,1851,80,41,39
9,5,1925,30,17,13
9,5,1706,5,2,3
9,5,1626,33,17,16
9,5,1738,39,14,25
9,5,1403,23,10,13
9,5,1608,9,3,6
9,5,1549,395,197,198
9,5,1314,331,170,161
9,5,1531,13,7,6
9,5,1279,153,77,76
9,5,1565,21,10,11
9,5,2017,29,18,11
9,5,1880,30,13,17
9,5,1038,29,13,16
9,5,1838,18,9,9
9,5,1938,30,15,15
9,5,3145,29,13,16
9,5,1363,56,27,29
9,5,1106,14,4,10
9,5,1500,21,10,11
9,5,1387,78,40,38
9,5,2866,114,53,61
9,5,872,34,13,21
9,5,1189,23,13,10
9,5,1103,0,0,0
9,5,1423,30,11,19
9,5,1266,19,8,11
9,5,1720,22,8,14
9,5,1565,375,181,194
9,5,1603,128,73,55
9,5,931,7,3,4
9,5,1418,9,5,4
9,5,1554,21,8,13
9,5,1041,8,5,3
9,5,1208,4,2,2
9,5,2091,15,9,6
9,5,1302,24,10,14
9,5,1370,2,2,0
9,5,1062,55,25,30
9,5,1067,19,8,11
9,5,885,26,12,14
9,5,1591,8,0,8
9,5,2878,41,20,21
9,5,1639,5,1,4
9,5,1043,8,8,0
9,5,1170,2,1,1
9,5,1173,10,4,6
9,5,1042,11,5,6
9,5,726,17,9,8
9,5,882,11,7,4
9,5,914,12,5,7
9,5,938,9,6,3
9,5,820,11,7,4
9,5,673,33,15,18
9,5,1837,14,6,8
9,5,1704,19,12,7
9,5,1627,70,31,39
9,5,1813,9,4,5
9,5,1762,24,12,12
9,5,1904,9,4,5
9,5,1489,5,3,2
9,5,1101,40,19,21
9,5,1414,12,6,6
9,5,1657,40,19,21
9,5,2123,6,1,5
9,5,1190,16,6,10
9,5,771,25,14,11
9,5,635,61,25,36
9,5,1010,42,20,22
9,5,724,18,9,9
9,5,1218,21,12,9
9,5,824,0,0,0
9,5,821,24,10,14
9,5,769,5,2,3
9,5,891,3,2,1
9,5,9179,320,160,160
9,5,606,46,29,17
9,5,853,10,6,4
9,5,918,7,1,6
9,5,906,21,14,7
9,5,603,65,33,32
9,5,760,140,76,64
9,5,1047,49,23,26
9,5,1204,69,36,33
9,5,1269,23,8,15
9,5,544,10,8,2
9,5,1746,11,4,7
9,5,1359,11,3,8
9,5,1431,80,36,44
9,5,1244,37,21,16
9,5,2816,58,31,27
9,5,1300,25,9,16
9,5,1363,16,7,9
9,5,882,19,6,13
9,5,948,36,20,16
9,5,705,11,5,6
9,5,1152,11,5,6
9,5,1155,5,3,2
9,5,859,11,6,5
9,5,810,7,2,5
9,5,548,13,7,6
9,5,849,9,6,3
9,5,1384,4,2,2
9,5,1130,10,5,5
9,5,1161,7,3,4
9,5,982,5,4,1
9,5,627,4,2,2
9,5,928,9,6,3
9,5,985,3,1,2
9,5,777,52,31,21
9,5,775,26,11,15
9,5,990,2,1,1
9,5,836,13,5,8
9,5,940,11,7,4
9,5,1505,16,6,10
9,5,1166,30,11,19
9,5,5982,154,70,84
9,5,1335,20,13,7
9,5,870,20,11,9
9,5,933,8,3,5
9,5,755,10,8,2
9,5,1412,36,15,21
9,5,1788,19,5,14
9,5,359,10,8,2
9,5,1080,27,13,14
9,5,906,28,14,14
9,5,1764,54,24,30
9,5,1534,20,6,14
9,5,173,6,4,2
9,5,1579,49,26,23
9,5,1071,17,7,10
9,5,1067,6,3,3
9,5,953,2,1,1
9,5,1516,10,8,2
9,5,964,13,6,7
9,5,1275,26,12,14
9,5,977,3,0,3
9,5,1287,20,11,9
9,5,2945,101,50,51
9,5,1256,8,2,6
9,5,1108,2,1,1
9,5,812,5,3,2
9,5,930,12,6,6
9,5,1329,8,4,4
9,5,1816,2,1,1
9,5,650,15,9,6
9,5,834,24,14,10
9,5,968,5,3,2
9,5,999,7,3,4
9,5,1259,226,117,109
9,5,1714,15,8,7
9,5,988,15,10,5
9,5,1418,12,5,7
9,5,1421,13,7,6
9,5,809,27,21,6
9,5,1049,17,8,9
9,5,993,33,16,17
9,5,950,14,6,8
9,5,1574,12,5,7
9,5,676,71,41,30
9,5,327,10,4,6
9,5,639,34,15,19
9,5,991,42,19,23
9,5,711,7,1,6
9,5,787,30,16,14
9,5,1851,17,10,7
9,5,703,52,26,26
9,5,691,4,1,3
9,5,855,24,12,12
9,5,614,9,5,4
9,5,558,11,5,6
9,5,812,26,13,13
9,5,856,23,12,11
9,5,1324,27,17,10
9,5,1058,47,27,20
9,5,1023,16,7,9
9,5,792,13,8,5
9,5,807,16,8,8
9,5,873,14,7,7
9,5,961,18,10,8
9,5,1008,9,3,6
9,5,995,10,3,7
9,5,888,15,9,6
9,5,900,3,3,0
9,5,753,19,10,9
9,5,794,29,14,15
9,5,1083,33,20,13
9,5,875,8,2,6
9,5,926,73,41,32
9,5,830,40,22,18
9,5,673,1,0,1
9,5,919,8,6,2
9,5,680,3,1,2
9,5,958,7,2,5
9,5,1119,8,4,4
9,5,929,5,1,4
9,5,863,22,6,16
9,5,877,14,9,5
9,5,821,8,4,4
9,5,686,9,6,3
9,5,946,37,20,17
9,5,788,12,6,6
9,5,1032,18,7,11
9,5,760,16,7,9
9,5,686,2,1,1
9,5,831,5,3,2
9,5,1472,21,9,12
9,5,996,1,1,0
9,5,812,5,2,3
9,5,793,5,2,3
9,5,901,4,0,4
9,5,732,19,11,8
9,5,768,21,10,11
9,5,1013,12,5,7
9,5,1035,5,4,1
9,5,902,19,7,12
9,5,900,8,7,1
9,5,798,16,8,8
9,5,716,2,1,1
9,5,1350,27,15,12
9,5,847,37,21,16
9,5,991,8,5,3
9,5,1358,90,48,42
9,5,1113,5,5,0
9,5,1715,13,5,8
9,5,1382,30,20,10
9,5,1020,8,3,5
9,5,682,2,0,2
9,5,785,10,4,6
9,5,1281,3,1,2
9,5,1161,5,3,2
9,5,1052,31,13,18
9,5,1250,7,1,6
9,5,1736,37,21,16
9,5,1052,33,15,18
9,5,1091,35,13,22
9,5,1035,22,8,14
9,5,974,11,5,6
9,5,1072,7,3,4
9,5,1130,5,1,4
9,5,1061,21,12,9
9,5,1081,37,19,18
9,5,1101,17,10,7
9,5,1072,87,38,49
9,5,1094,65,30,35
9,5,1005,5,2,3
9,5,991,3,0,3
9,5,1037,3,1,2
9,5,1091,13,5,8
9,5,1109,20,8,12
9,5,1169,31,17,14
9,5,990,10,5,5
9,5,4062,95,46,49
9,5,1159,24,11,13
9,5,1014,18,7,11
9,5,872,53,29,24
9,5,1531,43,24,19
9,5,1152,11,2,9
9,5,1274,11,4,7
9,5,1071,3,1,2
9,5,863,8,7,1
9,5,950,22,8,14
9,5,1111,37,20,17
9,5,831,12,6,6
9,5,966,48,25,23
9,5,1079,28,13,15
9,5,1139,34,19,15
9,5,1216,23,10,13
9,5,966,17,11,6
9,5,1234,11,9,2
9,5,1026,10,3,7
9,5,1143,35,15,20
9,5,1353,22,9,13
9,5,1132,7,4,3
9,5,1014,3,0,3
9,5,1011,13,3,10
9,5,967,14,4,10
9,5,1082,28,13,15
9,5,925,17,9,8
9,5,942,10,3,7
9,5,741,8,2,6
9,5,639,0,0,0
9,5,901,2,0,2
9,5,1059,10,7,3
9,5,833,3,1,2
9,5,965,24,14,10
9,5,1246,13,5,8
9,5,1093,19,11,8
9,5,1045,76,39,37
9,5,1383,21,10,11
9,5,1071,22,9,13
9,5,1094,15,9,6
9,5,1234,24,10,14
9,5,1090,19,6,13
9,5,866,27,15,12
9,5,865,48,24,24
9,5,877,80,35,45
9,5,1038,32,17,15
9,5,1396,8,4,4
9,5,944,8,2,6
9,5,1250,28,14,14
9,5,974,51,26,25
9,5,1839,28,19,9
9,5,1178,42,21,21
9,5,1399,19,7,12
9,5,1672,20,11,9
9,5,2415,5,2,3
9,5,970,26,10,16
9,5,922,6,3,3
9,5,1058,43,18,25
9,5,1044,27,18,9
9,5,1135,44,22,22
9,5,906,15,9,6
9,5,849,7,2,5
9,5,1327,25,15,10
9,5,1067,30,18,12
9,5,1024,16,6,10
9,5,1295,24,12,12
9,5,1215,11,5,6
9,5,1330,29,15,14
9,5,1008,3,0,3
9,5,1299,11,5,6
9,5,1122,6,3,3
9,5,1118,54,28,26
9,5,1258,24,13,11
9,5,1545,25,13,12
9,5,1328,69,42,27
9,5,1006,11,5,6
9,5,989,32,18,14
9,5,866,31,19,12
9,5,894,54,27,27
9,5,1125,21,12,9
9,5,1900,12,9,3
9,5,991,9,3,6
9,5,1677,24,12,12
9,5,925,13,6,7
9,5,1503,6,2,4
9,5,1643,35,16,19
9,5,1138,22,9,13
9,5,1198,46,25,21
9,5,1126,17,10,7
9,5,1333,5,3,2
9,5,651,15,6,9
9,5,1002,11,4,7
9,5,638,0,0,0
9,5,808,20,6,14
9,5,908,3,0,3
9,5,916,2,0,2
9,5,939,2,1,1
9,5,892,10,2,8
9,5,1057,23,12,11
9,5,850,20,12,8
9,5,1135,180,97,83
9,5,1365,41,16,25
9,5,1909,16,7,9
9,5,1748,9,4,5
9,5,1375,1,0,1
9,5,1961,11,7,4
9,5,1850,12,8,4
9,5,1390,16,8,8
9,5,1283,2,2,0
9,5,1229,4,1,3
9,5,1344,21,10,11
9,5,1379,25,14,11
9,5,1257,7,2,5
9,5,1993,5,4,1
9,5,1457,1,0,1
9,5,1154,36,15,21
9,5,984,7,3,4
9,5,1065,2,2,0
9,5,1625,19,10,9
9,5,1624,29,18,11
9,5,811,6,1,5
9,5,1250,18,9,9
9,5,984,6,4,2
9,5,1736,10,5,5
9,5,1160,2,0,2
9,5,1890,24,13,11
9,5,941,15,7,8
9,5,793,7,5,2
9,5,892,13,8,5
9,5,1419,28,17,11
9,5,1035,2,1,1
9,5,1299,9,8,1
9,5,2409,45,19,26
9,5,951,46,27,19
9,5,999,8,3,5
9,5,1258,56,39,17
9,5,1094,56,27,29
9,5,909,23,13,10
9,5,1242,34,20,14
9,5,443,5,2,3
9,5,688,10,5,5
9,5,2032,6,3,3
9,5,1273,16,7,9
9,5,1586,14,5,9
9,5,1062,7,5,2
9,5,1373,10,7,3
9,5,1288,8,3,5
9,5,1412,32,17,15
9,5,1155,19,7,12
9,5,2046,11,5,6
9,5,1296,22,13,9
9,5,1059,7,6,1
9,5,1821,25,14,11
9,5,1309,36,19,17
9,5,1071,2,1,1
9,5,1348,5,3,2
9,5,1178,24,4,20
9,5,1148,2,0,2
9,5,1155,0,0,0
9,5,1789,95,51,44
9,5,940,52,26,26
9,5,849,5,5,0
9,5,846,10,5,5
9,5,1043,14,8,6
9,5,810,4,1,3
9,5,869,2,0,2
9,5,1214,1,1,0
9,5,1290,79,41,38
9,5,1051,10,4,6
9,5,1237,13,4,9
9,5,1141,26,12,14
9,5,1048,11,4,7
9,5,1705,37,18,19
9,5,1056,24,13,11
9,5,1627,4,2,2
9,5,1261,19,10,9
9,5,1584,30,14,16
9,5,1147,25,12,13
9,5,1322,10,3,7
9,5,1618,27,12,15
9,5,1248,14,8,6
9,5,1118,7,3,4
9,5,1432,19,11,8
9,5,1116,24,12,12
9,5,1608,13,2,11
9,5,860,7,3,4
9,5,997,10,5,5
9,5,1221,27,12,15
9,5,977,6,1,5
9,5,979,16,7,9
9,5,888,7,3,4
9,5,1248,0,0,0
9,5,1011,2,1,1
9,5,849,4,1,3
9,5,1114,15,5,10
9,5,1142,3,2,1
9,5,1136,12,6,6
9,5,1386,23,10,13
9,5,1414,3,1,2
9,5,1210,20,10,10
9,5,1238,0,0,0
9,5,1224,3,2,1
9,5,1136,3,1,2
9,5,1463,23,13,10
9,5,1085,2,2,0
9,5,1452,5,3,2
9,5,1213,10,2,8
9,5,1626,2,1,1
9,5,1050,9,6,3
9,5,1621,14,5,9
9,5,1176,19,10,9
9,5,1447,17,11,6
9,5,1230,36,17,19
9,5,1569,25,15,10
9,5,904,795,444,351
9,5,1182,25,10,15
9,5,1246,56,28,28
9,5,1834,7,3,4
9,5,956,0,0,0
9,5,1620,16,8,8
9,5,1044,21,13,8
9,5,4028,34,22,12
9,5,1135,6,1,5
9,5,1372,7,2,5
9,5,1157,30,12,18
9,5,1126,8,2,6
9,5,1186,9,3,6
9,5,1327,19,8,11
9,5,1253,17,8,9
9,5,1139,23,11,12
9,5,1333,6,2,4
9,5,1450,24,10,14
9,5,1121,10,7,3
9,5,1179,9,4,5
9,5,1140,19,11,8
9,5,1348,26,17,9
9,5,1174,4,0,4
9,5,1697,8,4,4
9,5,1416,7,1,6
9,5,1299,15,9,6
9,5,1332,9,6,3
9,5,1215,5,4,1
9,5,1414,48,21,27
9,5,1192,9,4,5
9,5,1051,5,4,1
9,5,1246,25,12,13
9,5,1396,49,27,22
9,5,1508,47,23,24
9,5,1071,3,1,2
9,5,1356,18,9,9
9,5,1117,3,2,1
9,5,1125,12,4,8
9,5,1136,19,10,9
9,5,981,3,1,2
9,5,1256,13,5,8
9,5,1153,12,6,6
9,5,1242,16,7,9
9,5,1384,8,5,3
9,5,1197,17,9,8
9,5,1455,19,13,6
9,5,959,6,2,4
9,5,1492,5,2,3
9,5,1130,3,2,1
9,5,1158,3,3,0
9,5,1130,16,10,6
9,5,1285,2,0,2
9,5,1518,15,8,7
9,5,1734,15,7,8
9,5,1361,9,4,5
9,5,1348,13,7,6
9,5,1518,13,7,6
9,5,1605,20,11,9
9,5,913,4,2,2
9,5,1277,9,7,2
9,5,1053,13,7,6
9,5,993,145,81,64
9,5,2712,21,10,11
9,5,1311,16,9,7
9,5,1433,22,6,16
9,5,1775,17,7,10
9,5,1403,20,12,8
9,5,1090,7,2,5
9,5,1369,8,1,7
9,5,759,16,4,12
9,5,1079,3,2,1
9,5,1131,13,7,6
9,5,763,11,5,6
9,5,1226,12,3,9
9,5,694,16,8,8
9,5,727,3,3,0
9,5,811,35,17,18
9,5,862,8,2,6
9,5,949,8,3,5
9,5,820,30,15,15
9,5,1132,27,15,12
9,5,782,16,7,9
9,5,875,65,37,28
9,5,624,33,17,16
9,5,883,56,24,32
9,5,1161,84,44,40
9,5,822,33,15,18
9,5,948,8,5,3
9,5,934,37,23,14
9,5,809,6,3,3
9,5,787,22,12,10
9,5,1307,167,89,78
9,5,945,37,22,15
9,5,1426,13,11,2
9,5,1056,30,17,13
9,5,884,27,15,12
9,5,1211,50,25,25
9,5,1048,69,36,33
9,5,988,38,19,19
9,5,1378,26,13,13
9,5,890,8,5,3
9,5,936,34,18,16
9,5,510,15,8,7
9,5,1122,3,0,3
9,5,1005,6,2,4
9,5,3516,142,74,68
9,5,1371,36,25,11
9,5,1125,53,28,25
9,5,830,14,8,6
9,5,1086,46,20,26
9,5,561,9,6,3
9,5,781,17,7,10
9,5,1040,27,17,10
9,5,1376,36,21,15
9,5,1681,96,52,44
9,5,1093,49,25,24
9,5,1454,42,20,22
9,5,457,6,4,2
9,5,1492,23,10,13
9,5,1235,13,6,7
9,5,1183,4,0,4
9,5,1655,3,1,2
9,5,1615,11,8,3
9,5,603,4,1,3
9,5,1335,47,27,20
9,5,999,28,16,12
9,5,1487,2,1,1
9,5,1121,5,1,4
9,5,847,10,4,6
9,5,1128,79,42,37
9,5,1477,28,13,15
9,5,936,14,6,8
9,5,819,15,6,9
9,5,1229,26,13,13
9,5,1344,59,31,28
9,5,1263,10,3,7
9,5,1399,7,3,4
9,5,1333,21,11,10
9,5,1247,3,1,2
9,5,1032,9,5,4
9,5,1332,10,6,4
9,5,1340,70,30,40
9,5,1138,6,1,5
9,5,1326,61,32,29
9,5,1342,16,10,6
9,5,1317,3,2,1
9,5,911,12,5,7
9,5,1279,9,4,5
9,5,992,8,2,6
9,5,1046,19,10,9
9,5,1029,31,13,18
9,5,1305,9,5,4
9,5,1096,0,0,0
9,5,1122,17,10,7
9,5,1192,36,14,22
9,5,1039,9,4,5
9,5,1459,5,1,4
9,5,865,12,7,5
9,5,1167,19,13,6
9,5,10998,256,120,136
9,5,817,73,37,36
9,5,1095,10,5,5
9,5,1166,7,2,5
9,5,1025,16,5,11
9,5,1078,9,6,3
9,5,1023,19,8,11
9,5,1254,21,11,10
9,5,1831,33,20,13
9,5,7880,244,120,124
9,5,1107,26,14,12
9,5,949,5,2,3
9,5,1031,45,24,21
9,5,989,7,4,3
9,5,809,13,7,6
9,5,4309,50,29,21
9,5,1392,57,32,25
9,5,789,23,17,6
9,5,1092,54,23,31
9,5,1209,92,51,41
9,5,1008,15,9,6
9,5,868,35,16,19
9,5,1100,18,10,8
9,5,1265,19,14,5
9,5,1057,1,1,0
9,5,1062,13,4,9
9,5,1072,22,12,10
9,5,1350,10,4,6
9,5,1238,11,7,4
9,5,8855,99,51,48
9,5,982,11,7,4
9,5,1200,36,19,17
9,5,2825,40,21,19
9,5,1342,11,5,6
9,5,1001,0,0,0
9,5,1001,2,0,2
9,5,1213,3,1,2
9,5,1895,49,27,22
9,5,1380,24,12,12
9,5,1410,5,2,3
9,5,2408,42,17,25
9,5,1551,16,7,9
9,5,902,1,0,1
9,5,2981,52,31,21
9,5,1566,11,7,4
9,5,1611,12,7,5
9,5,2321,40,24,16
9,5,4695,224,115,109
9,5,852,14,7,7
9,5,929,26,12,14
9,5,871,19,10,9
9,5,1004,17,10,7
9,5,1337,13,8,5
9,5,737,1,1,0
9,5,1413,24,9,15
9,5,1330,40,23,17
9,5,939,7,5,2
9,5,902,4,0,4
9,5,1174,5,3,2
9,5,1347,6,5,1
9,5,1224,31,14,17
9,5,1157,14,10,4
9,5,941,11,3,8
9,5,980,0,0,0
9,5,935,0,0,0
9,5,1633,14,9,5
9,5,956,21,13,8
9,5,1408,15,7,8
9,5,1406,22,9,13
9,5,1216,16,7,9
9,5,992,16,9,7
9,5,1324,11,5,6
9,5,1350,19,8,11
9,5,1456,7,2,5
9,5,1385,17,9,8
9,5,1414,42,24,18
9,5,1181,14,5,9
9,5,1450,18,8,10
9,5,1436,22,14,8
9,5,1040,25,17,8
9,5,775,31,16,15
9,5,1287,46,19,27
9,5,1383,31,21,10
9,5,1005,11,3,8
9,5,1365,4,2,2
9,5,1178,37,20,17
9,5,1301,5,2,3
9,5,1167,4,2,2
9,5,1324,16,9,7
9,5,1374,16,6,10
9,5,1256,17,7,10
9,5,1194,16,11,5
9,5,1233,15,7,8
9,5,1032,3,2,1
9,5,1352,7,4,3
9,5,1423,7,6,1
9,5,1225,6,4,2
9,5,1011,4,2,2
9,5,1385,4,1,3
9,5,1219,6,3,3
9,5,1545,29,16,13
9,5,1189,20,11,9
9,5,1022,10,6,4
9,5,1075,15,10,5
9,5,1453,6,3,3
9,5,898,14,9,5
9,5,1255,4,1,3
9,5,1285,29,18,11
9,5,794,2,1,1
9,5,838,6,2,4
9,5,1108,16,6,10
9,5,1004,22,16,6
9,5,1150,43,19,24
9,5,941,1,0,1
9,5,1461,13,6,7
9,5,1521,21,11,10
9,5,1103,10,6,4
9,5,1397,5,2,3
9,5,1263,18,10,8
9,5,1319,8,1,7
9,5,1395,4,2,2
9,5,990,5,2,3
9,5,1185,1,1,0
9,5,1073,3,2,1
9,5,1189,4,1,3
9,5,1067,4,2,2
9,5,999,3,2,1
9,5,745,1,0,1
9,5,754,61,33,28
9,5,997,55,25,30
9,5,1223,26,12,14
9,5,795,13,5,8
9,5,880,6,2,4
9,5,698,2,1,1
9,5,813,7,5,2
9,6,938,12,7,5
9,6,1646,31,19,12
9,6,669,4,3,1
9,6,1896,41,24,17
9,6,1095,12,6,6
9,6,877,2,1,1
9,6,1596,21,8,13
9,6,974,1,1,0
9,6,1358,26,14,12
9,6,1400,42,24,18
9,6,1354,12,6,6
9,6,1454,15,6,9
9,6,843,13,6,7
9,6,662,4,1,3
9,6,776,28,10,18
9,6,1298,12,8,4
9,6,1859,6,5,1
9,6,702,3,1,2
9,6,1190,14,4,10
9,6,1308,10,7,3
9,6,1307,27,15,12
9,6,1064,2,0,2
9,6,1038,12,7,5
9,6,559,2,1,1
9,6,2825,102,49,53
9,6,1413,11,7,4
9,6,2906,79,40,39
9,6,1800,39,22,17
9,6,395,7,1,6
9,6,1787,21,11,10
9,6,1431,25,11,14
9,6,1290,29,16,13
9,6,1185,32,19,13
9,6,1175,12,4,8
9,6,981,5,3,2
9,6,1078,3,1,2
9,6,1269,11,5,6
9,6,1128,16,12,4
9,6,1166,5,3,2
9,6,1068,7,5,2
9,6,1017,16,9,7
9,6,1009,17,10,7
9,6,1076,22,8,14
9,6,892,29,12,17
9,6,1145,105,50,55
9,6,1163,7,4,3
9,6,1146,17,5,12
9,6,1129,4,2,2
9,6,1415,5,3,2
9,6,1108,20,12,8
9,6,1129,10,6,4
9,6,1384,3,2,1
9,6,1144,6,1,5
9,6,1364,37,21,16
9,6,1357,25,14,11
9,6,1237,7,3,4
9,6,1358,25,14,11
9,6,1582,105,58,47
9,6,1913,65,32,33
9,6,1789,33,17,16
9,6,1207,6,2,4
9,6,1312,52,26,26
9,6,1917,11,8,3
9,6,1085,94,47,47
9,6,1336,9,6,3
9,6,1562,33,19,14
9,6,1071,2,1,1
9,6,886,2,1,1
9,6,1513,42,21,21
9,6,1060,17,8,9
9,6,1340,4,1,3
9,6,1461,14,3,11
9,6,1305,21,10,11
9,6,1019,13,4,9
9,6,1091,44,20,24
9,6,1068,4,1,3
9,6,1338,12,4,8
9,6,1295,17,9,8
9,6,1047,26,15,11
9,6,930,19,9,10
9,6,1390,7,2,5
9,6,1457,13,6,7
9,6,1876,16,10,6
9,6,1436,21,12,9
9,6,1112,23,12,11
9,6,1190,14,8,6
9,6,1147,30,14,16
9,6,889,2,0,2
9,6,269,1,0,1
9,6,996,39,18,21
9,6,2157,52,31,21
9,6,1280,7,5,2
9,6,1367,9,4,5
9,6,1189,42,22,20
9,6,1247,11,6,5
9,6,1260,13,8,5
9,6,1841,17,8,9
9,6,1410,13,7,6
9,6,2038,25,12,13
9,6,1905,37,20,17
9,6,1980,69,38,31
9,6,1032,30,17,13
9,6,1111,45,29,16
9,6,695,14,9,5
9,6,1528,11,3,8
9,6,963,10,4,6
9,6,939,44,19,25
9,6,1395,170,92,78
9,6,2021,46,23,23
9,6,2012,22,13,9
9,6,1550,0,0,0
9,6,1887,30,16,14
9,6,1810,60,31,29
9,6,1004,23,11,12
9,6,1223,9,6,3
9,6,1144,8,3,5
9,6,937,12,8,4
9,6,1180,13,9,4
9,6,1015,4,1,3
9,6,1326,1,1,0
9,6,1062,1,1,0
9,6,1509,8,4,4
9,6,1700,16,9,7
9,6,1176,81,32,49
9,6,1791,13,5,8
9,6,1671,9,2,7
9,6,1625,16,7,9
9,6,1016,3,2,1
9,6,982,3,3,0
9,6,1027,7,3,4
9,6,1102,12,9,3
9,6,1185,17,9,8
9,6,1058,22,11,11
9,6,1005,8,5,3
9,6,1439,18,6,12
9,6,1462,61,34,27
9,6,1748,7,6,1
9,6,1702,48,21,27
9,6,2064,6,3,3
9,6,2316,24,12,12
9,6,3038,43,22,21
9,6,1288,44,18,26
9,6,909,5,2,3
9,6,1213,83,45,38
9,6,646,43,24,19
9,6,762,8,4,4
9,6,262,0,0,0
9,6,1180,6,3,3
9,6,1098,9,4,5
9,6,948,10,5,5
9,6,932,13,6,7
9,6,1089,34,18,16
9,6,968,19,12,7
9,6,709,14,10,4
9,6,1086,38,21,17
9,6,893,15,8,7
9,6,550,0,0,0
9,6,486,3,0,3
9,6,1349,18,10,8
9,6,3336,14,7,7
9,6,5595,53,22,31
9,6,1497,6,4,2
9,6,1168,18,7,11
9,6,1654,44,21,23
9,6,1220,17,7,10
9,6,2773,37,16,21
9,6,2301,67,31,36
9,6,1503,8,3,5
9,6,1149,5,1,4
9,6,1003,6,3,3
9,6,1243,1,1,0
9,6,855,7,3,4
9,6,994,8,3,5
9,6,1287,16,9,7
9,6,1007,18,7,11
9,6,1866,51,25,26
9,6,862,7,2,5
9,6,1300,15,8,7
9,6,1268,23,11,12
9,6,1404,28,19,9
9,6,1007,52,29,23
9,6,1073,10,6,4
9,6,900,5,2,3
9,6,1270,15,5,10
9,6,1029,14,6,8
9,6,1188,20,10,10
9,6,1234,4,1,3
9,6,1227,5,4,1
9,6,1008,8,5,3
9,6,1391,43,20,23
9,6,1536,116,63,53
9,6,919,14,6,8
9,6,916,28,14,14
9,6,897,11,5,6
9,6,824,13,8,5
9,6,1272,21,10,11
9,6,1238,37,19,18
9,6,1434,28,14,14
9,6,1792,50,30,20
9,6,1447,11,7,4
9,6,2536,101,54,47
9,6,1086,1,1,0
9,6,1222,12,8,4
9,6,1485,39,18,21
9,6,1438,27,17,10
9,6,1015,3,1,2
9,6,1330,23,9,14
9,6,1397,9,3,6
9,6,1183,6,4,2
9,6,1173,13,6,7
9,6,986,13,9,4
9,6,1378,12,5,7
9,6,1077,4,1,3
9,6,1054,5,2,3
9,6,527,18,12,6
9,6,1008,36,16,20
9,6,1040,18,6,12
9,6,1301,121,60,61
9,6,1535,7,5,2
9,6,1562,21,8,13
9,6,1282,8,4,4
9,6,1456,8,3,5
9,6,1181,17,8,9
9,6,1202,25,13,12
9,6,1300,22,11,11
9,6,959,5,1,4
9,6,1285,21,9,12
9,6,1040,18,13,5
9,6,1194,36,16,20
9,6,688,15,7,8
9,6,1268,66,42,24
9,6,925,11,3,8
9,6,1448,12,6,6
9,6,1347,19,10,9
9,6,3437,48,23,25
9,6,2299,18,10,8
9,6,1141,11,7,4
9,6,2428,84,44,40
9,6,922,11,7,4
9,6,1054,17,11,6
9,6,899,3,1,2
9,6,2039,39,17,22
9,6,989,35,17,18
9,6,743,100,44,56
9,6,2101,22,11,11
9,6,1509,18,11,7
9,6,2343,33,14,19
9,6,1063,21,11,10
9,6,883,1,0,1
9,6,1974,3,0,3
9,6,2464,14,5,9
9,6,1195,13,5,8
9,6,2140,34,15,19
9,6,1763,15,6,9
9,6,1813,25,14,11
9,6,1203,17,8,9
9,6,1713,30,10,20
9,6,3994,55,24,31
9,6,1436,5,4,1
9,6,4957,82,42,40
9,6,1237,29,16,13
9,6,1090,16,8,8
9,6,1079,12,8,4
9,6,822,1,1,0
9,6,2320,106,48,58
9,6,1479,24,12,12
9,6,2241,23,11,12
9,6,2096,93,42,51
9,6,1051,18,10,8
9,6,1033,15,8,7
9,6,2245,81,38,43
9,6,4741,76,37,39
9,6,1248,22,12,10
9,6,1834,21,11,10
9,6,1214,39,22,17
9,6,1696,23,11,12
9,6,1402,12,8,4
9,6,608,1,1,0
9,6,1072,3,1,2
9,6,841,6,2,4
9,6,865,4,4,0
9,6,787,1,1,0
9,6,604,7,3,4
9,6,765,4,2,2
9,6,628,13,8,5
9,6,1992,30,11,19
9,6,1031,15,9,6
9,6,1183,11,4,7
9,6,1807,9,5,4
9,6,1151,25,9,16
9,6,1686,21,10,11
9,6,659,16,9,7
9,6,1336,24,15,9
9,6,702,10,4,6
9,6,665,7,2,5
9,6,1197,18,8,10
9,6,978,21,12,9
9,6,1658,39,20,19
9,6,1089,11,8,3
9,7,1414,21,8,13
9,7,1078,21,9,12
9,7,977,23,13,10
9,7,1646,30,12,18
9,7,1359,29,17,12
9,7,1639,23,12,11
9,7,458,0,0,0
9,7,848,34,18,16
9,7,1142,1,0,1
9,7,1090,12,8,4
9,7,1381,10,3,7
9,7,1493,16,9,7
9,7,1228,4,3,1
9,7,1199,8,5,3
9,7,852,1,0,1
9,7,1106,17,6,11
9,7,1063,20,8,12
9,7,983,2,1,1
9,7,3426,118,65,53
9,7,1599,5,4,1
9,7,1334,28,14,14
9,7,1184,31,14,17
9,7,1874,8,3,5
9,7,1533,5,3,2
9,7,1543,8,4,4
9,7,1205,15,7,8
9,7,1383,147,78,69
9,7,1493,121,65,56
9,7,1323,6,1,5
9,7,1668,18,8,10
9,7,1589,30,13,17
9,7,2008,54,27,27
9,7,1623,29,12,17
9,7,1675,28,18,10
9,7,2087,74,33,41
9,7,1647,7,3,4
9,7,1270,4,2,2
9,7,844,2,1,1
9,7,741,1,1,0
9,7,1681,8,3,5
9,7,1281,12,6,6
9,7,961,10,5,5
9,7,1933,24,8,16
9,7,1702,13,4,9
9,7,1611,37,19,18
9,7,1648,90,36,54
9,7,1049,10,6,4
9,7,1498,14,11,3
9,7,1176,14,8,6
9,7,1180,16,6,10
9,7,1160,47,19,28
9,7,1147,62,33,29
9,7,1365,5,3,2
9,7,2303,16,7,9
9,7,2223,36,21,15
9,7,2015,26,17,9
9,7,2576,158,85,73
9,7,2010,29,17,12
9,7,1964,42,27,15
9,7,2806,15,7,8
9,7,1524,31,7,24
9,7,1848,3,0,3
9,7,1419,3,2,1
9,7,1220,10,5,5
9,7,1895,23,10,13
9,7,771,21,11,10
9,7,1720,35,13,22
9,7,1471,11,4,7
9,7,1822,60,25,35
9,7,1266,80,46,34
9,7,1117,1,1,0
9,7,2116,27,10,17
9,7,1631,12,4,8
9,7,2359,60,33,27
9,7,1550,18,11,7
9,7,1270,37,17,20
9,7,1826,7,5,2
9,7,1525,8,4,4
9,7,1274,3,2,1
9,7,2299,15,9,6
9,7,2000,39,23,16
9,7,1910,9,5,4
9,7,2393,37,14,23
9,7,0,0,0,0
9,7,1404,29,15,14
9,7,2670,55,31,24
9,7,1903,95,52,43
9,7,2628,7,4,3
9,7,686,11,6,5
9,7,681,6,1,5
9,7,439,53,27,26
9,7,2030,118,54,64
9,7,1441,24,12,12
9,7,1278,4,2,2
9,7,1745,23,13,10
9,7,1047,2,0,2
9,7,3419,158,83,75
9,7,1291,24,14,10
9,7,1239,27,12,15
9,7,998,7,2,5
9,7,1260,31,17,14
9,7,1290,30,17,13
9,7,1385,21,10,11
9,7,800,5,3,2
9,7,1026,2,2,0
9,7,1117,26,17,9
9,7,943,15,6,9
9,7,906,22,11,11
9,7,1118,113,61,52
9,7,2770,105,56,49
9,7,1293,80,44,36
9,7,1325,51,28,23
9,7,313,4,3,1
9,7,4490,156,72,84
9,7,0,0,0,0
9,7,813,12,5,7
9,7,1239,45,23,22
9,7,1453,13,7,6
9,7,2344,63,31,32
9,7,1084,7,3,4
9,7,1637,27,20,7
9,7,1155,41,24,17
9,7,1311,24,10,14
9,7,2925,76,39,37
9,7,852,20,12,8
9,7,830,10,5,5
9,7,943,2,2,0
9,7,856,5,3,2
9,7,5311,91,50,41
9,7,965,6,2,4
9,7,1272,4,2,2
9,7,1270,43,23,20
9,7,737,28,12,16
9,7,970,17,10,7
9,7,1043,8,2,6
9,7,1264,24,16,8
9,7,1266,15,8,7
9,7,1451,7,4,3
9,7,882,7,4,3
9,7,1446,19,17,2
9,7,1415,8,5,3
9,7,1458,11,8,3
9,7,1447,5,2,3
9,7,1335,1,0,1
9,7,1481,18,8,10
9,7,1634,35,19,16
9,7,1324,64,24,40
9,7,1262,5,2,3
9,7,901,6,3,3
9,7,1624,137,66,71
9,7,1637,14,8,6
9,7,1332,38,20,18
9,7,2047,11,3,8
9,7,1212,7,4,3
9,7,6312,177,79,98
9,7,956,9,5,4
9,7,1225,52,30,22
9,7,1569,2,1,1
9,7,1370,43,21,22
9,7,1099,182,98,84
9,7,1131,17,9,8
9,7,1732,28,16,12
9,7,1771,12,8,4
9,7,1659,29,11,18
9,7,1256,15,5,10
9,7,1678,29,15,14
9,7,1230,1,0,1
9,7,1554,4,2,2
9,7,1245,4,2,2
9,7,1584,3,0,3
9,7,1428,27,19,8
9,7,1021,49,27,22
9,7,1393,12,2,10
9,7,1239,14,11,3
9,7,1363,6,5,1
9,7,1524,10,5,5
9,7,1353,6,4,2
9,7,1573,12,7,5
9,7,1793,20,8,12
9,7,1790,31,14,17
9,7,1783,22,16,6
9,7,1105,24,11,13
9,7,7983,167,81,86
9,7,1682,20,17,3
9,7,1459,3,1,2
9,7,1580,23,16,7
9,7,1520,26,11,15
9,7,1141,1,0,1
9,7,1161,3,2,1
9,7,866,8,3,5
9,7,1152,7,4,3
9,7,1359,25,14,11
9,7,1619,15,8,7
9,7,1768,24,18,6
9,7,1735,19,7,12
9,7,1010,2,0,2
9,7,1751,4,0,4
9,7,2321,86,43,43
9,7,897,6,2,4
9,7,983,10,6,4
9,7,1000,6,4,2
9,7,1008,9,7,2
9,7,1461,24,9,15
9,7,1490,36,16,20
9,7,1246,73,34,39
9,7,1306,32,19,13
9,7,948,9,6,3
9,7,1335,17,8,9
9,7,1319,22,12,10
9,7,1320,17,8,9
9,7,1501,10,6,4
9,7,1618,3,1,2
9,7,1405,6,2,4
9,7,1323,8,3,5
9,7,1950,22,9,13
9,7,1691,9,5,4
9,7,2194,36,16,20
9,7,2097,20,13,7
9,7,1820,24,14,10
9,7,1610,9,5,4
9,7,1373,12,8,4
9,7,1533,6,4,2
9,7,2647,10,3,7
9,7,2438,352,177,175
9,7,4894,6,2,4
9,7,2333,16,5,11
9,7,2065,10,6,4
9,7,2580,23,15,8
9,7,10007,96,52,44
9,7,826,21,9,12
9,7,1200,24,12,12
9,7,1843,9,3,6
9,7,1689,34,16,18
9,7,886,9,5,4
9,7,1278,26,18,8
9,7,2164,50,26,24
9,7,7295,55,24,31
9,7,1299,9,4,5
9,7,887,26,17,9
9,7,1136,28,16,12
9,7,1269,7,4,3
9,7,1159,45,24,21
9,7,1497,28,17,11
9,7,6184,121,66,55
9,7,967,16,7,9
9,7,885,17,9,8
9,7,826,16,8,8
9,7,7152,22,9,13
9,7,1681,16,8,8
9,7,5179,27,10,17
9,7,2289,19,11,8
9,7,1720,5,2,3
9,7,2379,26,7,19
9,7,2250,19,11,8
9,7,1507,14,7,7
9,7,2451,18,7,11
9,7,1762,22,14,8
9,7,1838,38,16,22
9,7,2294,78,36,42
9,7,1717,7,3,4
9,7,1278,6,4,2
9,7,2114,6,4,2
9,7,1597,7,5,2
9,7,1761,44,23,21
9,7,1850,2,1,1
9,7,1249,6,1,5
9,7,2154,8,5,3
9,7,2045,1,0,1
9,7,1504,11,4,7
9,7,1511,4,2,2
9,7,1239,16,10,6
9,7,1051,2,1,1
9,7,895,8,4,4
9,7,1252,25,15,10
9,7,1691,9,3,6
9,7,2398,6,2,4
9,7,858,4,2,2
9,7,1095,2,2,0
9,7,7980,70,33,37
9,7,588,3,1,2
9,7,929,0,0,0
9,7,1418,7,3,4
9,7,1481,14,5,9
9,7,1387,16,7,9
9,7,1453,10,4,6
9,7,1245,16,6,10
9,7,1340,10,7,3
9,7,1352,26,12,14
9,7,1146,84,46,38
9,7,1327,67,36,31
9,7,1150,7,4,3
9,7,1060,5,2,3
9,7,1350,3,1,2
9,7,990,2,1,1
9,7,1087,4,2,2
9,7,1209,32,18,14
9,7,1567,56,35,21
9,7,1733,62,33,29
9,7,1240,49,22,27
9,7,1557,70,34,36
9,7,1077,2,1,1
9,7,1078,16,6,10
9,7,1130,1,0,1
9,7,1379,13,7,6
9,7,1218,63,27,36
9,7,1279,3,1,2
9,7,1258,21,12,9
9,7,3628,131,63,68
9,7,1365,13,6,7
9,7,1480,13,9,4
9,7,2160,23,12,11
9,7,1902,1,0,1
9,7,1867,17,8,9
9,7,1243,21,11,10
9,7,459,1,1,0
9,7,1680,203,101,102
9,7,1910,262,137,125
9,7,2051,15,4,11
9,7,2287,51,23,28
9,7,2056,65,33,32
9,7,1485,20,8,12
9,7,2388,44,28,16
9,7,2029,35,15,20
9,7,1873,43,17,26
9,7,1905,30,15,15
9,7,1202,16,10,6
9,7,1370,4,2,2
9,7,1815,14,8,6
9,7,1235,40,19,21
9,7,964,0,0,0
9,7,1554,21,13,8
9,7,1589,34,16,18
9,7,1491,24,10,14
9,7,1301,19,12,7
9,7,1171,7,2,5
9,7,1726,16,8,8
9,7,696,3,3,0
9,7,928,11,9,2
9,7,2088,39,23,16
9,7,1566,14,9,5
9,7,1118,15,9,6
9,7,737,10,3,7
9,7,1634,32,16,16
9,7,1045,5,3,2
9,7,1341,4,2,2
9,7,1790,19,7,12
9,7,1170,1,0,1
9,7,921,1,1,0
9,7,925,11,6,5
9,7,1794,27,17,10
9,7,1407,18,7,11
9,7,1375,15,4,11
9,7,1256,25,12,13
9,7,1497,9,5,4
9,7,1377,21,13,8
9,7,2261,60,36,24
9,7,1252,4,2,2
9,7,749,2,1,1
9,7,1346,6,4,2
9,7,1557,16,11,5
9,7,1303,38,20,18
9,7,753,3,1,2
9,7,956,4,3,1
9,7,924,2,1,1
9,7,778,9,5,4
9,7,3421,30,15,15
9,7,1618,39,18,21
9,7,5705,363,172,191
9,7,1270,883,469,414
9,7,1012,34,17,17
9,7,1817,179,108,71
9,7,789,23,10,13
9,7,984,15,9,6
9,7,894,13,6,7
9,7,941,13,6,7
9,7,1273,38,17,21
9,7,1043,61,32,29
9,7,1520,34,21,13
9,7,1214,100,56,44
9,7,2691,23,10,13
9,7,2236,135,68,67
9,7,2340,19,9,10
9,7,1173,52,24,28
9,7,1123,10,4,6
9,7,1507,17,10,7
9,7,1368,7,6,1
9,7,1295,10,6,4
9,7,1371,4,1,3
9,7,1301,9,3,6
9,7,1733,21,9,12
9,7,1502,13,6,7
9,7,1637,25,12,13
9,7,2790,68,30,38
9,7,1805,15,5,10
9,7,2388,17,10,7
9,7,1549,12,7,5
9,7,1528,9,3,6
9,7,1281,11,7,4
9,7,1187,60,31,29
9,7,1431,52,25,27
9,7,1225,21,12,9
9,7,1500,20,9,11
9,7,1623,21,13,8
9,7,1476,10,5,5
9,7,662,14,11,3
9,7,980,30,20,10
9,7,1087,8,2,6
9,7,1315,32,15,17
9,7,1455,95,57,38
9,7,1428,10,4,6
9,7,4932,39,22,17
9,7,998,80,41,39
9,7,1012,45,21,24
9,7,1713,42,25,17
9,7,2498,22,13,9
9,7,1528,9,3,6
9,7,1605,6,3,3
9,7,1220,7,4,3
9,7,1636,50,22,28
9,7,1169,18,10,8
9,7,1531,8,3,5
9,7,1610,20,9,11
9,7,1964,14,7,7
9,7,1652,23,8,15
9,7,1528,207,93,114
9,7,2289,816,412,404
9,7,2039,30,15,15
9,7,1700,68,32,36
9,7,1697,10,3,7
9,7,2347,24,13,11
9,7,1578,16,5,11
9,7,1308,9,4,5
9,7,1447,13,5,8
9,7,1565,32,17,15
9,7,646,23,10,13
9,7,2556,18,7,11
9,7,1626,19,11,8
9,7,2725,31,11,20
9,7,2278,69,36,33
9,7,2370,49,25,24
9,7,1149,17,13,4
9,7,798,4,4,0
9,7,1239,40,17,23
9,7,873,19,10,9
9,7,1345,33,18,15
9,7,905,5,3,2
9,7,653,31,13,18
9,7,925,8,4,4
9,7,744,12,8,4
9,7,1209,12,5,7
9,7,1389,31,17,14
9,7,1117,2,1,1
9,7,604,4,2,2
9,7,1116,11,4,7
9,7,1377,6,4,2
9,7,869,13,4,9
9,7,346,3,3,0
9,7,0,0,0,0
9,7,1726,2,1,1
9,7,1406,14,7,7
9,7,1073,18,11,7
9,7,1914,62,36,26
9,7,1735,22,15,7
9,7,1102,12,7,5
9,7,909,17,8,9
9,7,2071,76,40,36
9,7,1097,5,2,3
9,7,1209,16,7,9
9,7,1231,12,6,6
9,7,1084,3,2,1
9,7,938,27,15,12
9,7,966,17,7,10
9,7,906,10,5,5
9,7,991,8,3,5
9,7,1441,36,18,18
9,7,564,2,2,0
9,7,1153,10,3,7
9,7,1352,40,17,23
9,7,1213,47,26,21
9,7,1698,47,24,23
9,7,1820,21,11,10
9,7,755,6,3,3
9,7,837,3,1,2
9,7,1699,21,10,11
9,7,618,7,2,5
9,7,906,3,2,1
9,7,1012,32,10,22
9,7,1042,27,15,12
9,7,1027,37,20,17
9,7,1100,10,6,4
9,7,1282,38,20,18
9,7,1104,3,3,0
9,7,991,15,6,9
9,7,1280,18,10,8
9,7,977,32,18,14
9,7,1296,9,7,2
9,7,965,12,7,5
9,7,995,3,2,1
9,7,967,10,5,5
9,7,1084,13,5,8
9,7,588,13,7,6
9,7,852,6,5,1
9,7,1119,6,3,3
9,7,1089,36,23,13
9,7,991,5,4,1
9,7,1210,33,18,15
9,7,1068,7,3,4
9,7,622,1,1,0
9,7,911,2,0,2
9,7,845,11,9,2
9,7,915,55,32,23
9,7,1253,12,7,5
9,7,1101,24,12,12
9,7,1030,25,17,8
9,7,1135,40,20,20
9,7,1265,11,5,6
9,7,964,13,4,9
9,7,1114,14,6,8
9,7,1252,13,7,6
9,7,860,21,10,11
9,7,827,1,1,0
9,7,1215,9,4,5
9,7,1070,36,21,15
9,7,957,53,23,30
9,7,1103,26,8,18
9,7,498,0,0,0
9,7,472,7,3,4
9,7,478,5,3,2
9,7,892,13,8,5
9,7,838,12,9,3
9,7,1781,32,18,14
9,7,107,5,1,4
9,7,637,7,2,5
9,7,1675,16,9,7
9,7,2572,59,41,18
9,7,1111,12,7,5
9,7,1443,12,3,9
9,7,585,4,1,3
9,7,4106,33,17,16
9,7,1399,45,23,22
9,7,1512,49,26,23
9,7,1623,17,11,6
9,7,1946,26,10,16
9,7,3034,47,20,27
9,7,1507,27,12,15
9,7,1668,3,3,0
9,7,1378,15,7,8
9,7,1354,17,8,9
9,7,1534,9,5,4
9,7,1067,4,3,1
9,7,1349,17,10,7
9,7,1150,9,5,4
9,7,802,17,7,10
9,7,2570,29,13,16
9,7,1078,44,20,24
9,7,1459,6,1,5
9,7,930,27,14,13
9,7,1232,5,3,2
9,7,1337,8,4,4
9,7,1767,6,3,3
9,7,1731,105,55,50
9,7,1113,13,5,8
9,7,1875,56,33,23
9,7,1351,19,8,11
9,7,1581,39,19,20
9,7,3682,31,15,16
9,7,1443,26,11,15
9,7,1371,10,6,4
9,7,2524,28,11,17
9,7,3260,49,23,26
9,7,1681,3,1,2
9,7,1013,4,1,3
9,7,1377,54,17,37
9,7,2021,12,9,3
9,7,1301,53,27,26
9,7,642,20,10,10
9,7,1757,28,15,13
9,7,1964,34,16,18
9,7,1656,93,57,36
9,7,1373,1,1,0
9,7,1380,85,43,42
9,7,1720,4,3,1
9,7,1358,8,5,3
9,7,1463,43,18,25
9,7,1717,7,2,5
9,7,1657,12,5,7
9,7,1751,20,5,15
9,7,1444,27,11,16
9,7,1692,51,22,29
9,7,2237,9,4,5
9,7,1462,20,10,10
9,7,3838,48,27,21
9,7,2826,25,14,11
9,7,1417,4,2,2
9,7,2282,38,14,24
9,7,1824,3,1,2
9,7,2023,3,1,2
9,7,1476,0,0,0
9,7,1273,32,10,22
9,7,2323,119,60,59
9,7,2816,23,14,9
9,7,2079,18,10,8
9,7,1836,39,18,21
9,7,1996,7,4,3
9,7,2072,16,8,8
9,7,1503,7,5,2
9,7,1746,12,5,7
9,7,1865,10,4,6
9,7,1882,18,5,13
9,7,2996,30,16,14
9,7,2942,26,11,15
9,7,1756,17,14,3
9,7,1830,4,1,3
9,7,1705,4,2,2
9,7,1461,26,11,15
9,7,3727,18,8,10
9,7,2188,87,43,44
9,7,2199,107,60,47
9,7,1374,2,2,0
9,7,2582,157,67,90
9,7,3765,28,15,13
9,7,1726,11,3,8
9,7,2033,41,23,18
9,7,2307,31,13,18
9,7,1918,23,13,10
9,7,1926,28,17,11
9,7,1867,10,4,6
9,7,1892,8,5,3
9,7,2418,41,17,24
9,7,1865,12,4,8
9,7,1875,6,4,2
9,7,1741,17,8,9
9,7,1279,17,12,5
9,7,1686,51,30,21
9,7,2076,9,5,4
9,7,1732,28,13,15
9,7,1958,41,18,23
9,7,2088,41,20,21
9,7,1792,29,14,15
9,7,2075,9,7,2
9,7,1949,49,20,29
9,7,2783,94,46,48
9,7,1967,2,0,2
9,7,1357,31,20,11
9,7,1674,10,7,3
9,7,4542,13,6,7
9,7,2175,24,10,14
9,7,1377,68,37,31
9,7,2099,9,6,3
9,7,3118,65,33,32
9,7,2299,16,3,13
9,7,1754,16,5,11
9,7,1880,16,8,8
9,7,1437,28,12,16
9,7,1509,37,22,15
9,7,1910,47,18,29
9,7,1231,2,1,1
9,7,1476,4,1,3
9,7,2078,11,4,7
9,7,1831,13,7,6
9,7,1552,22,9,13
9,7,1640,22,10,12
9,7,2041,16,5,11
9,7,914,9,5,4
9,7,1168,18,13,5
9,7,1378,5,1,4
9,7,1813,4,1,3
9,7,1331,72,27,45
9,7,980,198,107,91
9,7,1889,10,5,5
9,7,1900,22,11,11
9,7,751,10,4,6
9,7,2339,16,8,8
9,7,1177,13,6,7
9,7,2468,34,18,16
9,7,1809,124,65,59
9,7,2678,83,38,45
9,7,6565,105,48,57
9,7,2109,15,8,7
9,7,4528,73,43,30
9,7,277,18,10,8
9,7,2121,33,23,10
9,7,656,4,0,4
9,7,2154,25,12,13
9,7,1644,8,7,1
9,7,1033,3,1,2
9,7,3862,86,38,48
9,7,1445,6,3,3
9,7,1908,79,41,38
9,7,1614,60,29,31
9,7,1530,2,1,1
9,7,10841,457,232,225
9,7,2188,124,60,64
9,7,2132,17,9,8
9,7,5156,45,23,22
9,7,4585,74,37,37
9,7,2757,140,66,74
9,7,940,3,2,1
9,7,1762,34,20,14
9,7,910,25,13,12
9,7,1493,84,48,36
9,7,1906,6,5,1
9,7,1618,21,10,11
9,7,1708,49,23,26
9,7,1596,14,8,6
9,7,2581,31,19,12
9,7,1003,5,4,1
9,7,1878,80,44,36
9,7,2843,67,31,36
9,7,2265,96,45,51
9,7,2027,4,4,0
9,7,2337,31,17,14
9,7,2289,43,22,21
9,7,2489,9,6,3
9,7,2530,14,6,8
9,7,1665,8,1,7
9,7,1816,4,2,2
9,7,2236,12,4,8
9,7,1643,55,29,26
9,7,1995,5,2,3
9,7,1639,2,2,0
9,7,2672,38,23,15
9,7,2184,20,9,11
9,7,1615,6,3,3
9,7,1443,9,3,6
9,7,1670,13,8,5
9,7,1615,20,7,13
9,7,1476,10,7,3
9,7,1936,38,22,16
9,7,2254,52,23,29
9,7,1609,0,0,0
9,7,2158,21,9,12
9,7,2587,73,34,39
9,7,1902,12,7,5
9,7,1395,9,7,2
9,7,1691,15,8,7
9,7,2176,27,15,12
9,7,1552,10,9,1
9,7,1779,36,25,11
9,7,2138,7,4,3
9,7,1961,21,9,12
9,7,1798,2,1,1
9,7,2288,14,10,4
9,7,2431,10,5,5
9,7,1799,36,18,18
9,7,1639,3,1,2
9,7,1784,68,37,31
9,7,1755,52,24,28
9,7,3865,69,21,48
9,7,3483,30,13,17
9,7,2240,7,5,2
9,7,2008,10,4,6
9,7,2041,32,16,16
9,7,2648,85,44,41
9,7,2092,34,19,15
9,7,1880,6,4,2
9,7,1866,28,17,11
9,7,2306,27,13,14
9,7,1880,10,4,6
9,7,2083,43,21,22
9,7,1560,13,7,6
9,7,7801,67,39,28
9,7,5392,148,68,80
9,7,1858,8,3,5
9,7,1242,8,5,3
9,7,1101,27,14,13
9,7,1247,38,19,19
9,7,4285,42,22,20
9,7,1674,30,12,18
9,7,811,6,1,5
9,7,1525,12,6,6
9,7,1495,30,16,14
9,7,1710,3,1,2
9,7,1639,21,9,12
9,7,1378,18,8,10
9,7,1522,10,4,6
9,7,2264,17,5,12
9,7,2505,32,17,15
9,7,1708,18,7,11
9,7,2339,30,16,14
9,7,1619,12,8,4
9,7,1082,23,9,14
9,7,1145,2,0,2
9,7,4495,61,34,27
9,7,1392,2,0,2
9,7,1029,16,11,5
9,7,2334,108,56,52
9,7,12680,44,23,21
9,7,1939,19,9,10
9,7,1839,22,9,13
9,7,1605,24,9,15
9,7,1836,18,6,12
9,7,1154,8,3,5
9,7,2397,16,6,10
9,7,1487,15,5,10
9,7,1655,158,81,77
9,7,1829,27,13,14
9,7,1857,59,24,35
9,7,3183,49,24,25
9,7,1720,40,19,21
9,7,2126,32,14,18
9,7,1908,76,43,33
9,7,1733,32,15,17
9,7,1966,8,3,5
9,7,1913,12,7,5
9,7,1855,21,16,5
9,7,2173,9,4,5
9,7,2091,7,5,2
9,7,3938,20,10,10
9,7,2399,50,27,23
9,7,2919,45,24,21
9,7,2169,36,20,16
9,7,1971,12,3,9
9,7,2117,118,56,62
9,7,3402,14,10,4
9,7,7721,153,70,83
9,7,2279,25,11,14
9,7,2074,4,2,2
9,7,2550,15,6,9
9,7,2958,7,2,5
9,7,2730,12,7,5
9,7,2064,11,5,6
9,7,2413,8,4,4
9,7,1990,2,1,1
9,7,1933,11,5,6
9,7,2009,16,9,7
9,7,4143,56,25,31
9,7,2244,29,9,20
9,7,3140,36,18,18
9,7,7969,75,34,41
9,7,4329,74,43,31
9,7,6922,91,45,46
9,7,4452,120,58,62
9,7,1887,8,5,3
9,7,2420,34,22,12
9,7,2770,530,264,266
9,7,2441,101,49,52
9,7,1806,16,7,9
9,7,3851,30,17,13
9,7,1574,14,7,7
9,7,5397,26,10,16
9,7,3597,139,70,69
9,7,1700,68,35,33
9,7,1882,50,24,26
9,7,1896,25,12,13
9,7,1563,122,58,64
9,7,3301,38,19,19
9,7,3334,29,12,17
9,7,5600,83,41,42
9,7,3158,38,15,23
9,7,4832,15,8,7
9,7,2684,17,10,7
9,7,1620,8,6,2
9,7,2275,22,10,12
9,7,1772,27,12,15
9,7,1706,29,12,17
9,7,1668,202,101,101
9,7,1346,7,3,4
9,7,2611,11,7,4
9,7,1805,106,50,56
9,7,1655,15,10,5
9,7,1971,9,4,5
9,7,1714,65,28,37
9,7,2711,24,10,14
9,7,2262,38,17,21
9,7,1180,8,3,5
9,7,1196,4,2,2
9,7,1563,34,16,18
9,7,788,14,4,10
9,7,1876,83,42,41
9,7,1489,37,26,11
9,7,1141,27,16,11
9,7,917,35,16,19
9,7,627,15,8,7
9,7,1128,6,4,2
9,7,871,10,8,2
9,7,1301,53,29,24
9,7,732,6,5,1
9,7,1648,8,3,5
9,7,1635,21,10,11
9,7,1432,10,4,6
9,7,2159,35,13,22
9,7,3645,107,53,54
9,7,2154,40,17,23
9,7,2056,2,1,1
9,7,1582,20,8,12
9,7,1514,14,6,8
9,7,2279,31,16,15
9,7,2077,132,68,64
9,7,1763,358,178,180
9,7,2012,23,10,13
9,7,1726,21,8,13
9,7,2687,27,15,12
9,7,12752,201,107,94
9,7,5687,60,34,26
9,7,17340,458,238,220
9,7,4441,59,36,23
9,7,1928,55,25,30
9,7,9016,57,32,25
9,7,3360,94,48,46
9,7,1738,85,44,41
9,7,2239,14,6,8
9,7,3181,27,11,16
9,7,2109,62,30,32
9,7,2057,47,21,26
9,7,2135,18,5,13
9,7,1255,2,2,0
9,7,1499,9,4,5
9,7,3850,56,30,26
9,7,1107,13,8,5
9,7,1112,12,7,5
9,7,2362,17,10,7
9,7,486,3,1,2
9,7,1275,73,39,34
9,7,6004,164,93,71
9,7,1093,94,52,42
9,7,1007,17,11,6
9,7,1167,13,8,5
9,7,814,0,0,0
9,7,1153,38,24,14
9,7,1330,49,23,26
9,7,772,3,1,2
9,7,1276,4,3,1
9,7,2135,45,19,26
9,7,2371,26,16,10
9,7,3551,50,27,23
9,7,2199,5,3,2
9,7,1848,16,9,7
9,7,11447,182,100,82
9,7,2437,25,12,13
9,7,764,37,20,17
9,7,1538,48,24,24
9,7,1280,12,7,5
9,7,1270,38,16,22
9,7,1511,38,17,21
9,7,747,4,2,2
9,7,1539,24,12,12
9,7,1810,2,1,1
9,7,2205,37,19,18
9,7,1693,37,18,19
9,7,1828,58,34,24
9,7,1666,3,2,1
9,7,1670,12,6,6
9,7,1824,30,16,14
9,7,1333,21,15,6
9,7,1804,1,0,1
9,7,1558,0,0,0
9,7,2105,9,5,4
9,7,1686,21,13,8
9,7,1673,48,21,27
9,7,1584,15,5,10
9,7,1543,24,13,11
9,7,1584,44,21,23
9,7,1603,35,14,21
9,7,2411,76,38,38
9,7,1854,6,2,4
9,7,1842,23,7,16
9,7,2122,27,13,14
9,7,1992,17,9,8
9,7,1687,8,3,5
9,7,1671,15,8,7
9,7,1778,34,16,18
9,7,1385,18,7,11
9,7,3154,9,6,3
9,7,3653,7,5,2
9,7,1456,4,1,3
9,7,1325,6,4,2
9,7,1542,36,19,17
9,7,712,2,0,2
9,7,1794,13,9,4
9,7,2229,6,2,4
9,7,2206,8,3,5
9,7,2118,11,3,8
9,7,1990,2,1,1
9,7,2344,17,9,8
9,7,2151,96,51,45
9,7,2006,17,11,6
9,7,2433,86,39,47
9,7,1473,33,14,19
9,7,944,20,7,13
9,7,2011,8,4,4
9,7,1680,5,2,3
9,7,1479,34,18,16
9,7,1585,11,3,8
9,7,1853,4,1,3
9,7,1972,1,1,0
9,7,4151,55,30,25
9,7,6214,36,15,21
9,7,1535,8,2,6
9,7,1937,34,13,21
9,7,3177,31,15,16
9,7,1374,4,1,3
9,7,576,6,4,2
9,7,1072,160,86,74
9,7,1395,14,8,6
9,7,683,10,5,5
9,7,1000,3,1,2
9,7,838,15,6,9
9,7,850,10,4,6
9,7,3308,40,15,25
9,7,264,4,2,2
9,8,827,42,23,19
9,8,925,72,34,38
9,8,1212,14,7,7
9,8,658,33,16,17
9,8,922,10,5,5
9,8,898,7,3,4
9,8,928,12,7,5
9,8,848,8,5,3
9,8,642,20,9,11
9,8,915,17,9,8
9,8,1849,21,7,14
9,8,1235,10,4,6
9,8,1215,24,9,15
9,8,1180,12,5,7
9,8,1359,23,15,8
9,8,1198,4,2,2
9,8,1477,33,18,15
9,8,1338,175,85,90
9,8,955,81,41,40
9,8,1944,104,49,55
9,8,1713,39,17,22
9,8,2326,17,8,9
9,8,2296,26,15,11
9,8,785,12,6,6
9,8,1213,184,112,72
9,8,606,228,119,109
9,8,1617,13,9,4
9,8,1250,10,6,4
9,8,1288,35,16,19
9,8,1675,85,38,47
9,8,1060,34,21,13
9,8,1021,10,3,7
9,8,1770,25,12,13
9,8,1156,21,5,16
9,8,1190,14,7,7
9,8,1159,18,7,11
9,8,1457,35,15,20
9,8,1159,38,22,16
9,8,809,14,7,7
9,8,1345,62,40,22
9,8,1350,11,6,5
9,8,2198,73,35,38
9,8,1751,88,39,49
9,8,1815,5,2,3
9,8,2188,6,3,3
9,8,1968,56,27,29
9,8,1949,60,33,27
9,8,2203,7,4,3
9,8,1026,37,18,19
9,8,1516,138,72,66
9,8,232,32,18,14
9,8,1701,7,4,3
9,8,787,28,12,16
9,8,2040,24,17,7
9,8,1528,11,5,6
9,8,1313,16,7,9
9,8,1750,19,10,9
9,8,1524,10,3,7
9,8,1651,27,11,16
9,8,1509,55,30,25
9,8,1729,111,61,50
9,8,1711,115,67,48
9,8,1536,11,6,5
9,8,1800,29,20,9
9,8,1459,30,14,16
9,8,2078,16,8,8
9,8,1715,17,7,10
9,8,3122,13,9,4
9,8,2395,8,6,2
9,8,1768,7,6,1
9,8,1662,3,1,2
9,8,1227,6,1,5
9,8,1066,43,23,20
9,8,1548,133,72,61
9,8,1771,61,31,30
9,8,1629,57,30,27
9,8,950,27,15,12
9,8,1802,60,27,33
9,8,1520,22,11,11
9,8,1480,36,19,17
9,8,1279,37,19,18
9,8,1364,6,4,2
9,8,788,11,6,5
9,8,1311,26,8,18
9,8,1295,48,24,24
9,8,845,17,5,12
9,8,1475,31,18,13
9,8,1507,12,6,6
9,8,2109,31,16,15
9,8,2285,15,10,5
9,8,2000,30,17,13
9,8,2245,67,34,33
9,8,1308,41,22,19
9,8,1125,46,22,24
9,8,1732,32,18,14
9,8,1814,14,10,4
9,8,3050,18,7,11
9,8,1983,64,35,29
9,8,1521,6,2,4
9,8,2390,6,4,2
9,8,2076,50,23,27
9,8,1189,9,6,3
9,8,2072,1,1,0
9,8,822,3,1,2
9,8,1517,14,8,6
9,8,1735,28,13,15
9,8,2125,36,18,18
9,8,1761,17,8,9
9,8,745,3,2,1
9,8,1055,7,5,2
9,8,1513,24,12,12
9,8,2199,113,62,51
9,8,1219,143,77,66
9,8,1494,24,14,10
9,8,2337,9,5,4
9,8,3831,51,32,19
9,8,8648,260,123,137
9,8,4503,51,25,26
9,8,3370,16,8,8
9,8,3088,105,53,52
9,8,2188,20,11,9
9,8,1857,39,22,17
9,8,2375,50,27,23
9,8,5453,174,83,91
9,8,3391,58,28,30
9,8,1551,0,0,0
9,8,2045,10,5,5
9,8,1053,7,4,3
9,8,578,13,7,6
9,8,1136,5,2,3
9,8,983,21,11,10
9,8,2620,58,22,36
9,8,1664,11,8,3
9,8,1432,19,10,9
9,8,72,0,0,0
9,8,631,8,5,3
9,8,2149,15,5,10
9,8,945,26,7,19
9,8,986,3,2,1
9,8,998,101,45,56
9,8,1109,8,4,4
9,8,1779,8,3,5
9,8,1033,25,10,15
9,8,1352,43,25,18
9,8,1587,23,10,13
9,8,4391,17,6,11
9,9,2121,36,20,16
9,9,6226,24,13,11
9,9,3633,114,55,59
9,9,2092,9,5,4
9,9,7326,40,22,18
9,9,2800,35,16,19
9,9,5788,179,91,88
9,9,4848,84,38,46
9,9,3567,53,26,27
9,9,2156,28,15,13
9,9,2643,15,7,8
9,9,1657,14,6,8
9,9,1833,5,2,3
9,9,2960,65,31,34
9,9,5249,74,38,36
9,9,2106,19,11,8
9,9,1474,77,43,34
9,9,2148,97,43,54
9,9,2428,8,4,4
9,9,3083,2,1,1
9,9,2330,67,28,39
9,9,3456,31,15,16
9,9,1969,28,18,10
9,9,1634,7,3,4
9,9,3301,5,4,1
9,9,2773,32,15,17
9,9,2792,7,4,3
9,9,3089,51,22,29
9,9,2135,12,8,4
9,9,4462,87,50,37
9,9,1801,10,3,7
9,9,3019,80,38,42
9,9,2914,20,13,7
9,9,2461,69,36,33
9,9,5483,20,6,14
9,9,2359,21,9,12
9,9,3842,25,13,12
9,9,3082,128,69,59
9,9,3975,60,31,29
9,9,1614,15,9,6
9,9,7102,12,3,9
9,9,7517,39,16,23
9,9,2218,6,2,4
9,9,2510,125,64,61
9,10,2512,10,6,4
9,10,1349,22,10,12
9,10,1431,17,9,8
9,10,916,11,8,3
9,10,896,7,3,4
9,10,1469,23,10,13
9,10,1827,12,4,8
9,10,552,1,1,0
9,10,1448,5,3,2
9,10,1350,20,10,10
9,10,1170,348,178,170
9,10,1093,5,1,4
9,10,3215,95,49,46
9,10,6409,252,127,125
9,10,1377,4,3,1
9,10,560,39,17,22
9,10,2722,32,12,20
9,10,991,2,1,1
9,10,824,17,13,4
9,10,1193,9,5,4
9,10,1859,32,19,13
9,10,1508,15,10,5
9,10,1671,28,16,12
9,10,1943,32,15,17
9,10,1164,9,3,6
9,10,1371,10,3,7
9,10,2272,25,14,11
9,10,1348,25,13,12
9,10,1517,48,25,23
9,10,1538,7,3,4
9,10,1794,35,13,22
9,10,1992,38,17,21
9,10,2322,14,5,9
9,10,1409,15,5,10
9,10,1470,7,3,4
9,10,959,18,11,7
9,10,936,0,0,0
9,10,1008,3,3,0
9,10,837,92,52,40
9,10,1302,22,6,16
9,10,1002,6,4,2
9,10,1134,10,2,8
9,10,900,4,1,3
9,10,855,11,3,8
9,10,907,2,1,1
9,10,806,48,24,24
9,10,1058,8,3,5
9,10,1981,9,3,6
9,10,814,3,0,3
9,10,1731,11,2,9
9,10,2795,32,14,18
9,10,5892,86,45,41
9,10,1835,36,19,17
9,10,1290,16,8,8
9,10,1121,14,5,9
9,10,1224,14,8,6
9,10,1342,35,19,16
9,10,337,8,4,4
9,10,2137,50,26,24
9,10,2067,54,28,26
9,10,991,13,5,8
9,10,1414,46,23,23
9,10,1431,42,26,16
9,10,1307,38,24,14
9,10,1365,36,19,17
9,10,1384,19,12,7
9,10,1386,4,3,1
9,10,1210,18,7,11
9,10,1359,45,22,23
9,10,2054,17,9,8
9,10,1329,16,7,9
9,10,961,12,5,7
9,10,3383,51,21,30
9,10,2060,39,22,17
9,10,1633,54,26,28
9,10,1187,11,3,8
9,10,1293,6,4,2
9,10,1189,174,87,87
9,10,1438,312,164,148
9,10,1944,20,14,6
9,10,647,2,0,2
9,10,1547,17,10,7
9,10,2008,6,4,2
9,10,1294,12,6,6
9,10,735,25,11,14
9,10,1334,7,3,4
9,10,2038,5,2,3
9,10,1688,17,11,6
9,10,1230,10,7,3
9,10,1017,1,1,0
9,10,1680,15,7,8
9,10,1390,4,2,2
9,10,1140,20,7,13
9,10,1108,45,27,18
9,10,845,41,20,21
9,10,844,9,4,5
9,10,835,18,9,9
9,10,1471,9,6,3
9,10,981,9,4,5
9,10,1346,21,8,13
9,10,1265,3,2,1
9,10,2222,19,10,9
9,10,1893,7,3,4
9,10,1683,43,20,23
9,10,2134,19,14,5
9,10,2162,38,16,22
9,10,2302,11,8,3
9,10,1816,43,22,21
9,10,1683,8,3,5
9,10,1611,3,3,0
9,10,1154,19,8,11
9,10,1725,70,42,28
9,10,1241,10,6,4
9,10,1860,8,2,6
9,10,2824,61,32,29
9,10,3932,20,11,9
9,10,1551,11,2,9
9,10,1764,28,12,16
9,10,1553,10,2,8
9,10,1817,5,4,1
9,10,1917,58,31,27
9,10,2183,11,4,7
9,10,2164,35,18,17
9,10,3511,936,479,457
9,10,2010,224,121,103
9,10,2059,2,1,1
9,10,2433,20,9,11
9,10,1077,15,8,7
9,10,1884,9,6,3
9,10,1130,2,0,2
9,10,1073,16,10,6
9,10,1034,17,12,5
9,10,15763,397,208,189
9,10,3757,85,43,42
9,10,1903,20,5,15
9,10,3209,73,37,36
9,10,1236,187,109,78
9,10,1949,193,96,97
9,10,2148,5,2,3
9,10,2233,9,5,4
9,10,1345,16,9,7
9,10,1233,1,1,0
9,10,1776,7,3,4
9,10,1500,136,72,64
9,10,1605,18,11,7
9,10,1518,11,5,6
9,10,2141,23,10,13
9,10,2221,11,6,5
9,10,2154,21,10,11
9,10,1215,3,2,1
9,10,1374,4,1,3
9,10,1671,13,5,8
9,10,3389,10,5,5
9,10,1593,47,24,23
9,10,1450,2,1,1
9,10,2512,37,15,22
9,10,1962,24,13,11
9,10,1314,17,6,11
9,10,2277,16,8,8
9,10,2621,43,20,23
9,10,2471,38,13,25
9,10,1999,34,17,17
9,10,1461,3,2,1
9,10,1174,2,1,1
9,10,1188,8,2,6
9,10,1525,3,2,1
9,10,1615,3,2,1
9,10,1652,23,13,10
9,10,1270,18,8,10
9,10,1464,11,4,7
9,10,1655,12,3,9
9,10,1107,4,3,1
9,10,974,15,7,8
9,10,1309,23,14,9
9,10,1735,13,6,7
9,10,1457,24,12,12
9,10,1134,8,3,5
9,10,1414,8,6,2
9,10,1815,14,12,2
9,10,959,6,3,3
9,10,1317,13,9,4
9,10,1234,59,30,29
9,10,1176,3,0,3
9,10,1097,7,3,4
9,10,1147,7,3,4
9,10,1751,49,25,24
9,10,1487,10,5,5
9,10,1629,52,24,28
9,10,1816,21,11,10
9,10,2189,44,24,20
9,10,998,8,1,7
9,10,1617,20,10,10
9,10,430,11,5,6
9,10,1747,5,1,4
9,10,1091,7,5,2
9,10,1893,5,3,2
9,10,1260,1,1,0
9,10,10304,125,70,55
9,10,1876,23,10,13
9,10,2388,20,11,9
9,10,1934,11,5,6
9,10,3065,3,1,2
9,10,1432,19,7,12
9,10,2298,80,36,44
9,10,1101,27,17,10
9,10,1033,17,11,6
9,10,1456,15,10,5
9,10,1679,49,26,23
9,10,1598,60,29,31
9,10,983,16,5,11
9,10,633,16,9,7
9,10,2129,117,63,54
9,10,2194,37,21,16
9,10,2721,130,75,55
9,10,1669,39,17,22
9,10,1224,9,4,5
9,10,2790,9,4,5
9,10,2990,171,89,82
9,10,1760,32,14,18
9,10,2303,54,19,35
9,10,2076,20,6,14
9,10,6271,72,32,40
9,10,1702,34,18,16
9,10,1817,49,22,27
9,10,2577,25,13,12
9,10,3350,26,12,14
9,10,1980,39,18,21
9,10,4326,47,26,21
9,10,1648,11,7,4
9,10,3742,64,39,25
9,10,4554,128,64,64
9,10,2143,21,14,7
9,10,3359,49,22,27
9,10,3215,34,17,17
9,10,4260,73,30,43
9,10,736,0,0,0
9,10,411,0,0,0
9,10,855,7,2,5
9,10,677,5,0,5
9,10,918,2,2,0
9,10,834,4,3,1
9,10,1332,11,8,3
9,10,701,6,5,1
9,10,1399,9,7,2
9,10,1125,28,14,14
9,10,1384,76,36,40
9,10,1133,41,23,18
9,10,1380,14,6,8
9,10,1170,1,0,1
9,10,1121,13,7,6
9,10,992,12,6,6
9,10,951,3,1,2
9,10,1402,13,6,7
9,10,1176,9,5,4
9,10,1802,16,7,9
9,10,1423,12,7,5
9,10,626,19,10,9
9,10,1464,12,5,7
9,10,539,20,10,10
9,10,1607,23,11,12
9,10,834,24,16,8
9,10,1191,15,9,6
9,10,881,63,36,27
9,10,757,26,11,15
9,10,1218,50,22,28
9,10,960,30,14,16
9,10,1219,24,13,11
9,10,1298,20,5,15
9,10,402,8,5,3
9,10,753,20,7,13
9,10,589,2,0,2
9,10,407,1,1,0
9,10,1007,70,38,32
9,10,628,15,8,7
9,10,845,27,16,11
9,10,792,47,30,17
9,10,1178,14,7,7
9,10,715,34,20,14
9,10,759,7,6,1
9,10,687,0,0,0
9,10,969,4,2,2
9,10,789,2,1,1
9,10,1124,18,8,10
9,10,865,10,5,5
9,10,427,6,4,2
9,10,1233,14,8,6
9,10,857,2,0,2
9,10,1214,19,13,6
9,10,2005,80,46,34
9,10,968,9,5,4
9,10,1516,13,7,6
9,10,796,16,8,8
9,10,1370,40,23,17
9,10,1395,36,23,13
9,10,1232,65,32,33
9,10,1335,4,3,1
9,10,1014,12,2,10
9,10,748,4,3,1
9,10,789,17,7,10
9,10,1066,23,14,9
9,10,583,2,1,1
9,10,914,29,15,14
9,10,869,12,7,5
9,10,635,2,0,2
9,10,1011,10,4,6
9,10,999,22,11,11
9,10,696,40,26,14
9,10,752,4,3,1
9,10,1056,29,15,14
9,10,1233,6,4,2
9,10,553,26,16,10
9,10,664,31,16,15
9,10,863,19,11,8
9,10,1170,16,4,12
9,10,1216,8,3,5
9,10,1440,15,6,9
9,10,1502,19,7,12
9,10,3834,44,20,24
9,10,1138,5,3,2
9,10,1821,555,292,263
9,10,2339,31,15,16
9,10,2388,456,238,218
9,10,1325,7,5,2
9,10,1757,25,15,10
9,10,1494,7,5,2
9,10,1518,43,19,24
9,10,10227,173,94,79
9,10,1955,4,3,1
9,10,1144,4,1,3
9,10,2614,13,6,7
9,10,875,14,9,5
9,10,1490,3,3,0
9,10,1762,29,15,14
9,10,1679,8,2,6
9,10,1258,6,3,3
9,10,1531,12,7,5
9,10,1352,12,5,7
9,10,1007,19,7,12
9,10,1029,18,11,7
9,10,1347,35,15,20
9,10,1098,15,6,9
9,10,1835,8,4,4
9,10,1912,47,31,16
9,10,1920,19,9,10
9,10,1446,19,9,10
9,10,1342,38,22,16
9,10,1605,13,9,4
9,10,1256,3,3,0
9,10,3134,6,4,2
9,10,1705,7,4,3
9,10,620,10,4,6
9,10,2068,25,10,15
9,10,1722,22,12,10
9,10,1173,11,6,5
9,10,1593,7,3,4
9,10,1647,6,6,0
9,10,1522,3,2,1
9,10,1607,17,12,5
9,10,1275,25,16,9
9,10,887,15,5,10
9,10,2068,20,11,9
9,10,1423,18,11,7
9,10,1294,24,16,8
9,10,1491,29,17,12
9,10,1220,9,5,4
9,10,4333,131,72,59
9,10,0,0,0,0
9,10,2280,78,45,33
9,10,1974,30,16,14
9,10,1255,132,71,61
9,10,1641,25,16,9
9,10,1035,19,11,8
9,10,2065,35,20,15
9,10,1305,28,17,11
9,10,2410,14,10,4
9,10,2255,14,11,3
9,10,897,3,3,0
9,10,2782,5,3,2
9,10,1293,1,1,0
9,10,715,3,1,2
9,10,776,13,5,8
9,10,1104,30,20,10
9,10,1265,42,17,25
9,10,736,18,8,10
9,10,1270,14,9,5
9,10,1228,8,3,5
9,10,902,35,17,18
9,10,1094,122,66,56
9,10,1450,46,26,20
9,10,3628,35,16,19
9,10,384,1,0,1
9,10,1083,4,2,2
9,10,4624,65,37,28
9,10,3552,140,75,65
9,10,1762,17,6,11
9,10,1785,8,4,4
9,10,4505,75,45,30
9,10,1263,18,11,7
9,10,1699,25,11,14
9,10,1827,41,21,20
9,10,949,36,21,15
9,10,1959,543,282,261
9,10,929,129,66,63
9,10,2372,167,90,77
9,10,628,123,64,59
9,10,694,242,120,122
9,10,1080,5,3,2
9,10,328,0,0,0
9,10,2648,48,26,22
9,10,4327,137,69,68
9,10,1160,17,11,6
9,10,2829,51,27,24
9,10,2389,13,6,7
9,10,1982,94,53,41
9,10,1649,86,40,46
9,10,1504,14,10,4
9,10,2153,24,14,10
9,10,3074,53,20,33
9,10,1650,9,3,6
9,10,3491,37,13,24
9,4,3403,35,14,21
9,4,3493,139,78,61
9,4,3112,52,29,23
9,10,2964,22,11,11
9,10,3148,11,5,6
9,10,1844,3,2,1
9,10,2497,40,18,22
9,10,1876,11,5,6
9,10,3224,65,27,38
9,4,3377,59,30,29
9,10,6483,150,71,79
9,10,2863,39,24,15
9,10,1756,25,10,15
9,10,2054,11,6,5
9,10,1594,7,2,5
9,10,2927,107,47,60
9,10,2274,6,2,4
9,10,448,3,3,0
9,10,1051,4,3,1
9,10,2136,14,5,9
9,10,1308,9,4,5
9,10,2259,21,12,9
9,10,609,5,3,2
9,11,3198,40,17,23
9,11,1963,29,17,12
9,11,1595,6,2,4
9,11,1425,11,7,4
9,11,2337,9,5,4
9,11,4678,221,112,109
9,11,4569,42,25,17
9,11,4216,58,35,23
9,11,3957,164,80,84
9,11,3394,31,18,13
9,11,2784,28,18,10
9,11,5807,47,24,23
9,11,1647,50,30,20
9,11,2499,20,7,13
9,11,3376,16,8,8
9,11,2365,22,12,10
9,11,2747,107,50,57
9,11,2033,14,7,7
9,11,5448,134,66,68
9,11,19671,319,165,154
9,11,4774,98,52,46
9,11,1828,22,9,13
9,11,704,14,6,8
9,11,2520,18,11,7
9,11,2613,54,26,28
9,11,2367,4,1,3
9,11,1459,37,18,19
9,11,6617,295,137,158
9,11,6314,376,188,188
9,11,2092,14,7,7
9,11,2301,19,7,12
9,11,2340,28,14,14
9,11,1685,27,15,12
9,11,2144,27,15,12
9,11,2789,6,4,2
9,11,2248,3,2,1
9,11,2026,4,3,1
9,11,1284,10,4,6
9,11,1638,13,6,7
9,11,1549,6,4,2
9,11,3066,81,44,37
9,11,2145,21,11,10
9,11,1549,52,24,28
9,11,1308,15,7,8
9,11,4288,57,26,31
9,11,2141,4,3,1
9,11,1528,10,4,6
9,11,1627,10,5,5
9,11,1750,24,13,11
9,11,2185,30,16,14
9,11,3047,31,13,18
9,11,2177,4,2,2
9,11,2332,16,9,7
9,11,2169,4,1,3
9,11,10843,83,43,40
9,11,2053,36,17,19
9,11,2758,676,351,325
9,11,2517,514,282,232
9,11,2268,16,6,10
9,11,2454,58,29,29
9,11,2400,39,18,21
9,11,2826,30,11,19
9,11,2030,31,17,14
9,11,2329,18,5,13
9,11,3730,21,11,10
9,11,2887,21,12,9
9,11,2324,49,29,20
9,11,2915,70,37,33
9,11,1731,8,6,2
9,11,1590,15,9,6
9,11,1766,15,5,10
9,11,2055,16,7,9
9,11,1498,52,20,32
9,11,3180,198,101,97
9,11,1763,29,18,11
9,11,4176,75,39,36
9,11,2114,53,25,28
9,11,1884,18,10,8
9,11,1672,7,4,3
9,11,1744,63,30,33
9,11,2069,39,26,13
9,11,1741,66,28,38
9,11,10163,331,161,170
9,11,9216,49,26,23
9,11,1887,21,10,11
9,11,1772,1,0,1
9,11,2217,12,5,7
9,11,1995,29,15,14
9,11,2023,50,24,26
9,11,1785,79,34,45
9,11,1979,3,2,1
9,11,2362,13,7,6
9,11,2169,7,5,2
9,11,2165,7,4,3
9,11,3073,15,4,11
9,11,2054,52,20,32
9,11,2714,49,28,21
9,11,2045,112,55,57
9,11,2219,11,6,5
9,11,3365,24,9,15
9,11,2575,74,36,38
9,11,1954,8,1,7
9,11,3788,85,46,39
9,11,2295,18,7,11
9,11,2181,42,21,21
9,11,1742,35,13,22
9,11,1935,33,16,17
9,11,7133,53,19,34
9,11,5431,113,57,56
9,11,2131,6,3,3
9,11,2119,15,6,9
9,11,2557,48,20,28
9,11,3137,20,10,10
9,11,5714,43,20,23
9,11,4207,16,11,5
9,11,3017,32,16,16
9,11,1907,43,18,25
9,11,1385,2,2,0
9,11,1595,4,3,1
9,11,3602,24,13,11
9,11,3936,24,12,12
9,11,1574,2,1,1
9,11,2534,17,9,8
9,11,1608,7,5,2
9,11,1732,53,29,24
9,11,783,15,7,8
9,11,771,14,5,9
9,11,806,20,11,9
9,11,755,18,8,10
9,11,4479,112,64,48
9,11,1051,71,36,35
9,11,1063,7,4,3
9,11,1664,13,6,7
9,12,1232,11,7,4
9,12,1524,93,47,46
9,12,1457,9,2,7
9,12,1104,24,12,12
9,12,2111,22,11,11
9,12,1407,48,27,21
9,12,1278,32,18,14
9,12,1415,12,3,9
9,12,1165,3,1,2
9,12,1362,24,9,15
9,12,1297,28,17,11
9,12,1516,135,66,69
9,12,1510,6,3,3
9,12,770,4,2,2
9,12,831,8,5,3
9,12,1088,16,9,7
9,12,1850,12,6,6
9,12,808,9,5,4
9,12,434,7,4,3
9,12,705,22,10,12
9,12,2083,32,17,15
9,12,2113,63,40,23
9,12,706,10,5,5
9,12,1027,12,2,10
9,12,1225,15,7,8
9,12,1226,34,17,17
9,12,1061,36,21,15
9,12,1168,18,10,8
9,12,2433,41,22,19
9,12,643,4,3,1
9,12,1071,36,18,18
9,12,2566,29,16,13
9,12,1930,8,4,4
9,12,1306,35,17,18
9,12,1031,57,37,20
9,12,705,20,12,8
9,12,749,18,9,9
9,12,2231,76,40,36
9,12,2488,10,8,2
9,12,740,12,8,4
9,12,1082,43,22,21
9,12,429,12,6,6
9,12,1875,139,71,68
9,12,1989,16,7,9
9,12,1912,22,14,8
9,12,2090,36,20,16
9,12,457,14,9,5
9,12,1894,4,3,1
9,12,1809,17,5,12
9,12,1623,14,7,7
9,12,1688,37,17,20
9,12,1542,24,12,12
9,12,1641,32,16,16
9,12,1786,22,11,11
9,12,1764,4,2,2
9,12,2086,37,14,23
9,12,4577,42,23,19
9,12,2171,14,10,4
9,12,1816,12,5,7
9,12,1732,20,10,10
9,12,1753,73,39,34
9,12,1569,23,11,12
9,12,1754,49,26,23
9,12,1743,44,25,19
9,12,1125,4,2,2
9,12,1367,49,27,22
9,12,1886,16,8,8
9,12,1602,14,10,4
9,12,1247,17,7,10
9,12,2440,8,5,3
9,12,2248,59,26,33
9,12,2490,45,22,23
9,12,1579,4,2,2
9,12,3033,61,39,22
9,12,2293,90,54,36
9,12,2290,37,20,17
9,12,1609,23,13,10
9,12,1988,18,11,7
9,12,1578,35,19,16
9,12,1384,10,4,6
9,12,1711,16,5,11
9,12,1973,69,29,40
9,12,1599,11,8,3
9,12,2014,6,3,3
9,12,2177,21,10,11
9,12,1876,13,8,5
9,12,3324,28,15,13
9,12,2063,33,18,15
9,12,1429,35,15,20
9,12,2084,55,24,31
9,12,1677,56,29,27
9,12,1073,12,8,4
9,12,1761,18,10,8
9,12,655,9,5,4
9,12,545,13,5,8
9,12,1311,73,42,31
9,12,1129,52,24,28
9,12,2016,32,11,21
9,12,1277,25,13,12
9,12,1257,33,17,16
9,12,1545,25,12,13
9,12,1070,4,3,1
9,12,991,43,24,19
9,12,598,13,7,6
9,12,881,32,16,16
9,12,1289,27,16,11
9,12,1119,13,8,5
9,12,1146,39,19,20
9,12,824,26,16,10
9,12,742,3,2,1
9,12,1092,43,20,23
9,12,969,18,13,5
9,12,2455,6,2,4
9,12,3218,19,11,8
9,12,2589,55,25,30
9,12,2645,66,34,32
9,12,2454,134,52,82
9,12,1980,37,17,20
9,12,2835,447,242,205
9,12,2205,37,17,20
9,12,2434,38,21,17
9,12,2051,19,8,11
9,12,2157,26,11,15
9,12,2121,14,5,9
9,12,2410,165,81,84
9,12,1692,21,8,13
9,12,1984,16,9,7
9,12,2353,39,20,19
9,12,1996,17,10,7
9,12,2512,31,16,15
9,12,2297,28,14,14
9,12,2751,17,11,6
9,12,3237,14,6,8
9,12,2633,42,20,22
9,12,2190,140,63,77
9,12,2487,14,6,8
9,12,1868,43,19,24
9,12,2071,17,13,4
9,12,2041,10,4,6
9,12,1906,15,11,4
9,12,2205,10,2,8
9,12,1799,49,32,17
9,12,4641,185,100,85
9,12,22,0,0,0
9,12,0,0,0,0
9,12,1444,4,3,1
9,12,6282,47,30,17
9,12,1572,46,21,25
9,12,2249,16,5,11
9,12,1637,19,9,10
9,12,1196,23,15,8
9,12,700,25,7,18
9,12,128,6,2,4
9,12,264,15,11,4
9,12,307,8,3,5
9,12,895,28,14,14
9,12,1598,36,20,16
9,12,275,10,6,4
9,12,648,16,9,7
9,12,491,21,9,12
9,12,1175,32,14,18
9,12,1893,121,71,50
9,12,1538,54,24,30
9,12,4661,48,24,24
9,12,807,13,9,4
9,12,4447,119,62,57
9,12,1451,62,31,31
9,12,1534,2,0,2
9,12,1877,32,14,18
9,12,1175,1,0,1
9,12,1594,16,7,9
9,12,1664,0,0,0
9,12,1788,38,20,18
9,12,2478,71,34,37
9,12,1515,18,11,7
9,12,2073,45,31,14
9,12,2663,49,23,26
9,12,1010,20,9,11
9,12,6975,133,66,67
9,12,1877,32,17,15
9,12,2425,113,47,66
9,12,2655,9,5,4
9,12,2888,9,6,3
9,12,2664,111,59,52
9,12,2853,11,6,5
9,12,2498,26,20,6
9,12,6800,75,34,41
9,12,5799,168,90,78
9,12,2362,5,3,2
9,12,2345,10,5,5
9,12,2517,10,6,4
9,12,2016,59,32,27
9,12,5038,104,44,60
9,12,2014,141,77,64
9,12,2526,31,13,18
9,12,1991,23,10,13
9,12,1317,41,25,16
9,12,856,31,17,14
9,12,681,23,12,11
9,12,1046,35,18,17
9,12,1832,36,18,18
9,12,2943,23,8,15
9,12,3627,49,22,27
9,12,2312,118,57,61
9,12,2451,59,32,27
9,12,3318,22,13,9
9,12,6918,202,113,89
9,12,1349,14,7,7
9,12,6773,109,61,48
9,12,3654,40,20,20
9,12,2438,77,47,30
9,12,1721,22,10,12
9,12,4453,82,45,37
9,12,1997,59,27,32
9,12,2628,48,25,23
9,12,6344,69,37,32
9,12,5306,118,45,73
9,12,3515,39,17,22
9,12,4410,35,19,16
9,12,4737,80,39,41
9,12,1893,12,7,5
9,12,1268,57,32,25
9,12,1507,33,20,13
9,12,1635,5,2,3
9,12,1329,39,20,19
9,12,2883,23,11,12
9,12,2615,69,36,33
9,12,2509,19,10,9
9,12,5356,61,29,32
9,12,4548,12,5,7
9,12,7146,75,35,40
9,12,1410,4,2,2
9,12,5485,52,24,28
9,12,3927,24,13,11
9,12,3150,6,4,2
9,12,2659,58,25,33
9,12,1105,23,12,11
9,12,5600,35,18,17
9,12,13907,335,173,162
9,12,4210,68,37,31
9,12,1796,3,0,3
9,12,8972,56,30,26
9,12,6862,59,30,29
9,12,6863,60,35,25
9,12,8340,60,29,31
9,12,3217,25,13,12
9,12,3537,16,8,8
9,12,9420,132,56,76
9,12,7012,104,55,49
9,12,3407,143,65,78
9,12,3403,40,19,21
9,12,6175,122,61,61
9,12,917,16,9,7
9,12,932,5,2,3
9,12,723,6,4,2
9,12,1860,52,22,30
9,12,633,7,3,4
9,12,813,38,16,22
9,12,881,48,25,23
9,12,2427,22,6,16
9,12,946,6,4,2
9,12,898,2,1,1
9,12,1305,8,4,4
9,12,1821,22,14,8
9,12,1242,29,14,15
9,12,1212,32,21,11
9,12,2014,63,35,28
9,12,552,11,4,7
9,12,1437,65,32,33
9,12,931,19,6,13
9,12,1039,29,14,15
9,12,3015,51,23,28
9,12,1063,12,5,7
9,12,930,14,6,8
9,12,1760,43,24,19
9,12,817,3,3,0
9,12,1084,11,5,6
9,12,718,2,1,1
9,12,871,4,1,3
9,12,869,13,10,3
9,12,659,22,15,7
9,12,1349,38,20,18
9,12,1340,8,3,5
9,12,836,20,12,8
9,12,1424,8,5,3
9,12,816,6,4,2
9,12,903,3,2,1
9,12,1049,51,33,18
9,12,942,57,33,24
9,12,2025,35,17,18
9,12,2186,14,8,6
9,12,1673,8,3,5
9,12,1350,7,3,4
9,12,966,6,4,2
9,12,1051,1,1,0
9,12,938,4,3,1
9,12,1025,4,3,1
9,12,1020,7,4,3
9,12,775,3,0,3
9,12,974,2,1,1
9,12,910,3,2,1
9,12,819,5,3,2
9,12,793,13,5,8
9,12,969,8,6,2
9,12,572,5,3,2
9,12,765,17,7,10
9,12,1590,6,2,4
9,12,1544,15,5,10
9,12,1739,43,20,23
9,12,1425,23,6,17
9,12,1137,9,3,6
9,12,1273,7,3,4
9,12,1572,13,8,5
9,12,1182,54,31,23
9,12,1564,14,9,5
9,12,1918,46,28,18
9,12,801,9,2,7
9,12,874,7,6,1
9,12,731,3,2,1
9,12,776,1,1,0
9,12,730,3,1,2
9,12,865,10,5,5
9,12,1225,40,15,25
9,12,914,13,5,8
9,12,1024,48,29,19
9,12,1093,22,14,8
9,12,929,5,3,2
9,12,1043,3,2,1
9,12,1924,8,4,4
9,12,953,8,5,3
9,12,1553,9,3,6
9,12,1102,11,4,7
9,12,1520,7,2,5
9,12,1202,3,1,2
9,12,2056,25,12,13
9,12,1278,27,13,14
9,12,875,5,4,1
9,12,1279,16,9,7
9,12,1269,44,19,25
9,12,1002,1,1,0
9,12,1068,27,16,11
9,12,1723,25,10,15
9,12,443,8,5,3
9,12,1405,23,14,9
9,12,1644,35,19,16
9,12,1409,51,25,26
9,12,668,4,0,4
9,12,1357,38,25,13
9,12,2350,12,8,4
9,12,968,6,1,5
9,12,304,2,1,1
9,12,730,16,6,10
9,13,1766,70,37,33
9,13,1790,27,12,15
9,13,1141,29,12,17
9,13,1262,24,12,12
9,13,722,5,2,3
9,13,941,24,9,15
9,13,1075,26,12,14
9,13,2130,26,18,8
9,13,3107,33,12,21
9,13,3941,23,14,9
9,13,3825,28,14,14
9,13,10450,256,130,126
9,13,2534,10,4,6
9,13,3569,41,21,20
9,13,2541,22,9,13
9,13,1654,16,8,8
9,13,1197,18,8,10
9,13,1439,8,3,5
9,13,1220,22,13,9
9,13,1577,15,7,8
9,13,1839,18,8,10
9,13,1217,6,2,4
9,13,1186,10,4,6
9,13,5735,76,33,43
9,13,2908,46,19,27
9,13,1755,20,6,14
9,13,1440,28,14,14
9,13,1690,27,15,12
9,13,1479,56,30,26
9,13,1801,76,34,42
9,13,1517,77,41,36
9,13,1717,71,38,33
9,13,824,22,8,14
9,13,2415,31,14,17
9,13,1328,12,7,5
9,13,1388,35,18,17
9,13,1318,41,19,22
9,13,989,9,3,6
9,13,1239,68,33,35
9,13,795,20,11,9
9,13,1152,19,9,10
9,13,1156,14,10,4
9,13,1677,9,2,7
9,13,1411,21,11,10
9,13,1286,11,5,6
9,13,1708,53,27,26
9,13,1465,76,36,40
9,13,1956,329,166,163
9,13,2339,36,17,19
9,13,5054,677,320,357
9,13,4814,268,121,147
9,13,2162,37,18,19
9,13,1159,8,4,4
9,13,3188,42,21,21
9,13,2310,34,22,12
9,13,2297,2,0,2
9,13,4185,65,33,32
9,13,2471,49,26,23
9,11,1455,26,12,14
9,11,996,0,0,0
9,11,1554,20,10,10
9,11,1589,25,14,11
9,13,1240,16,8,8
9,13,1350,21,11,10
9,13,2156,58,32,26
9,13,1707,41,20,21
9,13,3454,105,54,51
9,13,1474,42,24,18
9,13,369,13,6,7
9,13,1039,1,1,0
9,13,7709,142,74,68
9,13,1664,50,19,31
9,13,5637,108,61,47
9,13,3672,24,12,12
9,13,3154,24,17,7
9,13,7244,89,43,46
9,13,4171,24,10,14
9,13,3052,8,5,3
9,13,3266,9,5,4
9,13,1512,5,3,2
9,13,1565,3,0,3
9,13,1453,3,2,1
9,13,2950,10,4,6
9,13,4201,44,20,24
9,13,1778,0,0,0
9,13,2328,82,44,38
9,13,2493,32,15,17
9,13,3838,69,36,33
9,13,6826,184,94,90
9,13,3710,54,33,21
9,13,2416,97,49,48
9,13,1457,35,23,12
9,13,1147,21,9,12
9,13,1403,3,1,2
9,13,1108,2,1,1
9,13,1180,14,7,7
9,13,1744,15,8,7
9,13,1550,29,11,18
9,13,1650,34,17,17
9,13,862,9,4,5
9,13,1009,4,3,1
9,13,1311,11,5,6
9,13,1282,9,7,2
9,13,1219,2,1,1
9,13,7125,143,78,65
9,13,2264,10,5,5
9,13,5646,72,33,39
9,13,768,13,5,8
9,13,848,23,15,8
9,13,1036,24,13,11
9,13,1157,30,14,16
9,13,1161,19,10,9
9,13,1141,8,4,4
9,13,1337,20,11,9
9,13,1584,12,3,9
9,13,1342,47,21,26
9,13,1068,9,6,3
9,13,910,5,1,4
9,13,1750,37,20,17
9,13,1427,6,1,5
9,13,1458,22,10,12
9,13,1854,24,13,11
9,13,1760,50,21,29
9,13,2191,124,61,63
9,13,2954,19,12,7
9,13,1495,25,13,12
9,13,1601,20,11,9
9,13,2254,6,2,4
9,13,5596,257,118,139
9,13,8488,379,195,184
9,13,5640,106,54,52
9,13,3080,104,48,56
9,13,2104,754,373,381
9,13,3528,45,27,18
9,13,3416,64,29,35
9,13,1719,25,14,11
9,13,1639,25,11,14
9,13,1366,108,58,50
9,13,1011,81,44,37
9,13,2853,112,57,55
9,13,4017,95,40,55
9,13,1738,0,0,0
9,13,6500,54,29,25
9,13,3706,79,43,36
9,13,2572,14,6,8
9,13,1010,10,5,5
9,13,2026,36,19,17
9,13,1093,71,38,33
9,13,964,7,4,3
9,13,2969,39,14,25
9,13,4394,101,54,47
9,13,16657,255,116,139
9,13,2463,23,13,10
9,13,3302,49,26,23
9,13,2484,7,3,4
9,13,3057,31,12,19
9,13,7294,91,43,48
9,13,3288,8,5,3
9,13,2419,25,16,9
9,13,2902,13,7,6
9,13,4809,62,30,32
9,13,2130,41,19,22
9,13,1863,35,15,20
9,13,2773,67,30,37
9,13,4648,31,15,16
9,13,10700,573,277,296
9,13,3388,76,36,40
9,13,3939,95,47,48
9,13,3927,55,25,30
9,13,6164,129,63,66
9,13,4422,74,38,36
9,13,3878,103,48,55
9,13,1321,74,40,34
9,13,961,48,21,27
9,14,1946,32,16,16
9,14,1214,20,8,12
9,14,1450,43,22,21
9,14,1695,12,5,7
9,14,1681,51,26,25
9,14,1502,70,37,33
9,14,1262,47,23,24
9,14,1264,58,28,30
9,14,1847,68,31,37
9,14,1592,51,27,24
9,14,1276,54,29,25
9,14,1857,44,24,20
9,14,1730,66,31,35
9,14,1375,34,18,16
9,14,1702,28,16,12
9,14,2579,62,35,27
9,14,2346,38,19,19
9,14,1999,28,11,17
9,14,1603,67,35,32
9,14,1993,126,67,59
9,14,1402,50,25,25
9,14,2080,74,33,41
9,14,2255,54,25,29
9,14,1114,42,19,23
9,14,1003,33,18,15
9,14,856,35,17,18
9,14,1070,20,10,10
9,14,1600,41,21,20
9,14,1448,63,30,33
9,14,957,14,8,6
9,14,1517,53,21,32
9,14,2089,36,16,20
9,14,2106,63,29,34
9,14,1642,15,8,7
9,14,1396,45,19,26
9,14,1172,6,5,1
9,14,1686,29,14,15
9,14,1557,64,32,32
9,14,1580,28,13,15
9,14,1640,33,16,17
9,14,1734,55,30,25
9,14,1332,24,14,10
9,14,1779,49,28,21
9,14,1059,45,22,23
9,14,1066,12,7,5
9,14,1459,115,55,60
9,14,1443,207,117,90
9,14,1968,84,44,40
9,14,965,21,10,11
9,14,1801,38,19,19
9,14,2308,46,21,25
9,14,1843,496,284,212
9,14,2132,65,32,33
9,14,1600,179,94,85
9,14,1629,18,7,11
9,14,1538,12,10,2
9,14,1503,43,22,21
9,14,781,10,5,5
9,14,5060,183,88,95
9,14,1090,13,8,5
9,14,1355,41,23,18
9,14,651,29,16,13
9,14,1486,32,14,18
9,14,867,24,15,9
9,14,1303,18,7,11
9,14,1476,48,29,19
9,14,1800,59,32,27
9,14,2390,75,38,37
9,14,1218,24,15,9
9,14,1638,14,7,7
9,14,1404,41,19,22
9,14,1421,31,18,13
9,14,1842,72,33,39
9,14,1422,25,10,15
9,14,1194,23,11,12
9,14,1957,38,20,18
9,14,2037,73,44,29
9,14,1438,120,68,52
9,14,2138,20,10,10
9,14,1518,29,16,13
9,14,1286,16,8,8
9,14,1660,43,28,15
9,14,753,29,14,15
9,14,1850,82,43,39
9,14,1433,33,19,14
9,14,1699,43,23,20
9,14,1639,30,15,15
9,14,1805,57,25,32
9,14,2437,122,74,48
9,14,1582,71,34,37
9,14,2189,39,20,19
9,14,2736,90,42,48
9,14,2194,62,37,25
9,14,1940,52,23,29
9,14,1585,36,19,17
9,14,1493,28,10,18
9,14,2125,26,13,13
9,14,2115,23,13,10
9,14,1747,37,23,14
9,14,1444,15,4,11
9,14,1437,12,6,6
9,14,1918,19,11,8
9,14,1444,16,8,8
9,14,1454,5,2,3
9,14,1898,38,20,18
9,14,2055,33,16,17
9,14,1966,48,29,19
9,14,1503,44,24,20
9,14,1919,80,42,38
9,14,1566,101,57,44
9,14,2011,168,82,86
9,14,1907,57,23,34
9,14,2094,26,18,8
9,14,1771,46,24,22
9,14,1642,25,14,11
9,14,1323,31,17,14
9,14,1321,27,16,11
9,14,1837,40,16,24
9,14,1656,21,7,14
9,14,2399,52,23,29
9,14,1877,43,25,18
9,14,1334,26,12,14
9,14,1751,11,5,6
9,14,1471,50,25,25
9,14,1237,22,15,7
9,14,1703,30,17,13
9,14,1188,8,7,1
9,14,1588,41,16,25
9,14,1399,51,24,27
9,14,1541,77,43,34
9,14,2176,40,19,21
9,14,671,11,5,6
9,14,2713,81,36,45
9,14,1144,34,15,19
9,14,886,5,3,2
9,14,2984,56,34,22
9,14,2354,50,26,24
9,14,1335,44,21,23
9,14,572,49,26,23
9,14,1519,41,18,23
9,14,2694,84,40,44
9,14,3752,202,98,104
9,14,2219,55,24,31
9,14,2285,82,46,36
9,14,1578,64,32,32
9,14,2112,71,41,30
9,14,1548,66,38,28
9,14,1405,62,36,26
9,14,2267,82,42,40
9,14,1604,31,15,16
9,14,2182,60,27,33
9,14,3030,116,58,58
9,14,2150,51,33,18
9,14,2196,35,17,18
9,14,1152,30,12,18
9,14,1599,38,20,18
9,14,1446,50,25,25
9,14,940,24,15,9
9,14,1899,83,45,38
9,14,2118,26,11,15
9,14,1990,111,62,49
9,14,1754,25,10,15
9,14,2119,63,34,29
9,14,1693,38,19,19
9,14,1629,26,12,14
9,14,1873,37,17,20
9,14,1515,12,5,7
9,14,1381,15,10,5
9,14,1466,31,16,15
9,14,806,22,12,10
9,14,1254,33,18,15
9,14,1540,90,46,44
9,14,1253,69,36,33
9,14,1220,38,18,20
9,14,1269,42,20,22
9,14,1520,55,24,31
9,14,870,11,8,3
9,14,3191,42,23,19
9,14,1970,27,12,15
9,14,2945,51,30,21
9,14,2060,32,14,18
9,14,1287,41,14,27
9,14,1298,36,23,13
9,14,1978,39,18,21
9,14,1720,69,43,26
9,14,2308,199,110,89
9,14,1013,14,7,7
9,14,1379,23,13,10
9,14,1611,44,24,20
9,14,1696,39,23,16
9,14,952,12,5,7
9,14,1704,23,13,10
9,14,1327,8,1,7
9,14,1333,22,9,13
9,14,2013,91,50,41
9,14,2337,51,28,23
9,14,1374,22,9,13
9,14,2365,39,21,18
9,14,934,23,12,11
9,14,2162,28,16,12
9,14,1167,27,19,8
9,14,1491,26,13,13
9,14,2047,41,25,16
9,14,2705,81,47,34
9,14,1552,31,11,20
9,14,810,9,6,3
9,14,2959,32,14,18
9,14,3543,54,31,23
9,14,2043,27,14,13
9,14,1255,10,4,6
9,14,1511,19,13,6
9,14,1206,28,14,14
9,14,1205,39,20,19
9,14,1950,60,23,37
9,14,1465,48,25,23
9,14,2011,29,13,16
9,14,1515,8,3,5
9,14,1655,33,16,17
9,14,1316,35,17,18
9,14,1925,95,49,46
9,14,2371,32,13,19
9,14,2648,28,9,19
9,14,1560,43,23,20
9,14,1912,14,5,9
9,14,2301,68,36,32
9,14,1433,23,14,9
9,14,2591,48,18,30
9,14,1377,26,10,16
9,14,539,31,17,14
9,14,1638,50,27,23
9,14,1556,46,24,22
9,14,2401,21,9,12
9,14,2065,19,8,11
9,14,2112,145,80,65
9,14,1793,33,15,18
9,14,1707,78,43,35
9,14,1534,47,26,21
9,14,2134,44,24,20
9,14,3150,76,40,36
9,14,2417,44,24,20
9,14,954,18,11,7
9,14,1726,31,12,19
9,14,2390,213,102,111
9,14,2409,104,48,56
9,14,1237,24,14,10
9,14,2090,47,27,20
9,14,924,10,6,4
9,14,1307,40,23,17
9,14,694,29,17,12
9,14,750,38,16,22
9,14,3726,95,49,46
9,14,1141,17,9,8
9,14,1428,30,16,14
9,14,1518,35,16,19
9,15,1017,14,7,7
9,15,1154,21,12,9
9,15,1566,29,16,13
9,15,740,7,4,3
9,15,1498,42,23,19
9,15,1033,20,4,16
9,15,1107,24,7,17
9,15,887,58,31,27
9,15,836,36,17,19
9,15,1709,65,36,29
9,15,1707,30,13,17
9,15,727,8,4,4
9,15,1105,26,14,12
9,15,687,8,4,4
9,15,447,12,7,5
9,15,1135,9,3,6
9,15,988,24,13,11
9,15,1379,88,47,41
9,15,1130,42,22,20
9,15,1067,37,18,19
9,15,2127,38,21,17
9,15,1141,45,22,23
9,15,1004,69,23,46
9,15,858,14,5,9
9,15,883,39,15,24
9,15,705,23,10,13
9,15,618,32,21,11
9,15,923,10,7,3
9,15,1299,32,13,19
9,15,1040,25,10,15
9,15,656,35,16,19
9,15,1156,40,15,25
9,15,1411,43,22,21
9,15,1392,30,15,15
9,15,1028,23,10,13
9,15,1359,26,15,11
9,15,954,20,9,11
9,15,1279,102,60,42
9,15,705,14,3,11
9,15,466,4,1,3
9,15,945,11,3,8
9,15,1138,27,14,13
9,15,717,29,18,11
9,15,1026,13,6,7
9,15,664,2,1,1
9,15,1085,25,14,11
9,15,689,11,2,9
9,15,1156,33,18,15
9,15,502,16,10,6
9,15,1008,16,3,13
9,15,1490,41,21,20
9,15,1183,43,16,27
9,15,1226,38,13,25
9,15,1230,38,17,21
9,15,1728,33,16,17
9,15,1571,58,31,27
9,15,1357,19,12,7
9,15,1462,18,8,10
9,15,990,17,10,7
9,15,1346,34,15,19
9,15,1477,39,16,23
9,15,765,15,10,5
9,15,1325,19,11,8
9,15,2652,67,35,32
9,15,1093,8,4,4
9,15,1327,45,25,20
9,15,1825,80,45,35
9,15,1694,31,13,18
9,15,2587,120,55,65
9,15,524,22,10,12
9,15,1598,18,10,8
9,15,1259,14,6,8
9,15,1504,25,12,13
9,15,1209,17,11,6
9,15,1511,45,21,24
9,15,1127,29,13,16
9,15,1127,30,15,15
9,15,3245,164,86,78
9,15,1033,27,17,10
9,15,1186,24,11,13
9,15,949,8,3,5
9,15,1278,45,24,21
9,15,5516,115,60,55
9,15,2695,39,19,20
9,15,1944,49,28,21
9,15,1874,39,20,19
9,15,2314,94,54,40
9,15,1428,75,44,31
9,15,1474,41,21,20
9,15,1854,61,31,30
9,15,1780,67,34,33
9,15,1776,36,22,14
9,15,1201,13,6,7
9,15,1508,5,3,2
9,15,2129,19,12,7
9,15,2053,35,21,14
9,15,1312,50,29,21
9,15,1488,15,7,8
9,15,1998,43,21,22
9,15,2059,116,62,54
9,15,1421,36,19,17
9,15,1049,118,63,55
9,15,2226,72,31,41
9,15,1986,62,33,29
9,15,2037,208,118,90
9,15,1153,49,27,22
9,15,1153,7,6,1
9,15,548,13,9,4
9,15,1738,2,1,1
9,15,1628,52,28,24
9,15,2060,20,12,8
9,15,2145,113,68,45
9,15,1634,41,19,22
9,15,1874,64,34,30
9,15,1843,42,18,24
9,15,928,3,3,0
9,15,1681,74,41,33
9,15,1232,8,5,3
9,15,1078,56,33,23
9,15,1308,28,15,13
9,15,1855,96,45,51
9,15,1746,23,6,17
9,15,1204,7,3,4
9,15,1446,42,23,19
9,15,2211,92,45,47
9,15,1124,10,6,4
9,15,1138,8,4,4
9,15,614,2,2,0
9,15,699,13,7,6
9,15,543,3,0,3
9,15,607,2,0,2
9,15,1881,20,9,11
9,15,1907,9,5,4
9,15,1963,88,49,39
9,15,1444,12,6,6
9,15,2019,47,22,25
9,15,1387,9,5,4
9,15,1197,27,13,14
9,15,1558,26,17,9
9,15,3342,157,84,73
9,15,1546,10,7,3
9,15,1544,9,2,7
9,15,1125,14,6,8
9,15,1452,21,12,9
9,15,3056,32,17,15
9,15,2480,61,34,27
9,15,2138,69,37,32
9,15,678,43,24,19
9,15,1241,40,21,19
9,15,1509,15,9,6
9,15,1128,33,15,18
9,15,664,8,5,3
9,15,691,9,4,5
9,15,853,8,4,4
9,15,1459,21,13,8
9,15,517,23,15,8
9,15,1200,29,15,14
9,15,2033,39,18,21
9,15,427,2,0,2
9,15,1387,8,4,4
9,15,1962,35,18,17
9,15,1939,25,11,14
9,15,1812,22,10,12
9,15,1872,165,86,79
9,15,2169,47,25,22
9,15,1110,9,5,4
9,15,2366,24,12,12
9,15,2956,47,29,18
9,15,1487,83,47,36
9,15,1201,45,27,18
9,15,1254,26,15,11
9,15,1609,15,8,7
9,15,1503,18,8,10
9,15,1858,14,9,5
9,15,1387,42,21,21
9,15,1778,262,125,137
9,15,1783,210,111,99
9,15,2622,127,66,61
9,15,1028,12,8,4
9,15,2334,111,48,63
9,15,1547,58,22,36
9,15,1161,25,14,11
9,15,939,3,2,1
9,15,571,4,2,2
9,15,492,42,17,25
9,15,2867,662,336,326
9,15,1912,73,40,33
9,15,1696,121,66,55
9,15,1741,8,2,6
9,15,846,17,11,6
9,15,683,4,1,3
9,15,1842,32,13,19
9,15,549,7,5,2
9,15,799,6,4,2
9,15,1599,32,16,16
9,15,621,4,3,1
9,15,1442,40,20,20
9,15,854,16,8,8
9,15,854,12,8,4
9,15,1014,14,7,7
9,15,1004,11,7,4
9,15,3313,39,24,15
9,15,1020,1,1,0
9,15,709,14,6,8
9,15,1059,33,17,16
9,15,984,2,1,1
9,15,1043,41,24,17
9,15,839,19,9,10
9,15,1137,7,4,3
9,15,1181,16,9,7
9,15,968,18,11,7
9,15,1593,4,1,3
9,15,1184,54,32,22
9,15,1279,9,5,4
9,15,916,8,3,5
9,15,1675,16,6,10
9,15,1096,12,7,5
9,15,790,10,6,4
9,15,478,2,1,1
9,15,550,13,6,7
9,15,1022,14,5,9
9,15,612,8,5,3
9,15,760,14,11,3
9,15,632,11,8,3
9,15,372,20,10,10
9,15,816,44,19,25
9,15,561,18,8,10
9,15,731,42,27,15
9,15,1408,41,20,21
9,15,1231,51,19,32
9,15,1422,38,17,21
9,15,2244,45,18,27
9,15,901,144,72,72
9,15,877,17,9,8
9,15,1839,37,16,21
9,15,692,7,3,4
9,15,913,4,1,3
9,15,1406,9,2,7
9,15,2200,41,18,23
9,15,1965,19,8,11
9,15,2420,115,68,47
9,15,1349,14,8,6
9,15,1467,28,11,17
9,15,1237,24,11,13
9,15,1585,41,22,19
9,15,2200,46,18,28
9,15,2335,25,15,10
9,15,3355,77,45,32
9,15,2370,30,17,13
9,15,2350,85,54,31
9,15,1347,21,11,10
9,15,2442,68,31,37
9,15,1439,21,10,11
9,15,1547,20,8,12
9,15,1138,26,13,13
9,15,1655,33,14,19
9,15,1101,25,10,15
9,15,2166,52,22,30
9,15,1918,16,6,10
9,15,1288,4,3,1
9,15,1336,11,4,7
9,15,1956,19,6,13
9,15,1203,23,11,12
9,15,1521,17,9,8
9,15,1940,26,10,16
9,15,872,13,9,4
9,15,2418,122,74,48
9,15,1183,9,5,4
9,15,1313,23,10,13
9,15,1245,3,2,1
9,15,1076,14,10,4
9,15,1123,4,1,3
9,15,1704,21,14,7
9,15,3128,47,28,19
9,15,2075,67,40,27
9,15,2628,47,25,22
9,15,1229,14,7,7
9,15,1398,19,7,12
9,15,1571,26,11,15
9,15,925,6,4,2
9,15,1056,42,21,21
9,15,1030,42,22,20
9,15,924,15,7,8
9,15,1265,12,3,9
9,15,1831,90,44,46
9,15,869,51,28,23
9,15,1780,17,9,8
9,15,1460,102,50,52
9,15,1910,29,13,16
9,15,1137,10,4,6
9,15,1563,37,23,14
9,15,669,11,5,6
9,15,567,5,2,3
9,15,723,2,1,1
9,15,850,5,2,3
9,15,1897,19,12,7
9,15,3686,93,52,41
9,15,2419,42,16,26
9,15,2318,60,30,30
9,15,2857,74,40,34
9,15,1475,227,113,114
9,15,1317,24,7,17
9,15,1136,13,7,6
9,15,2436,38,20,18
9,15,2029,41,20,21
9,15,1199,254,130,124
9,15,884,1,0,1
9,15,2054,28,17,11
9,15,1322,57,29,28
9,15,2507,148,76,72
9,15,1239,29,17,12
9,15,1371,94,46,48
9,15,1067,38,22,16
9,15,927,23,8,15
9,15,1075,81,38,43
9,15,606,6,2,4
9,15,846,12,8,4
9,15,729,10,5,5
9,15,1132,16,4,12
9,15,1120,29,12,17
9,15,466,9,5,4
9,15,907,15,12,3
9,15,946,6,3,3
9,15,1109,21,16,5
9,15,695,19,10,9
9,15,1855,41,22,19
9,15,578,15,6,9
9,15,3865,115,58,57
9,15,1114,24,13,11
9,15,1358,53,21,32
9,15,1256,50,32,18
9,15,1014,19,8,11
9,15,1426,6,2,4
9,15,2084,80,41,39
9,15,2024,91,49,42
9,15,1890,27,11,16
9,15,1394,30,16,14
9,15,1551,71,43,28
9,15,1475,23,13,10
9,15,2128,73,36,37
9,15,1235,51,27,24
9,15,1168,35,17,18
9,15,1004,44,21,23
9,15,2484,74,34,40
9,15,1176,37,19,18
9,15,1009,28,11,17
9,15,1728,22,8,14
9,15,1169,67,25,42
9,15,1169,69,31,38
9,15,1182,40,21,19
9,15,701,16,9,7
9,15,1028,15,10,5
9,15,1314,41,22,19
9,15,1053,16,3,13
9,15,941,34,20,14
9,15,1079,21,11,10
9,15,1147,38,13,25
9,15,804,14,8,6
9,15,1183,50,29,21
9,15,502,22,12,10
9,15,473,9,2,7
9,15,724,9,6,3
9,15,873,22,11,11
9,15,684,16,9,7
9,15,331,15,6,9
9,15,611,16,10,6
9,15,875,9,4,5
9,15,944,17,6,11
9,15,3829,78,36,42
9,15,5265,79,43,36
9,15,2743,68,38,30
9,15,1998,48,26,22
9,15,1543,15,11,4
9,15,1038,17,11,6
9,15,1693,31,15,16
9,15,1100,17,10,7
9,15,1044,14,4,10
9,15,1149,17,5,12
9,15,890,10,2,8
9,15,1065,10,5,5
9,15,1076,48,26,22
9,15,1386,14,6,8
9,15,1205,34,17,17
9,15,1466,10,2,8
9,15,1609,22,9,13
9,15,1780,19,12,7
9,15,735,3,2,1
9,15,1164,32,16,16
9,15,1195,13,5,8
9,16,1405,16,13,3
9,16,1237,16,8,8
9,16,1456,6,2,4
9,16,991,17,7,10
9,16,636,15,8,7
9,16,2059,35,16,19
9,16,993,15,4,11
9,16,1162,9,6,3
9,16,1596,74,37,37
9,16,3362,61,28,33
9,16,2242,38,18,20
9,16,1295,26,18,8
9,16,1003,55,35,20
9,16,946,27,19,8
9,16,965,38,17,21
9,16,670,17,7,10
9,16,672,6,2,4
9,16,827,9,5,4
9,16,417,1,0,1
9,16,994,8,4,4
9,16,1111,19,8,11
9,16,2064,42,22,20
9,16,1309,7,2,5
9,16,648,6,3,3
9,16,1008,14,8,6
9,16,1112,31,20,11
9,16,1377,13,8,5
9,16,867,3,2,1
9,16,840,59,33,26
9,16,901,5,2,3
9,16,767,57,29,28
9,16,917,87,22,65
9,16,1252,49,16,33
9,16,1146,9,4,5
9,16,1229,13,7,6
9,16,521,3,3,0
9,16,1210,9,5,4
9,16,847,4,4,0
9,16,1511,68,35,33
9,16,1424,18,8,10
9,16,1296,42,22,20
9,16,1602,24,14,10
9,16,1005,37,25,12
9,16,1388,19,11,8
9,16,1211,47,22,25
9,16,1409,18,12,6
9,16,1562,27,11,16
9,16,1314,5,2,3
9,16,1125,10,2,8
9,16,1907,4,4,0
9,16,1380,20,12,8
9,16,1178,8,4,4
9,16,1296,2,1,1
9,16,1129,5,2,3
9,16,741,2,2,0
9,16,1704,16,8,8
9,16,1725,9,4,5
9,16,4062,14,4,10
9,16,1630,7,5,2
9,16,1358,10,6,4
9,16,1132,3,2,1
9,16,1387,20,8,12
9,16,1697,35,21,14
9,16,1213,34,14,20
9,16,1157,13,5,8
9,16,1131,22,9,13
9,16,1184,37,20,17
9,16,462,12,5,7
9,16,518,97,63,34
9,16,664,12,6,6
9,16,682,0,0,0
9,16,540,9,4,5
9,16,1294,16,7,9
9,16,378,5,1,4
9,16,766,8,3,5
9,16,0,0,0,0
9,16,21,0,0,0
9,16,3314,62,26,36
9,16,1534,45,11,34
9,16,674,7,3,4
9,16,1189,6,6,0
9,16,647,5,3,2
9,16,1167,558,289,269
9,16,1440,86,45,41
9,16,2312,99,48,51
9,16,689,34,19,15
9,16,1626,64,36,28
9,16,1539,71,33,38
9,16,2350,56,23,33
9,16,1147,82,48,34
9,16,2139,87,49,38
9,16,1307,70,33,37
9,16,1977,66,39,27
9,16,1634,21,11,10
9,16,1607,21,8,13
9,16,652,33,16,17
9,16,650,16,8,8
9,16,1111,38,22,16
9,16,1420,55,27,28
9,16,1422,17,8,9
9,16,955,10,4,6
9,16,1992,44,18,26
9,16,1802,39,21,18
9,16,918,27,19,8
9,16,1530,23,12,11
9,16,2852,91,59,32
9,16,2098,55,33,22
9,16,2405,30,20,10
9,16,1595,20,13,7
9,16,1497,32,20,12
9,16,1436,29,15,14
9,16,877,29,10,19
9,16,1775,24,15,9
9,16,1321,21,11,10
9,16,1376,24,13,11
9,16,1614,15,3,12
9,16,770,17,9,8
9,16,1236,14,4,10
9,16,1543,49,25,24
9,16,1675,87,49,38
9,16,2562,110,59,51
9,16,2486,20,8,12
9,16,1898,33,13,20
9,16,1906,22,10,12
9,16,1136,14,5,9
9,16,1661,22,10,12
9,16,1836,60,31,29
9,16,2271,54,22,32
9,16,2600,61,31,30
9,16,1924,36,16,20
9,16,2155,45,24,21
9,16,994,12,5,7
9,16,1278,6,1,5
9,16,1377,86,43,43
9,16,1507,47,23,24
9,16,1915,166,92,74
9,16,1652,13,10,3
9,16,1550,17,9,8
9,16,1159,6,3,3
9,16,1754,11,6,5
9,16,1848,94,49,45
9,16,1161,5,2,3
9,16,2507,22,12,10
9,16,1774,36,23,13
9,16,2604,20,12,8
9,16,1648,14,9,5
9,16,2058,36,17,19
9,16,1642,20,7,13
9,16,1902,35,17,18
9,16,1652,43,25,18
9,16,1419,19,9,10
9,16,915,36,23,13
9,16,1409,4,1,3
9,16,1273,19,6,13
9,16,1585,18,10,8
9,16,2221,8,6,2
9,16,1978,11,7,4
9,16,1460,11,5,6
9,16,1158,17,8,9
9,16,1255,15,6,9
9,16,1012,20,13,7
9,16,1275,82,45,37
9,16,1088,85,47,38
9,16,2483,22,12,10
9,16,928,12,3,9
9,16,882,144,83,61
9,16,1418,51,29,22
9,16,1082,21,10,11
9,16,750,39,21,18
9,16,886,61,36,25
9,16,837,24,13,11
9,16,818,58,30,28
9,16,958,5,3,2
9,16,817,11,7,4
9,16,896,22,11,11
9,16,906,10,5,5
9,16,715,2,1,1
9,16,543,4,3,1
9,16,1407,15,6,9
9,16,440,0,0,0
9,16,856,22,12,10
9,16,9498,233,113,120
9,16,1746,27,15,12
9,16,2049,43,23,20
9,16,4282,104,46,58
9,16,1295,34,18,16
9,16,1824,31,17,14
9,16,1241,93,43,50
9,16,762,5,1,4
9,16,1542,15,8,7
9,16,1167,8,3,5
9,16,1308,19,10,9
9,16,473,48,22,26
9,16,350,3,2,1
9,16,2471,82,40,42
9,16,2146,39,19,20
9,16,1408,94,56,38
9,16,2497,61,33,28
9,16,2921,81,31,50
9,16,1258,35,24,11
9,16,3552,116,58,58
9,16,1731,115,52,63
9,16,1123,34,18,16
9,16,1348,66,35,31
9,16,1426,321,172,149
9,16,1349,19,9,10
9,16,1398,1,1,0
9,16,1666,23,8,15
9,16,1372,12,4,8
9,16,1361,43,23,20
9,16,1234,175,99,76
9,16,1430,105,63,42
9,16,1138,321,172,149
9,16,1380,44,22,22
9,16,986,16,7,9
9,16,3289,67,33,34
9,16,2457,83,46,37
9,16,1561,50,23,27
9,16,2119,27,17,10
9,16,1657,22,11,11
9,16,2533,225,116,109
9,16,3390,144,80,64
9,16,2034,101,57,44
9,16,11279,175,110,65
9,16,1291,5,1,4
9,16,1070,5,1,4
9,16,1728,19,7,12
9,16,1354,18,7,11
9,16,2255,98,51,47
9,16,1623,10,4,6
9,16,1512,20,13,7
9,16,1287,46,19,27
9,16,5226,209,112,97
9,16,8352,404,214,190
9,16,17540,269,133,136
9,16,3548,38,17,21
9,16,1461,37,18,19
9,16,1945,93,44,49
9,16,1899,47,34,13
9,16,2028,23,11,12
9,16,799,24,8,16
9,16,945,31,17,14
9,16,1028,19,11,8
9,16,1117,15,8,7
9,16,1095,49,26,23
9,16,1042,34,16,18
9,16,937,16,8,8
9,16,1065,17,9,8
9,16,1158,26,17,9
9,16,1198,18,8,10
9,16,881,7,3,4
9,16,938,29,13,16
9,16,824,21,9,12
9,16,679,158,64,94
9,16,956,32,11,21
9,16,1212,32,14,18
9,16,1021,7,6,1
9,16,1624,21,9,12
9,16,1788,6,1,5
9,16,796,31,13,18
9,17,1780,51,22,29
9,17,1372,28,12,16
9,17,1221,18,10,8
9,17,1469,78,34,44
9,17,1549,18,7,11
9,17,300,21,12,9
9,17,2358,60,31,29
9,17,2841,125,63,62
9,17,1654,42,20,22
9,17,5740,209,103,106
9,17,985,14,6,8
9,17,698,9,3,6
9,17,1164,12,7,5
9,17,1306,9,4,5
9,17,2481,61,32,29
9,17,914,15,9,6
9,17,1609,14,6,8
9,17,1335,9,5,4
9,17,1221,15,6,9
9,17,1602,12,7,5
9,17,624,1,0,1
9,17,1249,26,12,14
9,17,1029,36,14,22
9,17,805,46,23,23
9,17,824,124,63,61
9,17,1013,9,7,2
9,17,2444,31,15,16
9,17,1705,26,16,10
9,17,1137,10,2,8
9,17,823,13,7,6
9,17,1536,13,6,7
9,17,676,2,2,0
9,17,1095,35,21,14
9,17,1148,23,14,9
9,17,1340,21,7,14
9,17,1312,15,6,9
9,17,1544,24,13,11
9,17,1192,10,5,5
9,17,1305,4,1,3
9,17,694,2,1,1
9,17,1354,102,51,51
9,17,2435,246,127,119
9,17,2339,13,10,3
9,17,2222,16,4,12
9,17,1491,30,14,16
9,17,1412,26,14,12
9,17,2243,169,78,91
9,17,1650,60,25,35
9,17,1331,57,28,29
9,17,1660,31,13,18
9,17,1686,58,31,27
9,17,1571,80,39,41
9,17,945,1,0,1
9,17,1266,11,5,6
9,17,1300,16,10,6
9,17,1052,11,4,7
9,17,904,20,6,14
9,17,667,18,8,10
9,17,1041,4,3,1
9,17,714,2,2,0
9,17,1464,12,2,10
9,17,649,0,0,0
9,17,929,14,10,4
9,17,1002,4,1,3
9,17,1318,13,9,4
9,17,2554,59,31,28
9,17,1586,20,10,10
9,17,1468,11,8,3
9,17,1615,11,6,5
9,17,866,28,17,11
9,17,1952,10,8,2
9,17,1348,18,9,9
9,17,1242,2,1,1
9,17,1368,7,1,6
9,17,1420,74,45,29
9,17,1168,8,6,2
9,17,1397,3,1,2
9,17,1510,11,4,7
9,17,687,20,6,14
9,17,1093,14,9,5
9,17,1436,12,10,2
9,17,712,29,11,18
9,17,719,7,4,3
9,17,867,6,4,2
9,17,1159,10,6,4
9,17,1643,35,16,19
9,17,1637,11,8,3
9,17,1517,8,3,5
9,17,660,31,19,12
9,17,1172,7,3,4
9,17,1033,6,4,2
9,17,1170,2,2,0
9,17,1535,15,7,8
9,17,2333,59,29,30
9,17,1529,14,9,5
9,17,1588,17,9,8
9,17,1031,17,8,9
9,17,1304,20,7,13
9,17,1159,55,29,26
9,17,575,5,1,4
9,17,1000,2,1,1
9,17,1387,18,10,8
9,17,789,5,4,1
9,17,1112,10,6,4
9,17,1378,3,3,0
9,17,1255,4,0,4
9,17,1339,26,16,10
9,17,3864,86,36,50
9,17,1593,76,39,37
9,17,2609,23,11,12
9,17,1531,56,25,31
9,17,1557,19,7,12
9,17,1228,23,14,9
9,17,991,15,6,9
9,17,1399,1,1,0
9,17,1047,11,3,8
9,17,1376,3,2,1
9,17,1278,7,2,5
9,17,1140,12,6,6
9,17,1407,25,12,13
9,17,2963,27,12,15
9,17,527,19,11,8
9,17,1381,15,6,9
9,17,1476,6,3,3
9,17,998,34,17,17
9,17,1570,66,34,32
9,17,1533,72,32,40
9,17,1174,683,367,316
9,17,808,10,4,6
9,17,1258,10,7,3
9,17,975,12,5,7
9,17,693,1,1,0
9,17,1166,37,16,21
9,17,1867,25,14,11
9,17,904,6,2,4
9,17,1156,19,12,7
9,17,1252,27,15,12
9,17,1174,8,5,3
9,17,1266,6,4,2
9,17,1228,8,6,2
9,17,1180,25,10,15
9,17,1296,16,10,6
9,17,1279,27,18,9
9,17,872,21,9,12
9,17,1287,29,18,11
9,17,1798,33,13,20
9,17,1597,17,10,7
9,17,1012,13,6,7
9,17,1001,22,12,10
9,17,1046,9,3,6
9,17,528,4,1,3
9,17,698,15,7,8
9,17,1540,11,6,5
9,17,890,4,1,3
9,17,651,13,8,5
9,17,670,38,20,18
9,17,1244,2,2,0
9,17,1118,49,24,25
9,17,1071,11,8,3
9,17,1003,19,9,10
9,17,1428,9,5,4
9,17,1067,7,3,4
9,17,1272,12,7,5
9,17,1367,20,8,12
9,17,1431,65,35,30
9,17,1260,60,26,34
9,17,992,30,13,17
9,17,1212,34,16,18
9,17,1130,8,5,3
9,17,1104,24,11,13
9,17,940,37,21,16
9,17,1037,10,3,7
9,17,682,30,15,15
9,17,815,16,9,7
9,17,824,15,7,8
9,17,961,2,0,2
9,17,1122,57,37,20
9,17,987,39,24,15
9,17,1462,71,37,34
9,17,1206,27,12,15
9,17,1380,14,9,5
9,17,1322,9,7,2
9,17,1223,17,7,10
9,17,1496,10,3,7
9,17,1101,17,8,9
9,17,1390,20,11,9
9,17,1610,66,41,25
9,17,748,20,13,7
9,17,1210,57,25,32
9,17,1313,19,5,14
9,17,1152,15,8,7
9,17,1009,25,16,9
9,17,1352,11,5,6
9,17,1383,17,7,10
9,17,1254,28,12,16
9,17,748,4,1,3
9,17,1141,19,9,10
9,17,1197,2,1,1
9,17,1336,28,14,14
9,17,1741,21,11,10
9,17,2346,18,13,5
9,17,1297,23,10,13
9,17,1580,35,16,19
9,17,1334,33,15,18
9,17,1776,34,18,16
9,17,2226,26,14,12
9,17,998,5,1,4
9,17,1553,43,23,20
9,17,742,24,14,10
9,17,1424,12,6,6
9,17,923,3,0,3
9,17,1575,26,12,14
9,17,751,1,1,0
9,17,463,1,0,1
9,17,563,14,9,5
9,17,756,4,3,1
9,17,634,32,16,16
9,17,1382,8,4,4
9,17,1561,6,4,2
9,17,1573,47,21,26
9,17,1401,18,9,9
9,17,950,45,29,16
9,17,942,47,27,20
9,17,788,10,3,7
9,17,1771,39,27,12
9,17,1207,10,3,7
9,17,1516,12,7,5
9,17,1295,22,11,11
9,17,1651,20,7,13
9,17,1421,3,0,3
9,17,1198,4,3,1
9,17,1584,21,11,10
9,17,1772,15,7,8
9,17,1709,15,8,7
9,17,1363,7,3,4
9,17,1427,12,7,5
9,17,1302,40,16,24
9,17,1437,18,6,12
9,17,984,16,6,10
9,17,975,30,15,15
9,17,618,20,12,8
9,17,1151,57,32,25
9,17,1122,21,11,10
9,17,732,32,15,17
9,17,662,7,5,2
9,17,1811,9,5,4
9,17,1570,30,16,14
9,17,727,14,8,6
9,17,1892,58,35,23
9,17,1356,30,18,12
9,17,1657,65,35,30
9,17,1503,4,2,2
9,17,771,18,9,9
9,17,1474,19,9,10
9,17,1420,13,8,5
9,17,570,19,13,6
9,17,1973,23,11,12
9,17,1733,5,2,3
9,17,1503,7,4,3
9,17,1065,0,0,0
9,17,1337,8,7,1
9,17,1557,4,2,2
9,17,1197,3,0,3
9,17,1454,9,7,2
9,17,1595,9,4,5
9,17,1085,4,1,3
9,17,1117,9,5,4
9,17,1201,7,2,5
9,17,1522,1,0,1
9,17,2859,32,15,17
9,17,1525,12,7,5
9,17,2036,33,18,15
9,17,833,38,21,17
9,17,1297,22,12,10
9,17,1287,2,0,2
9,17,538,1,0,1
9,17,722,4,3,1
9,17,1319,50,28,22
9,17,1178,15,7,8
9,17,1210,21,16,5
9,17,1373,57,30,27
9,17,1385,34,13,21
9,17,1992,34,16,18
9,17,1210,7,2,5
9,17,852,35,19,16
9,17,1224,21,12,9
9,17,1367,15,9,6
9,17,1603,10,3,7
9,17,1109,16,5,11
9,17,1135,17,10,7
9,17,1102,28,18,10
9,17,1525,74,31,43
9,17,1736,29,14,15
9,17,1004,8,5,3
9,17,1453,567,313,254
9,17,1305,21,8,13
9,17,795,26,17,9
9,17,1090,35,18,17
9,17,1414,649,350,299
9,17,1199,18,7,11
9,17,845,18,8,10
9,17,1438,50,30,20
9,17,1304,72,37,35
9,17,1000,36,21,15
9,17,1154,61,26,35
9,17,1215,55,25,30
9,17,1523,52,27,25
9,17,1208,11,7,4
9,17,1798,29,15,14
9,17,1539,43,23,20
9,17,885,15,7,8
9,17,548,8,3,5
9,17,956,21,10,11
9,17,858,14,10,4
9,17,1199,41,19,22
9,17,1088,4,0,4
9,17,960,13,8,5
9,17,824,11,5,6
9,17,660,1,1,0
9,17,4083,84,40,44
9,17,1105,131,65,66
9,17,1854,88,51,37
9,17,2857,58,31,27
9,17,1815,21,8,13
9,17,7832,211,99,112
9,17,1238,7,4,3
9,17,2168,43,14,29
9,17,2686,26,13,13
9,2,853,0,0,0
9,2,658,6,4,2
9,2,936,4,2,2
9,3,2393,35,16,19
9,7,857,2,2,0
9,7,9807,392,195,197
9,12,1004,42,17,25
9,12,656,12,5,7
9,17,591,2,0,2
9,17,565,8,7,1
9,17,488,16,8,8
9,17,522,6,5,1
9,17,784,55,25,30
9,17,511,11,5,6
9,17,650,19,12,7
9,17,1124,34,14,20
9,4,2289,20,11,9
9,5,1094,16,11,5
9,5,1899,10,3,7
9,5,1415,8,3,5
9,5,1425,3,1,2
9,5,1442,4,1,3
9,5,1463,24,10,14
9,5,1361,16,8,8
9,12,2522,30,17,13
9,13,348,3,2,1
9,10,1533,18,10,8
9,13,0,0,0,0
9,11,1843,2,1,1
9,11,1809,26,13,13
9,11,561,1,1,0
9,11,2226,24,14,10
9,11,1985,8,4,4
9,11,1795,58,26,32
9,11,2164,8,5,3
9,11,1828,34,15,19
9,8,1682,21,9,12
9,8,1595,2,0,2
9,8,3044,18,6,12
9,10,1683,13,5,8
9,10,3307,24,11,13
10,1,413,2,0,2
10,1,1088,1,1,0
10,1,2961,20,8,12
10,1,1774,0,0,0
10,1,1373,11,5,6
10,1,2162,16,8,8
10,1,1002,9,6,3
10,1,940,5,2,3
10,1,751,0,0,0
10,1,207,10,3,7
10,1,238,0,0,0
10,1,760,4,2,2
10,1,434,5,3,2
10,1,925,1,1,0
10,1,438,2,0,2
10,1,216,0,0,0
10,1,178,0,0,0
10,1,205,1,1,0
10,1,165,0,0,0
10,1,1448,12,7,5
10,1,712,10,4,6
10,1,362,1,1,0
10,1,808,0,0,0
10,1,1393,1,1,0
10,1,1249,0,0,0
10,1,826,4,2,2
10,1,1386,5,2,3
10,1,1367,3,2,1
10,1,974,1,0,1
10,1,531,0,0,0
10,1,373,1,0,1
10,1,274,0,0,0
10,1,251,2,0,2
10,1,1265,1,0,1
10,1,862,8,4,4
10,1,438,0,0,0
10,1,655,3,2,1
10,2,1000,0,0,0
10,2,67,0,0,0
10,2,284,0,0,0
10,2,175,0,0,0
10,2,304,0,0,0
10,2,422,0,0,0
10,2,301,2,2,0
10,2,85,0,0,0
10,2,240,0,0,0
10,2,357,0,0,0
10,2,446,0,0,0
10,2,164,0,0,0
10,2,422,1,0,1
10,3,754,0,0,0
10,3,192,0,0,0
10,3,163,0,0,0
10,3,395,0,0,0
10,3,172,0,0,0
10,3,280,0,0,0
10,3,1256,1,0,1
10,3,283,0,0,0
10,3,589,0,0,0
10,4,2866,2,2,0
10,4,2197,13,10,3
10,4,1583,3,3,0
10,4,2577,11,6,5
10,4,2401,11,7,4
10,4,702,1,1,0
10,4,2124,22,11,11
10,4,336,0,0,0
10,4,1396,3,0,3
10,4,1539,2,1,1
10,4,433,0,0,0
10,4,625,0,0,0
10,4,345,0,0,0
10,4,1498,5,4,1
10,4,497,6,5,1
10,4,308,0,0,0
10,4,379,0,0,0
10,4,700,1,0,1
10,4,429,1,0,1
10,4,557,0,0,0
10,4,751,1,1,0
10,4,288,0,0,0
10,4,209,0,0,0
10,4,413,1,1,0
10,4,760,7,3,4
10,4,1239,14,8,6
10,4,432,2,2,0
10,4,657,11,4,7
10,4,1432,3,2,1
10,4,1349,3,2,1
10,4,450,1,0,1
10,4,515,0,0,0
10,4,778,7,3,4
10,4,238,16,9,7
10,4,915,2,0,2
10,4,771,9,3,6
10,4,266,2,2,0
10,5,13807,97,52,45
10,5,6938,77,35,42
10,5,11844,125,60,65
10,5,2065,79,40,39
10,5,1048,49,27,22
10,5,1536,6,2,4
10,5,1035,10,7,3
10,5,975,10,4,6
10,5,1260,17,9,8
10,5,17575,190,91,99
10,5,1672,1,0,1
10,5,1913,19,11,8
10,5,929,9,2,7
10,5,929,3,2,1
10,5,2961,7,3,4
10,5,1677,4,3,1
10,5,3666,18,14,4
10,5,1606,4,3,1
10,5,1877,2,1,1
10,5,5936,134,78,56
10,5,4903,17,9,8
10,5,8141,51,23,28
10,5,3977,17,9,8
10,5,3371,21,11,10
10,5,3645,35,17,18
10,5,1617,1,1,0
10,5,2648,8,5,3
10,5,2300,25,13,12
10,5,3240,21,12,9
10,5,2713,7,3,4
10,5,1559,6,1,5
10,5,1482,17,13,4
10,5,1441,34,20,14
10,5,1722,26,12,14
10,5,1121,3,3,0
10,5,1198,4,3,1
10,5,1763,7,4,3
10,5,3115,3,2,1
10,5,4875,79,42,37
10,5,20278,289,147,142
10,5,1182,3,1,2
10,5,1546,1,0,1
10,5,1307,0,0,0
10,5,1516,15,7,8
10,5,752,5,4,1
10,5,1491,4,2,2
10,5,2375,14,5,9
10,5,1512,13,8,5
10,5,1900,46,26,20
10,5,955,12,8,4
10,5,1438,0,0,0
10,5,986,9,3,6
10,5,1913,4,1,3
10,5,1913,14,7,7
10,5,1538,11,6,5
10,5,1905,6,2,4
10,5,5402,53,28,25
10,5,3100,14,7,7
10,5,1711,19,10,9
10,5,1532,16,5,11
10,5,1594,10,5,5
10,5,1601,1,0,1
10,5,2232,28,9,19
10,5,1315,1,0,1
10,5,779,3,0,3
10,5,804,36,21,15
10,5,964,4,0,4
10,5,1607,20,10,10
10,5,1414,2,1,1
10,5,1673,8,6,2
10,5,1390,29,13,16
10,5,1564,9,2,7
10,5,1728,5,3,2
10,5,991,1,0,1
10,5,777,5,1,4
10,5,1238,25,12,13
10,5,996,2,1,1
10,5,553,3,3,0
10,5,942,0,0,0
10,5,1121,16,9,7
10,5,673,0,0,0
10,5,578,0,0,0
10,5,631,5,2,3
10,5,796,9,4,5
10,5,687,0,0,0
10,5,904,0,0,0
10,5,1220,1,0,1
10,5,773,5,2,3
10,5,1215,9,3,6
10,5,2276,10,5,5
10,5,1637,10,5,5
10,5,2855,27,13,14
10,5,4721,23,12,11
10,5,1887,29,13,16
10,5,914,0,0,0
10,5,9154,116,60,56
10,5,729,0,0,0
10,5,787,0,0,0
10,5,579,7,7,0
10,5,779,5,1,4
10,5,685,3,2,1
10,5,1019,6,3,3
10,5,725,16,8,8
10,5,611,3,1,2
10,5,700,18,11,7
10,5,746,47,34,13
10,5,614,8,6,2
10,5,431,0,0,0
10,5,720,2,2,0
10,5,4368,77,41,36
10,5,5935,91,40,51
10,5,656,1,0,1
10,5,854,0,0,0
10,5,1298,1,0,1
10,5,1371,9,8,1
10,5,1609,13,5,8
10,5,1281,23,11,12
10,5,538,1,0,1
10,5,1184,17,8,9
10,5,1119,5,1,4
10,5,563,18,11,7
10,5,408,0,0,0
10,5,453,2,0,2
10,5,372,1,1,0
10,5,374,2,0,2
10,5,413,1,0,1
10,5,460,0,0,0
10,5,1194,48,23,25
10,5,2866,31,14,17
10,5,1759,47,25,22
10,5,714,21,10,11
10,5,597,1,1,0
10,5,510,6,1,5
10,5,648,3,3,0
10,5,950,43,20,23
10,5,520,8,4,4
10,5,843,12,7,5
10,5,506,0,0,0
10,5,2571,31,17,14
10,5,1377,34,25,9
10,5,2132,16,9,7
10,5,1097,8,5,3
10,5,1087,9,3,6
10,5,2363,2,1,1
10,5,12217,141,64,77
10,5,2996,0,0,0
10,5,3569,27,10,17
10,5,1547,5,3,2
10,5,1235,15,6,9
10,5,1020,4,2,2
10,5,1108,32,17,15
10,5,1218,14,8,6
10,5,779,2,0,2
10,5,1994,2,1,1
10,5,774,5,3,2
10,5,740,13,6,7
10,5,579,3,0,3
10,5,798,47,28,19
10,5,776,31,20,11
10,5,572,3,0,3
10,5,1194,26,15,11
10,5,1378,32,14,18
10,5,1615,29,16,13
10,5,921,4,0,4
10,5,1088,5,1,4
10,5,1056,218,112,106
10,5,2135,11,5,6
10,5,9950,113,54,59
10,5,2038,7,4,3
10,5,2117,2,0,2
10,5,1570,7,4,3
10,5,2812,21,6,15
10,5,3536,21,12,9
10,5,813,101,50,51
10,5,2952,107,58,49
10,5,2407,30,18,12
10,5,1107,39,19,20
10,5,1913,7,2,5
10,5,617,18,8,10
10,5,1159,2,2,0
10,5,1311,3,2,1
10,5,1417,54,26,28
10,5,1162,17,5,12
10,5,1271,26,15,11
10,5,1461,7,5,2
10,5,1635,3,0,3
10,5,1052,13,6,7
10,5,2984,45,21,24
10,5,1271,17,11,6
10,5,9829,181,94,87
10,5,1640,2,2,0
10,5,1767,1,0,1
10,5,8681,58,36,22
10,5,11679,80,33,47
10,5,4515,237,125,112
10,5,3528,22,9,13
10,5,843,11,5,6
10,5,1036,5,2,3
10,5,991,16,4,12
10,5,1032,45,19,26
10,5,1534,45,24,21
10,5,1212,20,12,8
10,5,1517,23,10,13
10,5,2004,18,8,10
10,5,794,36,15,21
10,5,863,7,5,2
10,5,1475,25,12,13
10,5,1271,19,10,9
10,5,576,6,3,3
10,5,573,0,0,0
10,5,1626,21,10,11
10,5,1764,7,3,4
10,5,1879,23,13,10
10,5,7757,61,39,22
10,5,1866,3,1,2
10,5,1696,7,2,5
10,5,2277,26,14,12
10,5,1097,5,3,2
10,5,2117,22,12,10
10,5,1804,1,0,1
10,5,1290,2,0,2
10,5,1506,29,14,15
10,5,2033,45,23,22
10,5,1753,11,5,6
10,5,1402,2,1,1
10,5,1432,0,0,0
10,5,1526,3,0,3
10,5,1561,15,9,6
10,5,1205,9,4,5
10,5,1836,4,3,1
10,5,8007,57,30,27
10,5,7065,24,15,9
10,5,3762,30,15,15
10,5,2121,7,3,4
10,5,3405,11,7,4
10,5,2031,6,3,3
10,5,1657,4,2,2
10,5,1680,11,5,6
10,5,1910,1,1,0
10,5,4620,11,5,6
10,5,7608,41,25,16
10,5,1280,2,1,1
10,5,3165,46,25,21
10,5,244,20,4,16
10,5,435,27,15,12
10,5,1123,2,1,1
10,5,1328,0,0,0
10,5,624,1,1,0
10,5,977,1,0,1
10,5,637,1,0,1
10,5,210,0,0,0
10,5,246,0,0,0
10,5,2027,17,12,5
10,5,1000,6,4,2
10,5,837,0,0,0
10,5,782,0,0,0
10,5,612,1,1,0
10,5,415,0,0,0
10,5,463,0,0,0
10,5,3342,34,20,14
10,5,437,70,9,61
10,5,3599,34,16,18
10,5,1092,2,2,0
10,5,339,4,0,4
10,5,802,1,0,1
10,5,343,3,2,1
10,5,5572,33,19,14
10,5,1649,15,6,9
10,5,1997,18,8,10
10,5,1336,0,0,0
10,5,1231,2,1,1
10,5,1929,7,4,3
10,5,541,4,3,1
10,5,1581,14,6,8
10,5,1213,35,14,21
10,5,28949,226,111,115
10,5,499,1,0,1
10,5,259,0,0,0
10,5,1131,2,1,1
10,5,1779,10,4,6
10,5,3029,1,1,0
10,5,5473,118,58,60
10,5,2649,34,17,17
10,5,1668,39,18,21
10,5,478,50,23,27
10,5,1886,18,10,8
10,5,686,0,0,0
10,5,2014,6,4,2
10,5,2777,103,54,49
10,5,1457,5,4,1
10,5,2698,7,4,3
10,5,1717,1,0,1
10,5,1592,0,0,0
10,5,1885,6,3,3
10,5,830,0,0,0
10,5,1953,5,1,4
10,5,774,0,0,0
10,5,388,0,0,0
10,5,2088,6,3,3
10,5,2490,3,1,2
10,5,3079,28,14,14
10,5,1936,3,1,2
10,5,577,3,2,1
10,5,765,2,2,0
10,5,120,1,1,0
10,5,1105,1,0,1
10,5,421,0,0,0
10,5,356,0,0,0
10,5,139,2,1,1
10,6,1187,26,13,13
10,6,1504,1,0,1
10,6,451,2,2,0
10,6,1365,1,1,0
10,6,290,0,0,0
10,6,963,0,0,0
10,6,420,0,0,0
10,6,380,0,0,0
10,6,755,2,2,0
10,6,619,0,0,0
10,6,565,0,0,0
10,6,146,0,0,0
10,6,274,1,0,1
10,6,138,1,1,0
10,6,917,0,0,0
10,7,1389,9,3,6
10,7,1877,16,7,9
10,7,3435,77,33,44
10,7,11673,228,111,117
10,7,933,11,4,7
10,7,1046,2,2,0
10,7,812,3,3,0
10,7,5142,75,46,29
10,7,14118,247,114,133
10,7,1450,6,4,2
10,7,13668,166,75,91
10,7,8942,75,34,41
10,7,1501,4,3,1
10,7,947,7,5,2
10,7,1149,13,7,6
10,7,1927,21,13,8
10,7,1419,7,2,5
10,7,1032,0,0,0
10,7,939,17,8,9
10,7,1794,4,3,1
10,7,751,3,2,1
10,7,779,10,5,5
10,7,1884,13,5,8
10,7,1649,2,1,1
10,7,1507,67,35,32
10,7,1173,15,7,8
10,7,1146,3,1,2
10,7,1744,9,5,4
10,7,1025,16,8,8
10,7,896,6,3,3
10,7,2697,21,11,10
10,7,1386,23,13,10
10,7,939,8,3,5
10,7,588,10,5,5
10,7,3208,5,2,3
10,7,2077,6,5,1
10,7,1286,1,0,1
10,7,1141,15,4,11
10,7,1189,4,2,2
10,7,1703,2,2,0
10,7,503,119,62,57
10,7,581,181,90,91
10,7,570,9,5,4
10,7,575,9,6,3
10,7,668,51,23,28
10,7,680,14,7,7
10,7,626,7,4,3
10,7,1086,5,3,2
10,7,1569,21,7,14
10,7,2006,27,11,16
10,7,2476,4,1,3
10,7,18829,159,73,86
10,7,1653,8,4,4
10,7,1416,2,0,2
10,7,4728,42,21,21
10,7,1181,1,0,1
10,7,1369,3,1,2
10,7,1083,2,1,1
10,7,1018,6,2,4
10,7,487,3,2,1
10,7,328,3,1,2
10,7,679,2,1,1
10,7,965,4,1,3
10,7,1168,5,3,2
10,7,1247,5,4,1
10,7,1974,3,2,1
10,7,1024,0,0,0
10,7,678,2,1,1
10,7,971,3,2,1
10,7,814,3,0,3
10,7,673,3,0,3
10,7,369,8,4,4
10,7,588,4,0,4
10,7,1571,23,11,12
10,7,1536,3,2,1
10,7,1916,5,1,4
10,7,1397,0,0,0
10,7,740,1,0,1
10,7,1236,3,1,2
10,7,339,0,0,0
10,7,413,5,3,2
10,7,378,0,0,0
10,7,938,6,3,3
10,7,1017,2,0,2
10,7,1035,0,0,0
10,7,728,2,1,1
10,7,528,3,3,0
10,7,413,1,0,1
10,7,1385,6,3,3
10,7,1717,4,1,3
10,7,1607,51,25,26
10,7,1488,2,0,2
10,7,1452,11,2,9
10,7,1601,12,4,8
10,7,1438,11,3,8
10,7,654,16,10,6
10,7,709,8,3,5
10,7,460,1,0,1
10,7,1419,12,8,4
10,7,979,9,6,3
10,7,589,1,0,1
10,7,702,9,5,4
10,7,1134,3,1,2
10,7,949,1,1,0
10,7,14571,81,48,33
10,7,1694,7,4,3
10,7,891,1,1,0
10,7,986,12,7,5
10,7,676,2,1,1
10,7,838,0,0,0
10,7,929,2,2,0
10,7,910,0,0,0
10,7,645,0,0,0
10,7,1060,148,85,63
10,7,1124,8,6,2
10,7,1127,12,6,6
10,7,1187,6,4,2
10,7,1272,11,3,8
10,7,765,2,1,1
10,7,579,2,1,1
10,7,142,0,0,0
10,7,1330,28,12,16
10,7,1295,12,7,5
10,7,1476,22,11,11
10,7,2652,38,17,21
10,7,1483,4,2,2
10,7,810,1,1,0
10,7,1268,3,1,2
10,7,1438,1,0,1
10,7,1740,2,0,2
10,7,1936,16,9,7
10,7,464,6,3,3
10,7,1524,7,4,3
10,7,960,1,0,1
10,7,3711,6,4,2
10,7,1393,2,1,1
10,7,1035,4,2,2
10,7,2896,11,2,9
10,7,685,1,0,1
10,7,508,4,4,0
10,7,1155,4,3,1
10,7,720,22,12,10
10,7,2158,51,3,48
10,7,1013,4,2,2
10,7,2256,6,2,4
10,7,1518,1,0,1
10,7,1874,2,0,2
10,7,1113,6,2,4
10,7,2850,11,7,4
10,7,1099,1,0,1
10,7,758,2,1,1
10,7,2112,1,0,1
10,7,1487,1,1,0
10,7,1615,12,4,8
10,7,1841,4,2,2
10,7,1591,4,1,3
10,7,907,12,9,3
10,7,1428,1,0,1
10,7,1105,1,1,0
10,7,985,2,0,2
10,7,2689,1,0,1
10,7,3894,13,6,7
10,7,2121,17,6,11
10,7,1904,5,4,1
10,7,740,1,1,0
10,7,2359,9,6,3
10,7,1363,1,0,1
10,7,15314,621,310,311
10,7,8286,61,33,28
10,7,3644,16,7,9
10,7,4200,78,39,39
10,7,1234,5,3,2
10,7,1187,1,0,1
10,7,744,3,2,1
10,8,2430,12,8,4
10,8,2045,39,17,22
10,8,1481,7,5,2
10,8,1135,11,7,4
10,8,923,1,1,0
10,8,1073,7,3,4
10,8,1503,9,5,4
10,8,1853,9,3,6
10,8,2172,14,10,4
10,8,4434,15,5,10
10,8,666,0,0,0
10,8,134,43,17,26
10,8,1173,1,1,0
10,8,1340,1,0,1
10,8,521,0,0,0
10,8,531,0,0,0
10,8,1386,33,19,14
10,8,1329,21,9,12
10,8,2188,1,0,1
10,8,516,0,0,0
10,8,1065,11,5,6
10,8,1060,7,5,2
10,8,1309,8,3,5
10,8,1394,2,2,0
10,8,2541,4,2,2
10,8,493,0,0,0
10,9,2567,23,11,12
10,9,1420,26,10,16
10,9,245,1,0,1
10,9,293,4,2,2
10,9,184,1,1,0
10,9,260,0,0,0
10,9,731,2,2,0
10,9,127,0,0,0
10,9,114,1,0,1
10,9,243,0,0,0
10,9,223,0,0,0
10,9,231,0,0,0
10,9,909,4,2,2
10,9,278,0,0,0
10,9,486,0,0,0
10,9,129,0,0,0
10,9,153,0,0,0
10,9,348,0,0,0
10,9,616,2,1,1
10,9,252,0,0,0
10,9,219,0,0,0
10,10,600,22,12,10
10,10,322,0,0,0
10,10,426,2,2,0
10,10,1069,4,0,4
10,10,169,1,1,0
10,10,565,0,0,0
10,10,681,4,2,2
10,11,267,1,0,1
10,11,364,1,0,1
10,11,287,1,1,0
10,11,304,1,0,1
10,11,132,0,0,0
10,11,744,1,1,0
10,11,222,0,0,0
10,11,133,0,0,0
10,11,234,0,0,0
10,11,147,5,3,2
10,11,211,1,0,1
10,11,467,2,1,1
10,11,204,0,0,0
10,11,416,1,0,1
10,11,436,0,0,0
10,11,187,0,0,0
10,12,12781,98,49,49
10,12,3729,13,6,7
10,12,1914,11,4,7
10,12,1184,5,4,1
10,12,1517,4,3,1
10,12,3888,23,15,8
10,12,3232,43,15,28
10,12,1391,6,2,4
10,12,1528,7,4,3
10,12,18306,254,132,122
10,12,2670,5,4,1
10,12,8379,41,23,18
10,12,1396,12,6,6
10,12,1160,1,0,1
10,12,703,3,2,1
10,12,778,0,0,0
10,12,2611,12,6,6
10,12,1671,3,1,2
10,12,925,0,0,0
10,12,1092,1,0,1
10,12,858,2,1,1
10,12,1183,1,0,1
10,12,1668,8,4,4
10,12,724,6,3,3
10,12,703,6,6,0
10,12,883,12,5,7
10,12,1125,6,4,2
10,12,2735,557,291,266
10,12,1189,11,5,6
10,12,1415,0,0,0
10,12,955,5,3,2
10,12,1484,7,3,4
10,12,1491,21,10,11
10,12,1660,22,13,9
10,12,1302,8,6,2
10,12,1384,40,23,17
10,12,668,48,28,20
10,12,1330,75,35,40
10,12,2601,57,31,26
10,12,452,0,0,0
10,12,371,2,1,1
10,12,3148,35,18,17
10,12,1519,6,3,3
10,12,1490,3,1,2
10,12,4479,14,10,4
10,12,1473,3,3,0
10,12,2787,4,0,4
10,12,846,0,0,0
10,12,1678,2,1,1
10,12,2784,10,4,6
10,12,2368,2,0,2
10,12,280,1,0,1
10,12,2367,1,1,0
10,12,1683,3,2,1
10,12,850,1,0,1
10,12,1734,38,16,22
10,12,1380,3,2,1
10,12,1740,3,3,0
10,12,2689,20,13,7
10,12,1214,125,61,64
10,12,1435,3,2,1
10,12,1558,25,13,12
10,12,1451,4,1,3
10,12,1908,3,2,1
10,12,1381,10,2,8
10,12,1916,0,0,0
10,12,2442,0,0,0
10,12,2039,2,1,1
10,12,1553,5,2,3
10,12,465,0,0,0
10,12,512,1,0,1
10,12,2793,186,79,107
10,12,2592,40,19,21
10,12,1470,35,16,19
10,12,2792,32,13,19
10,12,1585,12,2,10
10,12,406,1,1,0
10,12,945,2,1,1
10,12,492,2,1,1
10,13,4737,206,101,105
10,13,901,56,26,30
10,13,1005,8,3,5
10,13,428,2,0,2
10,13,270,0,0,0
10,13,336,0,0,0
10,13,1752,6,5,1
10,13,863,0,0,0
10,13,401,0,0,0
10,13,283,0,0,0
10,13,269,0,0,0
10,13,938,3,1,2
10,13,2375,16,8,8
10,13,995,7,5,2
10,13,2037,9,5,4
10,13,1304,20,9,11
10,13,1290,34,13,21
10,13,1669,1,1,0
10,13,1764,14,5,9
10,13,656,1,1,0
10,13,170,4,2,2
10,13,146,2,1,1
10,14,1541,0,0,0
10,14,702,1,0,1
10,14,241,1,0,1
10,14,315,0,0,0
10,14,976,4,2,2
10,14,748,0,0,0
10,14,98,0,0,0
10,14,373,1,0,1
10,14,167,0,0,0
10,14,996,8,4,4
10,14,616,0,0,0
10,14,1185,294,157,137
10,14,1248,3,1,2
10,14,1848,0,0,0
10,14,3057,3,1,2
10,14,4158,37,16,21
10,14,751,6,4,2
10,14,1024,27,14,13
10,14,993,3,1,2
10,14,1121,6,3,3
10,14,2836,141,73,68
10,14,2343,4,3,1
10,14,1954,5,1,4
10,14,953,6,1,5
10,14,1777,97,45,52
10,14,2944,8,4,4
10,14,3259,7,5,2
10,14,2009,2,2,0
10,14,1962,22,10,12
10,14,2123,13,9,4
10,14,2091,2,2,0
10,14,2073,3,2,1
10,15,799,5,3,2
10,15,1193,5,4,1
10,15,1764,122,65,57
10,15,653,28,13,15
10,15,348,0,0,0
10,15,817,1,0,1
10,15,777,6,3,3
10,15,565,0,0,0
10,15,681,0,0,0
10,15,1053,0,0,0
10,15,582,2,2,0
10,15,1410,5,2,3
10,15,807,1,1,0
10,15,301,71,37,34
10,15,457,6,3,3
10,15,163,0,0,0
10,15,470,9,1,8
10,16,1100,17,9,8
10,16,3405,25,11,14
10,16,1511,43,24,19
10,16,761,0,0,0
10,16,822,2,1,1
10,16,920,0,0,0
10,16,889,3,1,2
10,16,596,2,1,1
10,16,528,1,1,0
10,16,512,3,1,2
10,16,675,3,2,1
10,16,695,8,3,5
10,16,1843,5,2,3
10,16,53,0,0,0
10,16,1322,0,0,0
10,16,1172,39,18,21
10,16,323,0,0,0
10,16,1079,3,0,3
10,16,505,0,0,0
10,16,413,5,2,3
10,17,3306,7,4,3
10,17,1071,0,0,0
10,17,1235,2,0,2
10,17,1447,7,4,3
10,17,1504,2,0,2
10,17,1014,0,0,0
10,17,1029,4,0,4
10,17,384,0,0,0
10,17,1203,2,2,0
10,17,616,0,0,0
10,17,420,0,0,0
10,17,604,0,0,0
10,17,337,0,0,0
10,17,1552,1,1,0
10,17,566,2,1,1
10,17,1460,6,3,3
10,17,1657,8,5,3
10,17,169,0,0,0
10,17,366,1,1,0
10,17,237,0,0,0
10,17,522,0,0,0
10,17,962,1,0,1
10,17,2906,8,2,6
10,17,339,2,1,1
10,17,913,12,5,7
10,17,1391,3,1,2
10,17,137,0,0,0
10,17,144,0,0,0
10,17,493,4,1,3
10,18,1053,0,0,0
10,18,439,0,0,0
10,18,207,0,0,0
10,18,428,0,0,0
10,18,226,0,0,0
10,18,595,0,0,0
10,18,282,0,0,0
10,18,245,0,0,0
10,18,605,4,2,2
10,18,448,1,1,0
10,18,761,6,2,4
10,18,907,2,2,0
10,18,632,3,2,1
10,18,735,19,8,11
10,18,117,0,0,0
10,18,282,0,0,0
10,19,2168,6,4,2
10,19,838,3,2,1
10,19,1548,4,0,4
10,19,1227,7,3,4
10,19,266,0,0,0
10,19,146,0,0,0
10,19,212,4,2,2
10,19,144,0,0,0
10,19,78,0,0,0
10,19,257,0,0,0
10,19,121,0,0,0
10,19,106,2,2,0
10,19,211,8,3,5
10,19,204,0,0,0
10,19,220,1,1,0
10,19,193,0,0,0
10,19,631,4,1,3
10,19,146,5,2,3
10,19,264,2,1,1
10,19,336,0,0,0
10,19,283,6,1,5
10,19,166,0,0,0
10,19,619,1,0,1
10,20,1060,4,3,1
10,20,316,0,0,0
10,20,294,0,0,0
10,20,261,0,0,0
10,20,228,0,0,0
10,20,423,1,1,0
10,20,152,0,0,0
10,20,260,0,0,0
10,20,475,1,1,0
10,20,197,2,1,1
10,20,171,0,0,0
10,20,227,0,0,0
10,20,728,2,0,2
10,20,165,0,0,0
10,21,1128,1,1,0
10,21,703,3,1,2
10,21,1291,5,3,2
10,21,992,1,0,1
10,21,1678,2,2,0
10,21,228,0,0,0
10,21,1442,2,2,0
10,21,765,1,1,0
10,21,868,1,0,1
10,21,252,1,1,0
10,21,718,0,0,0
10,21,970,0,0,0
10,21,450,0,0,0
10,21,402,4,1,3
10,21,499,0,0,0
10,21,222,0,0,0
10,22,1034,9,5,4
10,22,1087,0,0,0
10,22,1375,0,0,0
10,22,1475,6,4,2
10,22,241,0,0,0
10,22,304,3,3,0
10,22,568,51,24,27
10,22,1344,11,5,6
10,22,544,0,0,0
10,22,164,0,0,0
10,22,410,5,2,3
10,22,977,0,0,0
10,22,836,2,2,0
10,22,813,0,0,0
10,23,2583,18,8,10
10,23,2197,31,20,11
10,23,2174,54,32,22
10,23,1865,29,14,15
10,23,1746,2,1,1
10,23,923,0,0,0
10,23,439,0,0,0
10,23,472,0,0,0
10,23,1443,12,9,3
10,23,770,3,1,2
10,23,655,0,0,0
10,23,1004,1,0,1
10,23,1040,4,1,3
10,23,1004,2,2,0
10,23,857,4,2,2
10,23,624,0,0,0
10,23,891,1,1,0
10,23,721,0,0,0
10,23,1538,14,7,7
10,23,311,1,0,1
10,23,393,0,0,0
10,23,759,2,2,0
10,23,1155,2,2,0
10,24,2619,9,3,6
10,24,1424,2,1,1
10,24,2278,9,5,4
10,24,1930,16,7,9
10,24,2874,14,6,8
10,24,2114,52,18,34
10,24,3464,49,26,23
10,24,1032,2,2,0
10,24,2629,18,11,7
10,24,6054,30,17,13
10,24,648,0,0,0
10,24,179,1,1,0
10,24,1123,1,1,0
10,24,1279,1,0,1
10,24,1161,0,0,0
10,24,743,3,2,1
10,24,558,49,22,27
10,24,337,2,0,2
10,24,568,2,0,2
10,24,928,3,1,2
10,24,557,2,1,1
10,24,111,0,0,0
10,24,978,1,1,0
10,24,326,1,1,0
10,24,385,0,0,0
10,24,972,16,7,9
10,24,375,2,1,1
10,24,585,1,0,1
10,24,512,1,0,1
10,24,976,3,2,1
10,24,509,5,4,1
10,24,1580,4,1,3
10,24,846,5,2,3
10,24,386,1,0,1
10,24,406,0,0,0
10,24,1101,2,2,0
10,24,640,2,1,1
10,24,2046,1,0,1
10,24,471,0,0,0
10,24,351,0,0,0
10,24,291,0,0,0
10,24,193,1,0,1
10,24,691,3,2,1
10,24,1108,6,2,4
10,24,588,1,1,0
10,25,1332,5,3,2
10,25,1460,13,11,2
10,25,2188,3,2,1
10,25,281,0,0,0
10,25,260,0,0,0
10,25,1135,3,2,1
10,25,482,0,0,0
10,25,482,0,0,0
10,25,923,0,0,0
10,25,68,0,0,0
10,25,207,0,0,0
10,25,505,0,0,0
10,25,136,0,0,0
10,25,420,1,0,1
10,25,230,1,0,1
10,25,261,42,16,26
10,25,588,1,0,1
10,25,374,1,1,0
10,25,472,5,3,2
10,25,776,8,2,6
10,25,238,0,0,0
10,26,638,2,1,1
10,26,231,1,0,1
10,26,201,0,0,0
10,26,195,3,1,2
10,26,193,0,0,0
10,26,283,0,0,0
10,26,87,0,0,0
10,26,242,0,0,0
10,26,119,2,1,1
10,26,354,0,0,0
10,26,294,0,0,0
10,27,1020,1,0,1
10,27,3711,9,7,2
10,27,1629,10,3,7
10,27,260,1,0,1
10,27,300,1,0,1
10,27,293,0,0,0
10,27,139,0,0,0
10,27,493,1,0,1
10,27,515,9,4,5
10,27,500,8,3,5
10,27,507,4,0,4
10,27,38,0,0,0
10,27,796,2,0,2
10,27,413,8,6,2
10,27,159,0,0,0
10,27,547,1,1,0
10,27,514,4,1,3
10,27,339,0,0,0
10,27,361,6,2,4
10,27,148,3,3,0
10,27,347,2,2,0
10,27,63,1,1,0
10,27,482,0,0,0
10,27,344,4,2,2
10,27,370,4,3,1
10,27,267,1,0,1
10,27,286,1,1,0
10,27,415,1,0,1
10,27,110,2,1,1
10,27,448,0,0,0
10,27,287,0,0,0
10,27,400,1,1,0
10,27,338,0,0,0
10,27,220,0,0,0
10,27,41,0,0,0
10,28,881,2,1,1
10,28,862,7,3,4
10,28,281,17,9,8
10,28,288,0,0,0
10,28,152,0,0,0
10,28,85,0,0,0
10,28,447,5,3,2
10,28,311,0,0,0
10,28,152,6,5,1
10,28,411,241,110,131
10,28,913,18,11,7
10,28,347,4,2,2
10,28,115,0,0,0
10,29,1259,1,0,1
10,29,1384,3,3,0
10,29,937,4,2,2
10,29,195,1,0,1
10,29,821,1,1,0
10,29,517,3,2,1
10,29,344,0,0,0
10,29,365,0,0,0
10,29,220,2,1,1
10,29,179,1,1,0
10,29,230,0,0,0
10,29,780,6,2,4
10,29,241,1,0,1
10,29,1260,3,2,1
10,29,192,0,0,0
10,29,675,1,0,1
10,29,798,3,2,1
10,29,545,0,0,0
10,29,474,0,0,0
10,29,148,0,0,0
10,29,171,0,0,0
10,29,167,1,0,1
10,29,111,0,0,0
10,30,510,0,0,0
10,30,404,0,0,0
10,30,608,1,0,1
10,30,581,1,1,0
10,31,733,12,6,6
10,31,178,0,0,0
10,31,341,4,2,2
10,31,207,0,0,0
10,31,178,0,0,0
10,32,882,12,7,5
10,32,1380,0,0,0
10,32,1167,9,6,3
10,32,619,22,13,9
10,32,447,0,0,0
10,32,926,8,5,3
10,32,574,6,2,4
10,32,802,5,3,2
10,33,2868,8,3,5
10,33,2827,13,4,9
10,33,2454,4,2,2
10,33,1168,4,2,2
10,33,969,4,3,1
10,33,1148,11,6,5
10,33,1926,2,1,1
10,33,4765,12,4,8
10,33,1378,1,1,0
10,33,636,7,1,6
10,33,622,1,0,1
10,33,938,1,1,0
10,33,2171,1,1,0
10,33,4166,13,4,9
10,33,1137,2,1,1
10,33,272,0,0,0
10,33,165,2,1,1
10,33,113,0,0,0
10,33,648,4,1,3
10,33,435,14,5,9
10,33,118,0,0,0
10,33,565,12,5,7
10,33,343,1,0,1
10,33,183,0,0,0
10,33,142,0,0,0
10,33,180,0,0,0
10,33,297,0,0,0
10,33,532,70,32,38
10,33,332,6,4,2
10,33,377,1,1,0
10,33,1184,4,1,3
10,33,467,1,0,1
10,33,734,1,1,0
10,33,532,1,0,1
10,33,835,1,1,0
10,33,219,8,2,6
10,33,366,2,1,1
10,33,1252,4,1,3
10,33,289,0,0,0
10,33,432,9,4,5
10,33,389,1,0,1
10,33,594,0,0,0
10,33,661,6,1,5
10,33,214,1,0,1
10,33,107,0,0,0
10,33,219,0,0,0
10,33,413,2,0,2
10,33,374,4,3,1
10,33,297,0,0,0
10,33,163,0,0,0
10,33,314,0,0,0
10,33,165,1,0,1
10,33,444,1,0,1
10,33,590,0,0,0
10,33,307,0,0,0
10,33,167,0,0,0
10,33,719,1,0,1
10,33,339,1,0,1
10,33,99,1,1,0
10,34,987,4,3,1
10,34,873,3,3,0
10,34,891,12,5,7
10,34,1547,61,27,34
10,34,208,1,1,0
10,34,828,0,0,0
10,34,249,1,0,1
10,34,322,0,0,0
10,34,360,1,1,0
10,34,757,1,0,1
10,35,2054,10,5,5
10,35,2433,6,1,5
10,35,490,0,0,0
10,35,1734,2,1,1
10,35,232,2,0,2
10,35,941,1,0,1
10,35,744,0,0,0
10,35,2070,3,3,0
10,35,719,0,0,0
10,35,194,1,1,0
10,35,349,0,0,0
10,35,633,3,1,2
10,35,1009,2,0,2
10,35,315,2,1,1
10,35,533,1,0,1
10,35,816,0,0,0
10,35,928,1,0,1
10,35,297,0,0,0
10,35,740,2,0,2
10,35,419,0,0,0
10,35,763,1,1,0
10,35,900,0,0,0
10,35,1152,1,0,1
10,35,731,1,0,1
10,35,960,3,0,3
10,35,1582,3,1,2
10,35,1334,2,1,1
10,35,540,3,1,2
10,35,720,0,0,0
10,35,422,1,0,1
10,36,1259,6,2,4
10,36,543,2,1,1
10,36,217,5,3,2
10,36,1851,31,18,13
10,36,1625,86,41,45
10,36,581,4,3,1
10,36,374,4,2,2
10,36,156,1,1,0
10,36,227,0,0,0
10,36,546,3,3,0
10,36,471,0,0,0
10,36,110,0,0,0
10,36,344,8,5,3
10,36,231,1,0,1
10,36,273,9,4,5
10,36,304,0,0,0
10,36,109,0,0,0
10,36,113,7,4,3
10,36,279,0,0,0
10,36,148,1,0,1
10,36,265,0,0,0
10,36,54,0,0,0
10,36,97,1,0,1
10,36,235,0,0,0
10,36,524,6,2,4
10,36,339,3,3,0
10,37,1395,1,0,1
10,37,1117,3,2,1
10,37,1252,3,0,3
10,37,817,3,3,0
10,37,889,3,1,2
10,37,860,2,0,2
10,37,1101,1,0,1
10,37,690,4,3,1
10,37,840,2,1,1
10,37,484,1,1,0
10,37,469,0,0,0
10,37,565,3,2,1
10,37,819,0,0,0
10,37,392,1,1,0
10,37,272,0,0,0
10,37,1039,18,8,10
10,37,1708,7,3,4
10,37,1750,0,0,0
10,37,383,3,2,1
10,37,276,1,1,0
10,37,1498,5,3,2
10,37,1285,0,0,0
10,37,1529,0,0,0
10,38,1504,4,3,1
10,38,755,8,3,5
10,38,1329,4,3,1
10,38,266,0,0,0
10,38,157,2,1,1
10,38,792,5,1,4
10,38,430,0,0,0
10,38,171,0,0,0
10,38,1509,6,2,4
10,38,184,2,0,2
10,38,419,1,0,1
10,38,488,1,0,1
10,38,926,1,0,1
10,39,1678,23,12,11
10,39,2508,28,14,14
10,39,1176,7,2,5
10,39,1194,4,3,1
10,39,1184,22,8,14
10,39,585,9,3,6
10,39,1116,12,9,3
10,39,3007,18,11,7
10,39,1213,6,2,4
10,39,1214,3,2,1
10,39,3716,5,2,3
10,39,1078,2,2,0
10,39,722,2,0,2
10,39,1821,1,0,1
10,39,95,0,0,0
10,39,396,0,0,0
10,39,768,2,2,0
10,33,2713,11,2,9
10,13,1116,0,0,0
10,13,1215,4,2,2
10,5,1908,8,3,5
10,5,1801,8,5,3
10,5,1702,27,14,13
10,5,1672,43,22,21
10,5,1060,1,1,0
10,5,1513,11,3,8
10,5,3144,15,7,8
10,5,1744,14,5,9
10,5,1356,2,0,2
10,5,1213,0,0,0
10,5,1723,15,5,10
10,5,968,26,15,11
10,5,1630,1,0,1
10,5,1254,0,0,0
10,5,1325,2,1,1
10,5,1527,3,2,1
10,5,1214,3,2,1
10,5,1798,22,12,10
10,5,2733,25,10,15
10,5,1491,47,22,25
10,5,1180,12,6,6
10,5,861,5,3,2
10,7,1559,8,1,7
10,7,2727,49,27,22
10,7,2100,1,0,1
10,7,1158,4,4,0
10,7,2947,12,7,5
10,7,1496,2,1,1
10,7,855,3,1,2
10,7,1340,13,8,5
10,7,1214,17,7,10
10,7,943,1,1,0
10,7,1951,7,5,2
10,7,1003,4,2,2
10,7,1012,4,4,0
10,7,675,1,0,1
10,7,818,7,3,4
10,7,1223,3,1,2
10,7,3095,20,9,11
10,7,851,7,4,3
10,7,1219,6,2,4
10,7,1483,0,0,0
10,7,890,3,2,1
10,7,1827,12,7,5
10,7,624,1,0,1
10,7,956,1,1,0
10,7,1178,6,3,3
10,7,1086,3,1,2
10,7,885,9,7,2
10,7,2259,10,5,5
10,7,980,18,9,9
10,7,1537,16,8,8
10,7,1972,1,0,1
10,7,370,0,0,0
11,1,2149,14,5,9
11,1,2302,35,17,18
11,1,1377,4,3,1
11,1,1214,7,3,4
11,1,1195,6,3,3
11,1,4476,15,6,9
11,1,1781,4,1,3
11,1,1531,22,12,10
11,1,3063,5,4,1
11,1,2225,31,14,17
11,1,5341,11,5,6
11,1,1524,4,1,3
11,1,1122,3,3,0
11,1,384,5,1,4
11,1,955,1,1,0
11,1,2706,3,1,2
11,1,1922,5,4,1
11,1,1143,1,1,0
11,1,1522,1,1,0
11,1,2885,35,21,14
11,1,2711,16,6,10
11,1,3286,13,4,9
11,1,537,0,0,0
11,1,2125,50,27,23
11,1,1252,7,3,4
11,1,2186,5,2,3
11,1,2243,17,12,5
11,1,545,2,1,1
11,1,1261,6,4,2
11,1,1027,10,7,3
11,1,2063,11,7,4
11,1,2044,5,2,3
11,1,1833,3,2,1
11,1,2116,4,4,0
11,1,1619,1,1,0
11,1,1286,3,2,1
11,1,1454,4,1,3
11,1,3394,15,10,5
11,1,3112,63,32,31
11,1,1852,2,1,1
11,1,1350,3,2,1
11,1,1892,3,1,2
11,1,810,13,6,7
11,1,1096,9,7,2
11,1,393,0,0,0
11,1,1244,5,1,4
11,1,1608,10,3,7
11,1,1209,0,0,0
11,1,720,0,0,0
11,1,2821,24,11,13
11,2,4660,27,11,16
11,2,916,2,0,2
11,2,728,6,4,2
11,2,696,11,5,6
11,2,612,28,15,13
11,2,1470,8,5,3
11,2,1145,8,3,5
11,2,2085,19,10,9
11,2,1046,0,0,0
11,2,785,1,0,1
11,2,825,12,7,5
11,2,849,3,1,2
11,2,568,8,1,7
11,2,820,12,6,6
11,2,1658,15,7,8
11,2,738,1,0,1
11,2,3452,22,14,8
11,2,702,2,1,1
11,2,725,36,15,21
11,2,1068,5,2,3
11,2,1524,9,6,3
11,2,1106,6,4,2
11,2,763,7,2,5
11,2,1901,7,3,4
11,2,624,1,1,0
11,2,726,3,2,1
11,2,1455,20,8,12
11,2,1794,10,4,6
11,2,1890,16,7,9
11,2,1264,21,11,10
11,2,4654,45,20,25
11,2,1383,7,5,2
11,2,1778,13,7,6
11,2,1793,5,5,0
11,2,1726,14,7,7
11,2,5195,78,37,41
11,2,178,4,1,3
11,2,196,0,0,0
11,2,677,2,1,1
11,2,285,3,1,2
11,2,915,1,1,0
11,2,440,0,0,0
11,2,986,2,2,0
11,2,669,6,3,3
11,2,995,2,0,2
11,2,864,2,0,2
11,2,1096,3,2,1
11,2,423,1,0,1
11,2,930,0,0,0
11,2,740,2,2,0
11,2,1064,4,2,2
11,2,834,2,2,0
11,2,954,0,0,0
11,2,942,0,0,0
11,2,572,1,0,1
11,2,1180,8,4,4
11,2,691,1,0,1
11,2,801,1,1,0
11,2,1406,26,16,10
11,2,507,0,0,0
11,2,947,0,0,0
11,2,849,0,0,0
11,2,774,0,0,0
11,2,1829,19,9,10
11,2,1884,2,1,1
11,2,1119,2,1,1
11,2,646,1,1,0
11,2,1335,0,0,0
11,2,1050,4,2,2
11,2,749,1,0,1
11,2,1568,34,15,19
11,2,949,1,0,1
11,2,1909,29,16,13
11,2,460,1,1,0
11,2,469,0,0,0
11,2,983,2,1,1
11,2,452,4,2,2
11,2,1319,6,3,3
11,2,933,4,3,1
11,2,679,1,0,1
11,2,1758,32,13,19
11,2,1345,49,25,24
11,2,645,0,0,0
11,2,656,0,0,0
11,2,762,4,2,2
11,2,4080,16,7,9
11,2,1333,2,0,2
11,2,845,0,0,0
11,2,982,5,2,3
11,2,1832,4,3,1
11,3,8776,170,81,89
11,3,2175,100,44,56
11,3,1118,12,5,7
11,3,1669,7,3,4
11,3,10532,65,31,34
11,3,2262,11,5,6
11,3,974,9,3,6
11,3,628,36,16,20
11,3,462,2,0,2
11,3,786,7,4,3
11,3,389,16,9,7
11,3,706,4,1,3
11,3,786,16,7,9
11,3,926,13,9,4
11,3,2281,6,3,3
11,3,3786,20,9,11
11,3,5884,23,12,11
11,3,2670,23,12,11
11,3,1191,3,1,2
11,3,516,2,1,1
11,3,682,4,2,2
11,3,278,1,1,0
11,3,568,0,0,0
11,3,5294,45,26,19
11,3,2095,12,7,5
11,3,342,4,2,2
11,3,664,14,7,7
11,3,1345,22,13,9
11,3,1393,5,3,2
11,3,759,35,22,13
11,3,1960,14,10,4
11,3,1099,11,3,8
11,3,6892,70,44,26
11,3,1716,15,8,7
11,3,3417,32,17,15
11,3,1322,10,5,5
11,3,2487,2,1,1
11,3,601,2,0,2
11,3,1045,2,1,1
11,3,1908,2,0,2
11,3,1191,6,2,4
11,3,995,6,4,2
11,3,1866,743,377,366
11,3,1341,569,301,268
11,3,1991,5,3,2
11,3,1161,1,0,1
11,3,832,3,3,0
11,3,3163,7,4,3
11,3,2193,4,3,1
11,3,2267,42,21,21
11,3,1662,0,0,0
11,3,733,0,0,0
11,3,741,167,98,69
11,3,2276,19,10,9
11,3,983,5,0,5
11,3,211,205,119,86
11,3,1992,8,2,6
11,3,741,0,0,0
11,3,662,55,31,24
11,3,4395,13,3,10
11,3,1672,6,3,3
11,3,3775,59,32,27
11,3,1296,21,10,11
11,3,1405,176,101,75
11,3,1818,9,5,4
11,3,1546,2,0,2
11,3,1201,7,5,2
11,3,1241,5,4,1
11,3,791,11,4,7
11,3,2275,11,9,2
11,3,2978,18,7,11
11,3,1317,14,10,4
11,3,1241,7,3,4
11,3,2776,4,3,1
11,3,679,0,0,0
11,3,4046,4,0,4
11,3,1007,6,2,4
11,3,2177,18,9,9
11,3,1313,3,2,1
11,3,1257,13,7,6
11,3,461,0,0,0
11,3,1524,15,8,7
11,3,1131,36,18,18
11,3,1427,44,14,30
11,3,1157,10,5,5
11,3,1211,5,4,1
11,3,2198,31,15,16
11,3,659,2,1,1
11,3,1273,2,1,1
11,3,1409,1,0,1
11,3,1050,1,1,0
11,3,101,0,0,0
11,3,1362,1,0,1
11,3,424,0,0,0
11,3,1533,5,5,0
11,3,1654,4,2,2
11,3,654,3,3,0
11,3,1215,12,6,6
11,3,427,3,1,2
11,3,259,2,2,0
11,3,746,8,7,1
11,3,1075,0,0,0
11,3,711,0,0,0
11,4,1401,47,29,18
11,4,1553,7,3,4
11,4,1930,7,2,5
11,4,1977,12,6,6
11,4,1554,12,7,5
11,4,918,5,4,1
11,4,1002,8,3,5
11,4,3513,64,30,34
11,4,4714,30,12,18
11,4,615,2,0,2
11,4,1060,7,5,2
11,4,2413,16,10,6
11,4,2107,12,4,8
11,4,1748,14,10,4
11,4,2028,22,15,7
11,4,1894,3,1,2
11,4,1000,0,0,0
11,4,2250,20,9,11
11,4,876,24,11,13
11,4,2482,109,55,54
11,4,1872,9,5,4
11,4,2204,25,9,16
11,4,631,3,2,1
11,4,527,0,0,0
11,4,674,1,0,1
11,4,2438,3,2,1
11,4,1028,1,1,0
11,4,1991,5,2,3
11,4,1402,4,3,1
11,4,1791,6,4,2
11,4,749,21,11,10
11,4,1146,2,1,1
11,4,1250,25,12,13
11,4,681,5,1,4
11,4,374,1,0,1
11,4,1120,6,5,1
11,4,1212,6,2,4
11,4,646,3,2,1
11,4,617,7,2,5
11,4,649,6,0,6
11,4,569,4,4,0
11,4,596,9,4,5
11,4,1478,7,3,4
11,4,558,0,0,0
11,5,5363,20,4,16
11,5,3130,86,45,41
11,5,2122,14,3,11
11,5,2539,168,87,81
11,5,4324,51,25,26
11,5,2859,27,12,15
11,5,5819,22,9,13
11,5,1998,160,80,80
11,5,1422,8,7,1
11,5,1345,1,1,0
11,5,774,0,0,0
11,5,1357,3,2,1
11,5,1893,9,4,5
11,5,1686,7,6,1
11,5,2902,23,14,9
11,5,1697,42,24,18
11,5,4346,27,16,11
11,5,1281,12,9,3
11,5,829,10,1,9
11,5,2371,40,21,19
11,5,704,8,4,4
11,5,1802,10,2,8
11,5,1309,3,2,1
11,5,3367,24,10,14
11,5,1150,8,4,4
11,5,2380,6,4,2
11,5,3002,20,7,13
11,5,29388,457,226,231
11,5,1619,22,10,12
11,5,2189,30,17,13
11,5,1466,3,2,1
11,5,1740,9,3,6
11,5,1666,4,1,3
11,5,1163,56,26,30
11,5,1841,31,14,17
11,5,1511,1,0,1
11,5,2243,15,6,9
11,5,941,4,1,3
11,5,2710,4,3,1
11,5,1423,4,1,3
11,5,2013,14,9,5
11,5,1018,27,17,10
11,5,1234,8,3,5
11,6,955,0,0,0
11,6,909,0,0,0
11,6,1455,0,0,0
11,6,870,0,0,0
11,6,1209,2,1,1
11,7,24325,238,103,135
11,7,2136,48,26,22
11,7,4796,77,37,40
11,7,4906,99,48,51
11,7,2539,327,171,156
11,7,7016,64,33,31
11,7,5274,34,17,17
11,7,24024,831,418,413
11,7,3997,14,4,10
11,7,1505,10,4,6
11,7,1857,8,3,5
11,7,1437,32,14,18
11,7,1420,11,6,5
11,7,1167,8,5,3
11,7,1149,7,3,4
11,7,3570,973,510,463
11,7,1575,15,8,7
11,7,961,30,14,16
11,7,1828,9,4,5
11,7,5372,121,49,72
11,7,2188,4,2,2
11,7,613,5,1,4
11,7,1235,17,10,7
11,7,1174,20,13,7
11,7,1443,34,17,17
11,7,2631,25,13,12
11,7,1024,2,1,1
11,7,1008,3,2,1
11,7,624,1,1,0
11,7,4079,32,14,18
11,7,917,10,4,6
11,7,1132,12,4,8
11,7,850,27,11,16
11,7,1249,4,2,2
11,7,1855,8,3,5
11,7,1682,15,7,8
11,7,1552,43,21,22
11,7,1945,14,8,6
11,7,1413,13,7,6
11,7,1759,19,8,11
11,7,925,10,6,4
11,7,1187,104,60,44
11,7,1350,166,76,90
11,7,880,4,2,2
11,7,1544,17,8,9
11,7,1670,23,11,12
11,7,1801,34,21,13
11,7,2440,143,75,68
11,7,1289,83,42,41
11,7,1088,13,3,10
11,7,1476,14,9,5
11,7,983,13,8,5
11,7,747,13,4,9
11,7,1085,3,2,1
11,7,950,1,0,1
11,7,1155,5,3,2
11,7,1107,5,2,3
11,7,639,10,3,7
11,7,375,0,0,0
11,7,522,1,0,1
11,7,737,5,2,3
11,7,1100,192,98,94
11,7,1488,24,15,9
11,7,1035,11,5,6
11,7,1440,10,4,6
11,7,5939,90,48,42
11,7,684,5,2,3
11,7,502,2,2,0
11,7,618,0,0,0
11,7,637,3,0,3
11,7,941,13,6,7
11,7,966,3,1,2
11,7,779,10,5,5
11,7,800,6,1,5
11,7,825,4,1,3
11,7,11267,148,69,79
11,7,859,4,2,2
11,7,984,7,3,4
11,7,1234,9,4,5
11,7,1230,1,1,0
11,7,666,0,0,0
11,7,716,2,0,2
11,7,536,12,5,7
11,7,472,3,2,1
11,7,837,78,42,36
11,7,1276,221,109,112
11,7,801,15,6,9
11,7,930,5,1,4
11,7,1191,2,1,1
11,7,1270,9,5,4
11,7,777,24,12,12
11,7,526,31,17,14
11,7,363,3,1,2
11,7,103,0,0,0
11,7,1003,14,8,6
11,7,653,4,0,4
11,7,540,10,5,5
11,7,1321,19,12,7
11,7,1138,46,22,24
11,7,2265,10,3,7
11,7,1009,9,3,6
11,7,761,4,1,3
11,7,419,5,4,1
11,7,122,0,0,0
11,7,693,187,102,85
11,7,1709,101,56,45
11,7,1075,6,2,4
11,7,695,6,3,3
11,7,746,8,3,5
11,7,871,11,5,6
11,7,417,2,1,1
11,7,746,30,18,12
11,7,3251,34,11,23
11,7,1263,20,7,13
11,7,984,3,3,0
11,7,1521,11,7,4
11,7,890,1,1,0
11,7,937,12,5,7
11,7,1009,36,17,19
11,7,1836,11,4,7
11,7,874,136,72,64
11,7,1475,21,8,13
11,7,1483,7,4,3
11,7,5845,255,142,113
11,7,853,1,0,1
11,7,652,13,8,5
11,7,542,6,2,4
11,7,618,14,8,6
11,7,860,6,4,2
11,7,1338,39,19,20
11,7,865,11,6,5
11,7,1251,13,7,6
11,7,480,13,4,9
11,7,684,20,12,8
11,7,6367,198,94,104
11,7,2638,6,3,3
11,7,6369,92,41,51
11,7,1433,32,15,17
11,7,1500,38,19,19
11,7,2121,51,23,28
11,7,3095,10,5,5
11,7,3236,11,4,7
11,7,1987,15,9,6
11,7,2495,25,14,11
11,7,1896,22,11,11
11,7,3831,30,14,16
11,7,1922,252,136,116
11,7,1112,26,12,14
11,7,1715,8,5,3
11,7,2369,6,2,4
11,7,8272,104,60,44
11,7,1557,16,10,6
11,7,2649,8,4,4
11,7,1833,52,28,24
11,7,3596,27,15,12
11,7,6436,53,28,25
11,7,860,8,7,1
11,7,1643,6,3,3
11,7,3058,10,7,3
11,7,1044,0,0,0
11,7,2578,2,2,0
11,7,2148,7,2,5
11,7,3205,9,3,6
11,7,4069,987,514,473
11,7,2665,24,8,16
11,7,2191,446,243,203
11,7,3145,294,142,152
11,7,1917,55,31,24
11,7,4398,279,131,148
11,7,2912,2,0,2
11,7,2312,6,3,3
11,7,1364,0,0,0
11,7,2668,38,18,20
11,7,1656,6,2,4
11,7,3125,3,1,2
11,7,3116,37,20,17
11,7,2607,13,6,7
11,7,5913,48,29,19
11,7,102,0,0,0
11,7,3138,8,5,3
11,7,1595,4,3,1
11,7,1459,7,5,2
11,7,1439,3,1,2
11,7,7546,180,99,81
11,7,1978,10,7,3
11,7,1222,31,18,13
11,7,6811,82,44,38
11,7,2889,29,15,14
11,7,1685,4,1,3
11,7,12041,743,369,374
11,7,7964,122,60,62
11,7,3727,179,89,90
11,7,12949,202,85,117
11,7,2961,12,4,8
11,7,2451,152,80,72
11,7,1925,38,20,18
11,7,1713,16,8,8
11,7,1301,28,13,15
11,7,734,8,7,1
11,7,5388,83,42,41
11,7,1972,31,16,15
11,7,2023,12,2,10
11,7,1920,21,12,9
11,7,1244,2,1,1
11,7,1700,43,22,21
11,7,1780,7,3,4
11,7,1342,4,2,2
11,7,453,1,1,0
11,7,720,4,0,4
11,7,1842,19,7,12
11,7,1756,3,2,1
11,7,279,1,1,0
11,7,598,1,0,1
11,7,971,22,13,9
11,7,1769,4,1,3
11,7,1676,24,13,11
11,7,1335,17,9,8
11,7,1196,6,3,3
11,7,1898,14,7,7
11,7,1120,7,5,2
11,7,1324,13,4,9
11,7,2196,7,2,5
11,7,1583,13,5,8
11,7,584,10,6,4
11,7,228,7,2,5
11,7,2409,17,9,8
11,7,910,6,3,3
11,7,882,19,9,10
11,7,236,3,2,1
11,8,1798,0,0,0
11,8,1391,4,2,2
11,8,1018,10,2,8
11,8,1027,4,2,2
11,8,2074,21,10,11
11,8,1694,14,5,9
11,8,530,5,2,3
11,8,1534,2,1,1
11,8,3417,16,6,10
11,8,1997,8,4,4
11,8,943,29,14,15
11,8,1206,7,3,4
11,8,1460,50,28,22
11,8,251,0,0,0
11,8,403,1,1,0
11,8,1369,9,5,4
11,8,919,3,1,2
11,8,452,0,0,0
11,8,257,0,0,0
11,8,647,4,1,3
11,8,937,6,1,5
11,8,201,0,0,0
11,8,1082,9,6,3
11,8,544,7,3,4
11,8,573,0,0,0
11,8,502,1,0,1
11,8,796,0,0,0
11,8,2109,8,4,4
11,8,331,0,0,0
11,8,1219,2,0,2
11,8,1306,3,2,1
11,8,295,0,0,0
11,8,549,0,0,0
11,8,497,3,1,2
11,8,1215,1,0,1
11,8,522,1,0,1
11,8,1036,1,1,0
11,8,1560,0,0,0
11,8,173,1,0,1
11,8,1164,0,0,0
11,8,390,1,1,0
11,8,174,0,0,0
11,9,3059,4,3,1
11,9,1487,0,0,0
11,9,2121,3,1,2
11,9,2508,2,0,2
11,9,1922,4,3,1
11,9,1129,2,0,2
11,9,799,6,4,2
11,9,1358,5,5,0
11,9,699,0,0,0
11,9,2253,0,0,0
11,9,3824,18,10,8
11,9,3563,16,6,10
11,9,1648,7,5,2
11,9,1686,7,4,3
11,9,1446,1,0,1
11,9,1409,1,1,0
11,9,1394,6,5,1
11,9,1222,2,0,2
11,9,1893,14,11,3
11,9,1579,1,0,1
11,9,1570,5,1,4
11,9,2551,10,7,3
11,9,1758,218,123,95
11,9,1528,7,4,3
11,9,2520,11,6,5
11,9,1273,3,1,2
11,9,808,10,5,5
11,9,1928,18,10,8
11,9,2052,0,0,0
11,9,3762,13,12,1
11,9,2539,1,0,1
11,9,2407,8,2,6
11,9,5170,12,8,4
11,9,1810,6,3,3
11,9,822,1,0,1
11,9,774,2,0,2
11,9,3373,10,5,5
11,9,1501,2,1,1
11,9,866,6,0,6
11,9,965,8,8,0
11,9,1173,6,2,4
11,9,3047,2,1,1
11,9,1202,6,2,4
11,10,791,1,0,1
11,10,1097,0,0,0
11,10,2029,12,6,6
11,10,1665,5,1,4
11,10,672,0,0,0
11,10,803,2,2,0
11,10,903,6,4,2
11,10,121,0,0,0
11,10,2092,16,8,8
11,10,1095,60,32,28
11,11,2774,7,4,3
11,11,467,89,46,43
11,11,822,0,0,0
11,11,1295,5,3,2
11,11,2231,12,6,6
11,11,3520,40,20,20
11,11,3582,28,14,14
11,11,813,54,26,28
11,11,1494,63,30,33
11,11,1194,86,52,34
11,11,1200,13,7,6
11,11,1094,67,46,21
11,11,614,45,24,21
11,11,837,11,6,5
11,11,6728,53,19,34
11,11,989,3,1,2
11,11,890,15,8,7
11,11,1810,12,6,6
11,11,3943,30,11,19
11,11,1114,5,0,5
11,11,1418,13,8,5
11,11,939,2,1,1
11,11,2289,9,6,3
11,11,495,0,0,0
11,11,4538,55,23,32
11,11,2949,70,35,35
11,11,3442,40,21,19
11,11,1733,4,1,3
11,11,2417,25,6,19
11,11,4128,7,4,3
11,11,4676,11,4,7
11,11,361,1,1,0
11,11,3343,36,14,22
11,11,2925,8,3,5
11,11,1287,1,1,0
11,11,2712,136,65,71
11,11,1849,6,3,3
11,11,1562,11,5,6
11,11,2688,34,15,19
11,11,1367,13,6,7
11,11,902,3,2,1
11,11,1074,0,0,0
11,11,431,1,1,0
11,11,1938,5,3,2
11,11,693,0,0,0
11,11,870,7,3,4
11,11,1306,1,0,1
11,11,1027,1,1,0
11,11,1449,7,5,2
11,11,379,13,7,6
11,11,513,1,1,0
11,11,1023,14,7,7
11,11,470,6,5,1
11,11,530,1,1,0
11,11,1322,5,4,1
11,12,1279,8,4,4
11,12,968,3,0,3
11,12,739,3,1,2
11,12,1334,4,1,3
11,12,890,3,2,1
11,12,1060,0,0,0
11,12,1204,12,1,11
11,12,2693,7,3,4
11,12,3842,23,13,10
11,12,1855,9,5,4
11,12,852,1,0,1
11,12,585,5,3,2
11,12,620,0,0,0
11,12,1356,4,3,1
11,12,862,7,4,3
11,12,719,1,1,0
11,12,433,0,0,0
11,12,3186,16,10,6
11,12,766,2,0,2
11,12,3514,3,2,1
11,12,2026,1,0,1
11,13,3540,9,5,4
11,13,3272,8,3,5
11,13,1834,2,0,2
11,13,781,0,0,0
11,13,979,2,0,2
11,13,1315,0,0,0
11,13,1797,6,3,3
11,13,4669,13,6,7
11,13,3401,3,1,2
11,13,2516,12,6,6
11,13,1445,13,10,3
11,13,1612,30,18,12
11,14,3148,9,4,5
11,14,4214,70,32,38
11,14,1630,16,10,6
11,14,2754,42,20,22
11,14,3429,13,10,3
11,14,768,5,5,0
11,14,2083,9,3,6
11,14,4211,45,24,21
11,14,7910,34,17,17
11,14,1586,8,5,3
11,14,1133,1,0,1
11,14,999,11,6,5
11,14,1217,1,1,0
11,14,3055,4,4,0
11,14,2931,26,14,12
11,14,3353,39,16,23
11,14,3132,114,54,60
11,14,1950,16,8,8
11,14,1743,7,3,4
11,14,2060,18,8,10
11,14,3553,113,52,61
11,14,1877,3,2,1
11,14,5787,22,13,9
11,14,9526,114,62,52
11,14,1868,7,4,3
11,14,1416,1,1,0
11,14,2722,6,2,4
11,14,1222,8,6,2
11,14,1838,6,6,0
11,14,2331,29,13,16
11,14,1566,4,3,1
11,14,1128,7,4,3
11,14,1837,19,11,8
11,14,2159,7,2,5
11,14,1194,0,0,0
11,14,2113,3,2,1
11,14,1483,3,2,1
11,14,1125,2,1,1
11,14,2755,430,229,201
11,14,1985,8,3,5
11,14,2315,622,353,269
11,14,2572,1,1,0
11,14,1082,6,4,2
11,14,1301,0,0,0
11,14,2044,9,4,5
11,14,3236,9,6,3
11,14,1875,22,12,10
11,14,733,3,3,0
11,14,617,0,0,0
11,14,2339,5,3,2
11,14,2759,10,6,4
11,14,2692,4,2,2
11,14,2794,6,5,1
11,14,3413,10,4,6
11,14,1345,3,0,3
11,14,2001,3,0,3
11,14,3272,12,6,6
11,14,2810,5,3,2
11,14,2531,28,15,13
11,14,3113,1,1,0
11,14,364,1,0,1
11,14,1734,3,1,2
11,14,1129,2,2,0
11,14,1914,8,4,4
11,14,1512,0,0,0
11,14,1311,45,23,22
11,14,2300,120,65,55
11,14,594,24,14,10
11,14,1472,9,2,7
11,14,1536,634,356,278
11,14,1668,2,1,1
11,15,886,24,12,12
11,15,1574,57,26,31
11,15,1483,28,16,12
11,15,1020,10,3,7
11,15,1643,975,495,480
11,15,2402,164,77,87
11,15,1164,15,9,6
11,15,1102,706,381,325
11,15,1725,8,6,2
11,15,1428,20,10,10
11,15,672,14,6,8
11,15,1378,13,6,7
11,15,1749,9,6,3
11,15,2374,62,32,30
11,15,1432,36,18,18
11,15,1206,85,38,47
11,15,557,32,11,21
11,15,252,12,5,7
11,15,908,4,2,2
11,15,941,20,10,10
11,15,607,1,0,1
11,15,1110,14,5,9
11,15,1811,27,11,16
11,15,1095,25,14,11
11,15,709,0,0,0
11,15,323,0,0,0
11,15,267,2,2,0
11,15,825,26,14,12
11,15,1219,11,8,3
11,15,974,31,9,22
11,15,7429,47,26,21
11,15,2713,26,13,13
11,15,1359,20,7,13
11,15,684,13,7,6
11,15,1735,39,24,15
11,15,837,5,3,2
11,15,291,1,0,1
11,15,746,8,5,3
11,15,914,32,21,11
11,15,1108,51,27,24
11,15,992,14,6,8
11,15,1022,2,1,1
11,15,1878,8,5,3
11,15,2459,16,11,5
11,15,1553,14,8,6
11,15,498,3,1,2
11,15,1424,25,11,14
11,15,1770,20,10,10
11,15,1140,18,6,12
11,15,1629,14,7,7
11,15,2210,44,22,22
11,15,2003,87,44,43
11,15,2940,138,67,71
11,15,4733,121,70,51
11,15,1268,29,14,15
11,15,3228,28,14,14
11,15,1002,3,0,3
11,15,452,2,1,1
11,15,504,2,2,0
11,15,1346,14,5,9
11,15,325,1,0,1
11,15,1156,16,9,7
11,15,476,2,1,1
11,15,1852,19,7,12
11,15,2328,60,31,29
11,15,1874,11,6,5
11,15,2382,5,4,1
11,15,455,3,3,0
11,15,126,0,0,0
11,15,1113,2,1,1
11,15,1634,8,3,5
11,15,2201,13,8,5
11,15,4937,20,12,8
11,15,2737,4,1,3
11,15,2316,5,2,3
11,15,4485,25,15,10
11,15,6334,35,18,17
11,15,2818,24,12,12
11,15,4202,43,19,24
11,15,2280,2,1,1
11,15,2946,19,11,8
11,15,2151,390,219,171
11,15,1140,1,0,1
11,15,2656,1020,503,517
11,15,3833,2,1,1
11,15,4061,23,12,11
11,15,2710,690,357,333
11,15,1798,29,12,17
11,15,3206,47,24,23
11,15,2176,1,1,0
11,15,2279,93,52,41
11,15,3221,25,9,16
11,16,1447,1,1,0
11,16,2520,1,1,0
11,16,1764,1,0,1
11,16,1807,2,1,1
11,16,467,1,0,1
11,16,1053,3,2,1
11,16,2146,4,0,4
11,16,3384,5,2,3
11,16,1221,1,1,0
11,16,1496,0,0,0
11,16,571,1,1,0
11,16,1538,10,8,2
11,16,1694,10,7,3
11,17,5832,217,114,103
11,17,9323,108,59,49
11,17,3405,4,2,2
11,17,7833,147,79,68
11,17,1802,2,0,2
11,17,2474,13,8,5
11,17,1074,22,10,12
11,17,976,293,148,145
11,17,1865,30,11,19
11,17,1175,2,0,2
11,17,1234,20,6,14
11,17,1078,14,6,8
11,17,908,11,6,5
11,17,735,6,5,1
11,17,1498,3,1,2
11,17,3540,31,20,11
11,17,790,12,7,5
11,17,1087,15,4,11
11,17,1962,12,3,9
11,17,1241,6,1,5
11,17,970,7,3,4
11,17,1077,9,4,5
11,17,2477,15,9,6
11,17,774,12,5,7
11,17,1081,5,1,4
11,17,862,2,2,0
11,17,1146,20,10,10
11,17,1088,15,9,6
11,17,1854,28,15,13
11,17,7845,45,16,29
11,17,1493,3,2,1
11,17,2899,25,14,11
11,17,826,21,9,12
11,17,625,2,1,1
11,17,1124,24,13,11
11,17,996,2,1,1
11,17,6151,66,34,32
11,17,14234,168,78,90
11,17,8262,211,115,96
11,17,7426,9,7,2
11,17,1122,8,2,6
11,17,591,2,0,2
11,17,930,57,32,25
11,17,1317,3,2,1
11,17,6046,32,16,16
11,17,1262,0,0,0
11,17,1773,1,0,1
11,17,733,15,7,8
11,17,1106,3,1,2
11,17,1140,31,12,19
11,17,1222,8,3,5
11,17,12919,1488,782,706
11,17,1301,26,13,13
11,17,928,4,4,0
11,17,886,7,5,2
11,17,871,18,3,15
11,17,524,7,6,1
11,17,413,23,14,9
11,17,8421,58,23,35
11,17,583,8,3,5
11,17,795,23,12,11
11,17,601,6,3,3
11,17,903,14,9,5
11,17,921,10,5,5
11,17,1030,1,1,0
11,17,1025,6,3,3
11,17,1006,19,12,7
11,17,455,9,4,5
11,17,1272,14,10,4
11,17,1188,5,1,4
11,17,1560,17,13,4
11,17,5850,166,73,93
11,17,359,1,0,1
11,17,508,6,4,2
11,17,480,6,2,4
11,17,827,4,0,4
11,17,972,10,5,5
11,17,1037,16,10,6
11,17,1019,4,3,1
11,17,2942,6,2,4
11,17,956,4,2,2
11,17,1077,10,3,7
11,17,749,1,0,1
11,17,769,0,0,0
11,17,706,1,0,1
11,17,766,1,1,0
11,17,679,1,1,0
11,17,570,1,0,1
11,17,867,1,0,1
11,17,753,14,7,7
11,17,845,2,2,0
11,17,781,1,1,0
11,17,1029,4,2,2
11,17,954,2,2,0
11,17,734,2,1,1
11,17,1125,15,7,8
11,17,1645,0,0,0
11,17,1589,27,11,16
11,17,1887,15,4,11
11,17,2143,6,2,4
11,17,1419,22,11,11
11,17,563,5,2,3
11,17,524,5,3,2
11,17,845,10,4,6
11,17,499,18,8,10
11,17,1191,2,1,1
11,17,1337,1,1,0
11,17,4938,134,67,67
11,17,2043,6,3,3
11,17,2768,106,58,48
11,17,1293,7,2,5
11,17,1350,7,4,3
11,17,1274,4,2,2
11,17,893,1,1,0
11,17,580,3,0,3
11,17,1120,1,1,0
11,17,863,10,6,4
11,17,1150,3,1,2
11,17,1062,11,3,8
11,17,730,7,3,4
11,17,871,11,4,7
11,17,1048,0,0,0
11,17,1756,39,14,25
11,17,1640,6,3,3
11,17,1492,14,7,7
11,17,1200,41,20,21
11,17,1009,7,6,1
11,17,1255,45,27,18
11,17,1487,10,4,6
11,17,1376,1,1,0
11,17,17029,216,108,108
11,17,4037,81,34,47
11,17,1101,0,0,0
11,17,1175,5,1,4
11,17,1680,34,17,17
11,17,1427,1,0,1
11,17,1218,20,6,14
11,17,1131,9,3,6
11,17,1464,14,5,9
11,17,1340,49,22,27
11,17,1192,41,21,20
11,17,1158,0,0,0
11,17,1159,7,3,4
11,17,1135,0,0,0
11,17,1145,26,14,12
11,17,1541,11,2,9
11,17,1332,2,0,2
11,17,1215,20,9,11
11,17,4711,25,8,17
11,17,12871,115,55,60
11,17,736,8,1,7
11,17,1583,11,5,6
11,17,1038,12,9,3
11,17,1588,16,5,11
11,17,807,15,4,11
11,17,1675,15,9,6
11,17,1269,6,3,3
11,17,1039,12,6,6
11,17,1479,6,5,1
11,17,1253,8,3,5
11,17,1612,15,8,7
11,17,1225,42,22,20
11,17,1536,11,4,7
11,17,1187,6,5,1
11,17,1634,9,4,5
11,17,1491,10,5,5
11,17,1734,3,2,1
11,17,1892,18,5,13
11,17,1183,14,6,8
11,17,1562,16,9,7
11,17,20266,182,83,99
11,17,1539,15,7,8
11,17,1355,7,3,4
11,17,1941,9,5,4
11,17,3797,15,8,7
11,17,2706,21,5,16
11,17,2319,58,33,25
11,17,5692,73,37,36
11,17,4816,83,41,42
11,17,1545,8,5,3
11,17,1275,14,9,5
11,17,17716,138,65,73
11,17,1299,6,4,2
11,17,841,1,1,0
11,17,2355,5,5,0
11,17,2308,19,7,12
11,17,3535,14,8,6
11,17,3579,6,2,4
11,17,2379,28,11,17
11,17,2661,13,8,5
11,17,3316,15,7,8
11,17,2779,4,2,2
11,17,2488,63,36,27
11,17,2745,31,11,20
11,17,2370,2,0,2
11,17,2524,15,11,4
11,17,2106,8,4,4
11,17,2108,5,3,2
11,17,1343,83,44,39
11,17,1424,5,2,3
11,17,3296,11,5,6
11,17,2478,12,4,8
11,17,3818,22,11,11
11,17,2291,5,3,2
11,17,1586,8,5,3
11,17,2179,6,2,4
11,17,1005,6,3,3
11,17,1660,2,1,1
11,17,7507,32,12,20
11,17,2817,15,8,7
11,17,5588,1042,525,517
11,17,3628,15,5,10
11,17,2634,13,6,7
11,17,1677,6,3,3
11,17,750,6,1,5
11,17,2097,20,11,9
11,17,1750,9,8,1
11,17,544,0,0,0
11,17,5639,68,37,31
11,17,5097,13,5,8
11,17,3984,57,32,25
11,17,3248,14,6,8
11,17,9644,272,122,150
11,17,3356,19,4,15
11,17,3573,23,8,15
11,17,1714,78,41,37
11,17,6894,57,25,32
11,17,528,3,0,3
11,17,3888,31,13,18
11,17,4839,30,10,20
11,17,2124,8,3,5
11,17,2138,6,2,4
11,17,2279,14,5,9
11,17,3146,6,4,2
11,17,2770,2,1,1
11,17,4134,12,7,5
11,17,3648,1,0,1
11,17,2537,5,2,3
11,17,4580,36,16,20
11,17,4641,70,40,30
11,17,3074,13,6,7
11,17,1694,6,3,3
11,17,1699,6,2,4
11,17,3136,15,4,11
11,17,2058,19,10,9
11,17,2433,20,15,5
11,17,1680,2,1,1
11,17,7894,38,19,19
11,17,2548,9,4,5
11,18,2699,26,9,17
11,18,976,22,9,13
11,18,545,0,0,0
11,18,296,2,0,2
11,18,1397,3,2,1
11,18,4543,27,20,7
11,18,1824,9,4,5
11,18,1347,2,1,1
11,18,1509,3,1,2
11,18,1474,4,3,1
11,18,3374,86,44,42
11,18,1840,63,36,27
11,18,1240,0,0,0
11,18,2311,30,14,16
11,18,2180,6,3,3
11,18,1288,7,3,4
11,18,1197,4,2,2
11,18,1592,10,7,3
11,18,1622,3,2,1
11,18,1449,1,0,1
11,18,1041,4,2,2
11,18,580,6,3,3
11,18,771,1,0,1
11,18,752,1,1,0
11,18,479,1,1,0
11,18,478,0,0,0
11,19,1010,30,17,13
11,19,2149,7,3,4
11,19,1510,28,13,15
11,19,791,101,56,45
11,19,1579,2,0,2
11,19,1297,12,8,4
11,19,2360,2,0,2
11,19,716,0,0,0
11,19,735,5,3,2
11,19,408,0,0,0
11,19,812,8,5,3
11,19,1160,0,0,0
11,19,355,2,2,0
11,19,715,4,1,3
11,19,1387,39,19,20
11,19,543,0,0,0
11,19,1006,0,0,0
11,19,378,1,1,0
11,19,659,1,0,1
11,19,672,0,0,0
11,19,1005,2,1,1
11,19,1131,3,3,0
11,19,993,0,0,0
11,19,692,1,1,0
11,19,389,1,1,0
11,19,1482,5,1,4
11,19,1458,6,2,4
11,19,143,0,0,0
11,19,423,0,0,0
11,19,669,0,0,0
11,19,349,0,0,0
11,19,831,0,0,0
11,19,538,0,0,0
11,19,357,1,0,1
11,19,244,0,0,0
11,19,368,0,0,0
11,19,118,3,1,2
11,19,2204,10,7,3
11,19,723,0,0,0
11,19,807,2,1,1
11,19,1313,0,0,0
11,19,405,0,0,0
11,19,776,11,7,4
11,19,814,1,1,0
11,19,1083,5,4,1
11,19,749,2,1,1
11,19,693,3,1,2
11,19,946,3,1,2
11,19,438,1,1,0
11,19,1745,3,1,2
11,19,1226,1,1,0
11,19,446,0,0,0
11,19,915,0,0,0
11,19,1036,2,1,1
11,19,1588,8,3,5
11,19,297,0,0,0
11,20,7771,46,20,26
11,20,2338,72,30,42
11,20,1464,17,9,8
11,20,2020,11,2,9
11,20,5483,60,29,31
11,20,4602,99,63,36
11,20,7436,37,22,15
11,20,7555,49,23,26
11,20,9236,27,11,16
11,20,2254,29,12,17
11,20,2140,7,5,2
11,20,2606,40,24,16
11,20,2116,35,19,16
11,20,4427,61,28,33
11,20,3167,121,54,67
11,20,11244,129,56,73
11,20,6236,436,235,201
11,20,12843,424,202,222
11,20,4113,140,74,66
11,20,1511,155,83,72
11,20,2253,16,12,4
11,20,14516,131,76,55
11,20,6617,204,94,110
11,20,12805,273,135,138
11,20,10949,191,104,87
11,20,2711,45,21,24
11,20,3883,140,73,67
11,20,1633,8,2,6
11,20,2365,157,81,76
11,20,298,11,8,3
11,20,678,10,5,5
11,20,2826,97,57,40
11,20,1334,81,45,36
11,20,1285,5,4,1
11,20,1517,12,5,7
11,20,1006,10,4,6
11,20,9828,46,17,29
11,20,4618,69,35,34
11,20,967,11,3,8
11,20,1905,32,16,16
11,20,2049,15,11,4
11,20,1234,3,2,1
11,20,1342,78,38,40
11,20,11245,267,139,128
11,20,1006,1,0,1
11,20,1660,7,7,0
11,20,1459,5,2,3
11,20,5563,38,14,24
11,20,4173,10,5,5
11,20,3058,354,184,170
11,20,830,23,14,9
11,20,2025,20,10,10
11,20,1300,47,26,21
11,20,1343,12,7,5
11,20,1056,3,1,2
11,20,1240,424,224,200
11,20,1211,301,154,147
11,20,823,11,7,4
11,20,1065,12,5,7
11,20,1730,6,2,4
11,20,1338,27,16,11
11,20,7060,115,60,55
11,20,3588,108,56,52
11,20,1609,13,6,7
11,20,1399,8,7,1
11,20,1140,13,3,10
11,20,680,88,48,40
11,20,1166,51,32,19
11,20,899,4,1,3
11,20,1590,48,30,18
11,20,1442,17,2,15
11,20,1414,12,4,8
11,20,2023,65,30,35
11,20,2376,134,58,76
11,20,2049,16,8,8
11,20,1149,9,5,4
11,20,3927,50,27,23
11,20,933,5,4,1
11,20,1205,3,2,1
11,20,1395,4,3,1
11,20,1429,0,0,0
11,20,1314,13,5,8
11,20,3920,23,11,12
11,20,1481,8,3,5
11,20,1220,10,3,7
11,20,1245,3,1,2
11,20,1523,32,18,14
11,20,1514,11,5,6
11,20,5587,35,17,18
11,20,1171,13,9,4
11,20,1386,5,2,3
11,20,1625,3,1,2
11,20,1093,18,11,7
11,20,1277,22,9,13
11,20,1256,2,2,0
11,20,1384,2,1,1
11,20,1124,2,1,1
11,20,1071,15,10,5
11,20,989,15,8,7
11,20,1172,39,22,17
11,20,1225,7,5,2
11,20,1325,6,4,2
11,20,1433,43,25,18
11,20,1716,23,14,9
11,20,8378,379,194,185
11,20,1269,2,2,0
11,20,2602,20,11,9
11,20,1007,4,1,3
11,20,1627,9,4,5
11,20,1463,59,38,21
11,20,1125,2,1,1
11,20,1590,0,0,0
11,20,917,5,3,2
11,20,1060,9,4,5
11,20,809,5,3,2
11,20,641,3,0,3
11,20,678,11,6,5
11,20,787,7,2,5
11,20,1010,5,3,2
11,20,461,0,0,0
11,20,575,6,2,4
11,20,1114,6,3,3
11,20,554,6,4,2
11,20,814,4,0,4
11,20,1563,38,17,21
11,20,1020,3,1,2
11,20,2017,2,2,0
11,20,1314,3,0,3
11,20,1369,12,4,8
11,20,2530,926,474,452
11,20,6561,307,168,139
11,20,1510,106,52,54
11,20,1436,13,6,7
11,20,1569,76,40,36
11,20,2332,7,4,3
11,20,1314,1,1,0
11,20,1121,2,1,1
11,20,302,15,9,6
11,20,620,30,16,14
11,20,373,8,4,4
11,20,426,10,5,5
11,20,561,8,4,4
11,20,886,26,21,5
11,20,832,2,1,1
11,20,434,2,1,1
11,20,686,4,1,3
11,20,1001,1,1,0
11,20,1202,11,6,5
11,20,1249,7,3,4
11,20,1596,22,7,15
11,20,1705,222,122,100
11,20,1194,127,69,58
11,20,3928,28,15,13
11,20,2912,54,29,25
11,20,1193,3,3,0
11,20,821,1,0,1
11,20,696,2,1,1
11,20,392,0,0,0
11,20,629,5,5,0
11,20,606,262,135,127
11,20,399,7,2,5
11,20,205,15,8,7
11,20,560,30,18,12
11,20,514,14,9,5
11,20,413,6,2,4
11,20,430,166,91,75
11,20,679,260,141,119
11,20,395,0,0,0
11,20,494,2,2,0
11,20,347,0,0,0
11,20,340,2,1,1
11,20,392,0,0,0
11,20,486,1,0,1
11,20,753,3,1,2
11,20,1376,785,391,394
11,20,1958,38,22,16
11,20,1716,28,17,11
11,20,1015,16,10,6
11,20,939,24,13,11
11,20,328,12,5,7
11,20,444,1,0,1
11,20,626,0,0,0
11,20,453,19,12,7
11,20,234,2,0,2
11,20,334,4,2,2
11,20,473,13,7,6
11,20,536,0,0,0
11,20,441,30,13,17
11,20,5065,925,487,438
11,20,1485,158,78,80
11,20,1367,479,242,237
11,20,1643,539,278,261
11,20,415,8,5,3
11,20,363,3,1,2
11,20,536,6,4,2
11,20,320,8,7,1
11,20,341,6,4,2
11,20,537,16,11,5
11,20,554,7,4,3
11,20,929,14,4,10
11,20,430,27,13,14
11,20,678,6,2,4
11,20,811,36,20,16
11,20,1130,24,14,10
11,20,1132,35,12,23
11,20,1073,24,15,9
11,20,2576,14,7,7
11,20,997,18,11,7
11,20,86,1,0,1
11,20,401,1,0,1
11,20,457,0,0,0
11,20,4523,41,24,17
11,20,1019,1,0,1
11,20,428,1,1,0
11,20,301,0,0,0
11,20,1344,6,3,3
11,20,4379,122,66,56
11,20,4751,46,22,24
11,20,7882,513,274,239
11,20,1300,3,1,2
11,20,12273,214,105,109
11,20,21830,830,397,433
11,20,6317,42,17,25
11,20,2814,10,4,6
11,20,10185,223,107,116
11,20,2886,23,13,10
11,20,11258,2330,1144,1186
11,20,37513,717,348,369
11,20,7607,1081,535,546
11,20,10555,244,118,126
11,20,12723,67,30,37
11,20,13701,90,42,48
11,20,20479,1162,592,570
11,20,3591,16,9,7
11,20,1441,7,5,2
11,20,2401,35,20,15
11,20,5885,118,59,59
11,20,11991,288,138,150
11,20,1031,2,1,1
11,20,4123,13,4,9
11,20,1546,3,2,1
11,20,2169,7,2,5
11,20,2336,2,1,1
11,20,18132,245,119,126
11,20,6066,14,6,8
11,20,15091,73,33,40
11,20,2497,13,9,4
11,20,2339,3,1,2
11,20,2822,27,15,12
11,20,595,10,5,5
11,20,646,5,1,4
11,20,1064,4,2,2
11,20,1010,26,19,7
11,20,1627,3,1,2
11,20,852,7,4,3
11,20,434,2,0,2
11,20,469,6,1,5
11,20,822,25,14,11
11,20,703,23,7,16
11,20,606,9,3,6
11,20,823,2,0,2
11,20,1076,7,5,2
11,20,474,2,0,2
11,20,621,6,3,3
11,20,923,30,18,12
11,20,1372,2,1,1
11,20,1253,27,16,11
11,20,1533,36,20,16
11,20,1083,11,4,7
11,20,899,50,24,26
11,20,865,11,6,5
11,20,833,9,6,3
11,20,1447,0,0,0
11,20,1425,1,0,1
11,20,1256,38,20,18
11,20,795,5,4,1
11,20,556,1,0,1
11,20,494,4,3,1
11,20,793,16,9,7
11,20,485,0,0,0
11,20,827,20,8,12
11,20,1039,5,2,3
11,20,1359,2,0,2
11,20,1180,17,8,9
11,20,724,7,3,4
11,20,657,2,1,1
11,20,473,10,4,6
11,20,1264,11,7,4
11,20,1349,3,2,1
11,20,1275,7,4,3
11,20,1347,30,15,15
11,20,1268,385,197,188
11,20,1290,722,371,351
11,20,2312,9,3,6
11,20,1317,30,17,13
11,20,1112,5,3,2
11,20,2220,62,29,33
11,20,1351,67,28,39
11,20,1055,72,38,34
11,20,1095,132,67,65
11,20,963,19,10,9
11,20,1154,44,21,23
11,20,1163,12,7,5
11,20,825,217,114,103
11,20,1161,0,0,0
11,20,1479,29,14,15
11,20,569,2,1,1
11,20,673,4,3,1
11,20,578,7,2,5
11,20,1078,99,57,42
11,20,1012,67,36,31
11,20,711,11,7,4
11,20,1026,3,2,1
11,20,755,0,0,0
11,20,537,2,0,2
11,20,581,0,0,0
11,20,1679,22,11,11
11,20,1237,34,18,16
11,20,2153,20,10,10
11,20,1063,27,10,17
11,20,8056,107,49,58
11,20,1149,5,3,2
11,20,1206,20,11,9
11,20,2032,36,21,15
11,20,1776,13,7,6
11,20,2092,3,3,0
11,20,3271,824,420,404
11,20,1614,9,4,5
11,20,1784,21,9,12
11,20,1387,10,3,7
11,20,1099,60,28,32
11,20,1079,12,8,4
11,20,656,0,0,0
11,20,969,2,1,1
11,20,838,7,4,3
11,20,1238,12,5,7
11,20,1074,7,5,2
11,20,677,5,2,3
11,20,1397,1,1,0
11,20,3981,25,15,10
11,20,1569,7,4,3
11,20,1077,7,5,2
11,20,689,67,41,26
11,20,1254,16,5,11
11,20,1583,10,3,7
11,20,1370,27,13,14
11,20,2521,25,9,16
11,20,1643,1,0,1
11,20,10258,165,80,85
11,20,23916,344,195,149
11,20,974,10,6,4
11,20,1037,1,0,1
11,20,1901,41,21,20
11,20,1145,11,5,6
11,20,1143,1,1,0
11,20,7466,142,71,71
11,20,1200,5,1,4
11,20,1177,30,12,18
11,20,1474,7,1,6
11,20,1151,10,5,5
11,20,2405,300,156,144
11,20,2699,23,15,8
11,20,4283,139,66,73
11,20,1096,7,3,4
11,20,2732,24,15,9
11,20,1044,29,14,15
11,20,5454,62,28,34
11,20,10872,173,77,96
11,20,18624,309,155,154
11,20,4168,118,58,60
11,20,1273,2,1,1
11,20,1353,10,4,6
11,20,1562,5,1,4
11,20,1530,474,235,239
11,20,1787,7,3,4
11,20,7355,60,28,32
11,20,23781,359,173,186
11,20,12235,368,171,197
11,20,11503,49,25,24
11,20,5339,23,13,10
11,20,5271,437,221,216
11,20,19865,272,126,146
11,20,966,0,0,0
11,20,2981,1043,523,520
11,20,2586,21,8,13
11,20,5410,19,9,10
11,20,11136,50,25,25
11,20,11285,150,70,80
11,20,1863,10,2,8
11,20,3091,13,4,9
11,20,1505,10,5,5
11,20,2560,13,3,10
11,20,9054,89,49,40
11,20,2307,14,7,7
11,20,1225,6,5,1
11,20,3762,25,13,12
11,20,4007,52,31,21
11,20,2686,15,7,8
11,20,4730,12,7,5
11,20,6961,14,6,8
11,20,1405,0,0,0
11,20,3774,29,13,16
11,20,2785,45,18,27
11,20,3343,8,3,5
11,20,1738,26,11,15
11,20,2213,34,19,15
11,20,2423,87,42,45
11,20,1051,9,5,4
11,20,4254,144,73,71
11,20,5545,86,40,46
11,20,1580,12,3,9
11,20,6233,150,76,74
11,20,1056,58,31,27
11,20,1019,33,19,14
11,20,1476,13,2,11
11,20,13085,191,88,103
11,20,1491,9,5,4
11,20,1054,6,3,3
11,20,729,16,9,7
11,20,1075,64,35,29
11,20,952,238,132,106
11,20,5492,100,46,54
11,20,1034,30,10,20
11,20,1458,28,12,16
11,20,2321,56,28,28
11,20,1536,28,13,15
11,20,1820,55,31,24
11,20,1560,33,16,17
11,20,3420,27,11,16
11,20,3013,358,172,186
11,20,1819,492,247,245
11,20,3437,156,73,83
11,20,871,47,23,24
11,20,923,26,13,13
11,20,1691,25,10,15
11,20,1093,42,24,18
11,20,1536,35,19,16
11,20,567,47,24,23
11,20,709,6,4,2
11,20,925,29,13,16
11,20,1208,4,1,3
11,20,617,25,11,14
11,20,837,37,23,14
11,20,1329,3,0,3
11,20,960,101,51,50
11,20,9152,174,86,88
11,20,795,14,5,9
11,20,686,10,4,6
11,20,790,36,20,16
11,20,770,6,4,2
11,20,815,2,1,1
11,20,676,15,8,7
11,20,1076,1,1,0
11,20,1368,15,8,7
11,20,925,175,80,95
11,20,1235,13,8,5
11,20,1377,11,6,5
11,20,937,7,5,2
11,20,1355,2,1,1
11,20,600,6,3,3
11,20,961,15,6,9
11,20,776,13,5,8
11,20,493,1,1,0
11,20,769,21,11,10
11,20,827,59,30,29
11,20,1580,9,4,5
11,20,2187,62,27,35
11,20,1762,10,4,6
11,20,1463,45,21,24
11,20,1034,10,9,1
11,20,813,8,2,6
11,20,897,37,12,25
11,20,638,0,0,0
11,20,1297,42,21,21
11,20,866,12,7,5
11,20,4289,190,89,101
11,20,1161,3,1,2
11,20,584,4,1,3
11,20,795,3,1,2
11,20,1599,1,1,0
11,20,950,9,3,6
11,20,3807,52,24,28
11,20,1271,1,0,1
11,20,1166,71,33,38
11,20,1497,51,24,27
11,20,1569,6,3,3
11,20,1376,12,6,6
11,20,1490,4,1,3
11,20,1417,7,4,3
11,20,939,47,26,21
11,20,695,46,18,28
11,20,409,0,0,0
11,20,794,17,5,12
11,20,1211,4,3,1
11,20,1193,4,2,2
11,20,685,3,1,2
11,20,746,6,5,1
11,20,778,7,3,4
11,20,938,2,1,1
11,20,1271,5,1,4
11,20,1041,4,2,2
11,20,1114,9,4,5
11,20,2089,33,19,14
11,20,1457,17,7,10
11,20,1531,26,11,15
11,20,1094,33,16,17
11,20,800,45,22,23
11,20,2918,167,88,79
11,20,1404,12,5,7
11,20,1151,20,12,8
11,20,708,5,2,3
11,20,760,13,6,7
11,20,705,31,15,16
11,20,1024,8,5,3
11,20,1266,11,4,7
11,20,1064,17,10,7
11,20,1357,10,7,3
11,20,1182,18,11,7
11,20,1043,28,14,14
11,20,1083,66,34,32
11,20,1144,16,11,5
11,20,4752,140,72,68
11,20,459,9,4,5
11,20,969,78,40,38
11,20,1032,20,6,14
11,20,1230,38,16,22
11,20,1477,14,6,8
11,20,1119,56,28,28
11,20,10601,197,103,94
11,20,1302,199,101,98
11,20,1436,41,21,20
11,20,1124,10,5,5
11,20,673,15,9,6
11,20,504,5,2,3
11,20,1067,19,12,7
11,20,804,4,3,1
11,20,1714,17,8,9
11,20,1952,8,3,5
11,20,618,9,4,5
11,20,712,5,1,4
11,20,1017,29,15,14
11,20,968,6,2,4
11,20,927,15,4,11
11,20,8636,88,45,43
11,20,1603,0,0,0
11,20,716,11,7,4
11,20,712,14,11,3
11,20,2612,71,40,31
11,20,2169,119,64,55
11,20,546,1,0,1
11,20,836,15,9,6
11,20,1073,5,3,2
11,20,1363,1,1,0
11,20,650,4,2,2
11,20,566,0,0,0
11,20,646,0,0,0
11,20,1568,146,70,76
11,20,1189,0,0,0
11,20,963,1,0,1
11,20,1204,5,3,2
11,20,1951,39,22,17
11,20,1597,24,11,13
11,20,990,8,6,2
11,20,936,2,1,1
11,20,1091,1,1,0
11,20,2082,359,189,170
11,20,1407,7,2,5
11,20,1316,19,10,9
11,20,1334,7,3,4
11,20,1105,4,3,1
11,20,1257,22,14,8
11,20,1349,6,4,2
11,20,1616,6,4,2
11,20,1487,66,29,37
11,20,1394,32,17,15
11,20,1381,21,5,16
11,20,797,1,1,0
11,20,821,41,19,22
11,20,1171,18,10,8
11,20,4456,181,92,89
11,20,4672,39,23,16
11,20,1179,165,85,80
11,20,1263,169,85,84
11,20,960,83,49,34
11,20,1273,111,45,66
11,20,1074,30,11,19
11,20,1189,18,9,9
11,20,1323,7,4,3
11,20,1255,19,13,6
11,20,1462,20,11,9
11,20,2238,30,14,16
11,20,1494,6,2,4
11,21,2620,7,2,5
11,21,1927,2,1,1
11,21,1161,2,1,1
11,21,778,4,0,4
11,21,862,6,3,3
11,21,993,0,0,0
11,21,638,8,3,5
11,21,1045,164,78,86
11,21,886,0,0,0
11,21,665,2,2,0
11,21,1014,3,2,1
11,21,1278,10,8,2
11,21,1117,2,0,2
11,21,4512,21,12,9
11,21,1722,6,4,2
11,21,899,2,1,1
11,21,1293,2,1,1
11,21,1045,2,2,0
11,21,550,4,2,2
11,21,442,4,2,2
11,21,211,0,0,0
11,21,1473,3,1,2
11,21,931,3,1,2
11,21,5584,23,10,13
11,21,1426,5,4,1
11,21,1789,11,5,6
11,21,1814,6,1,5
11,21,629,3,2,1
11,21,531,2,2,0
11,21,188,1,0,1
11,21,520,2,2,0
11,21,4243,31,15,16
11,21,673,4,2,2
11,21,894,0,0,0
11,21,1004,1,1,0
11,22,1247,3,2,1
11,22,2147,16,8,8
11,22,1103,138,70,68
11,22,2878,109,58,51
11,22,1994,1,1,0
11,22,1044,0,0,0
11,22,457,0,0,0
11,22,2617,6,4,2
11,22,1233,2,0,2
11,22,1162,3,2,1
11,22,973,1,0,1
11,22,1328,0,0,0
11,22,1511,0,0,0
11,22,1707,4,2,2
11,22,964,1,1,0
11,22,462,3,1,2
11,22,2092,14,6,8
11,22,1621,7,5,2
11,23,4339,297,149,148
11,23,3202,451,249,202
11,23,1079,2,0,2
11,23,1584,4,1,3
11,23,2626,36,17,19
11,23,2140,62,29,33
11,23,948,2,2,0
11,23,718,121,70,51
11,23,1462,13,8,5
11,23,940,4,2,2
11,23,1229,3,1,2
11,23,2106,16,5,11
11,23,1229,9,5,4
11,23,620,7,2,5
11,23,963,0,0,0
11,23,3848,54,29,25
11,23,1507,1,1,0
11,23,1728,8,5,3
11,23,1418,3,2,1
11,23,5682,15,6,9
11,23,3692,9,3,6
11,23,247,2,0,2
11,23,326,3,3,0
11,23,340,0,0,0
11,23,167,0,0,0
11,23,123,0,0,0
11,23,107,0,0,0
11,23,379,0,0,0
11,23,1296,2,0,2
11,23,504,4,2,2
11,23,1132,5,3,2
11,23,1263,0,0,0
11,23,1176,4,3,1
11,23,1078,35,19,16
11,23,486,15,10,5
11,23,2062,4,2,2
11,23,1575,4,1,3
11,23,1044,0,0,0
11,23,706,0,0,0
11,23,280,2,1,1
11,23,660,1,0,1
11,23,696,1,1,0
11,23,2045,11,4,7
11,23,1566,6,4,2
11,23,1721,3,2,1
11,23,1029,4,3,1
11,23,562,0,0,0
11,23,1366,9,4,5
11,23,1678,16,7,9
11,23,1043,0,0,0
11,23,1511,2,1,1
11,23,2110,3,3,0
11,23,1470,15,10,5
11,23,1191,8,2,6
11,23,1453,3,2,1
11,23,1868,4,1,3
11,23,2336,1,1,0
11,23,2744,10,6,4
11,23,1528,6,4,2
11,23,1549,8,3,5
11,23,1019,0,0,0
11,23,1429,3,1,2
11,23,3536,11,4,7
11,23,1651,1,0,1
11,23,2743,13,9,4
11,23,1622,7,3,4
11,23,509,17,6,11
11,23,1330,2,1,1
11,23,954,479,257,222
11,23,1294,29,18,11
11,23,2646,11,6,5
11,23,1062,2,1,1
11,23,1516,2,2,0
11,23,1071,4,3,1
11,23,1920,3,2,1
11,23,2026,54,25,29
11,23,1653,25,11,14
11,23,952,4,2,2
11,23,1460,5,2,3
11,23,1342,4,0,4
11,23,633,0,0,0
11,23,905,11,8,3
11,23,706,2,1,1
11,23,880,4,0,4
11,23,1719,18,6,12
11,23,992,1,0,1
11,23,1576,0,0,0
11,23,1080,0,0,0
11,23,588,0,0,0
11,23,995,4,2,2
11,23,1122,4,1,3
11,23,1497,1,1,0
11,23,725,0,0,0
11,23,1599,15,7,8
11,23,1139,1,0,1
11,23,1230,14,9,5
11,23,1592,0,0,0
11,23,1316,1,1,0
11,23,657,0,0,0
11,23,1188,0,0,0
11,23,878,0,0,0
11,23,918,9,4,5
11,23,802,1,1,0
11,23,567,1,0,1
11,23,882,1,0,1
11,23,1705,3,2,1
11,23,2051,12,4,8
11,23,990,3,2,1
11,23,994,0,0,0
11,23,734,4,2,2
11,23,395,0,0,0
11,23,552,9,3,6
11,23,555,3,1,2
11,23,1577,2,1,1
11,24,2613,10,3,7
11,24,655,0,0,0
11,24,1097,4,2,2
11,24,3214,4,2,2
11,24,1434,3,1,2
11,24,927,2,2,0
11,24,991,0,0,0
11,24,500,5,1,4
11,25,5477,29,19,10
11,25,6120,80,38,42
11,25,12340,558,280,278
11,25,592,1,1,0
11,25,2279,14,7,7
11,25,3462,55,26,29
11,25,855,3,2,1
11,25,1636,24,10,14
11,25,12237,269,135,134
11,25,3435,6,1,5
11,25,8896,97,38,59
11,25,3797,69,35,34
11,25,7471,47,25,22
11,25,2276,34,16,18
11,25,2524,10,6,4
11,25,2389,7,3,4
11,25,1620,1,0,1
11,25,1830,5,4,1
11,25,2253,0,0,0
11,25,1463,1,0,1
11,25,867,2,1,1
11,25,1017,1,1,0
11,25,575,0,0,0
11,25,1146,4,0,4
11,25,2694,17,9,8
11,26,2234,27,11,16
11,26,1959,6,2,4
11,26,1061,4,1,3
11,26,1240,6,5,1
11,26,1446,110,62,48
11,26,1322,55,31,24
11,26,3097,20,10,10
11,26,3058,7,2,5
11,26,969,5,1,4
11,26,1669,10,4,6
11,26,1400,3,0,3
11,26,4018,24,12,12
11,26,2304,9,6,3
11,26,2483,1,0,1
11,26,308,2,0,2
11,26,3467,0,0,0
11,26,838,2,2,0
11,26,755,0,0,0
11,26,433,1,1,0
11,26,618,0,0,0
11,26,1580,11,7,4
11,26,799,2,0,2
11,26,815,0,0,0
11,26,693,0,0,0
11,26,354,0,0,0
11,26,1586,16,7,9
11,26,1451,3,1,2
11,26,2624,19,11,8
11,26,1060,1,1,0
11,26,2171,0,0,0
11,26,878,20,13,7
11,26,442,0,0,0
11,26,167,1,0,1
11,26,1076,0,0,0
11,26,603,0,0,0
11,26,258,0,0,0
11,26,2142,1,1,0
11,26,951,1,1,0
11,26,1033,1,1,0
11,26,1875,4,3,1
11,26,1243,4,2,2
11,26,396,0,0,0
11,26,631,0,0,0
11,26,1495,23,14,9
11,26,670,6,4,2
11,26,274,0,0,0
11,26,1219,0,0,0
11,26,1209,2,2,0
11,26,957,4,3,1
11,26,852,0,0,0
11,27,7797,230,107,123
11,27,5583,51,27,24
11,27,3265,100,57,43
11,27,1733,14,8,6
11,27,700,1,0,1
11,27,961,22,12,10
11,27,794,50,29,21
11,27,497,6,2,4
11,27,767,65,33,32
11,27,765,0,0,0
11,27,640,2,1,1
11,27,796,1,1,0
11,27,5188,32,24,8
11,27,467,0,0,0
11,27,738,7,5,2
11,27,613,1,1,0
11,27,686,13,9,4
11,27,621,2,1,1
11,27,1409,0,0,0
11,27,658,1,0,1
11,27,1290,2,1,1
11,27,573,42,21,21
11,27,801,4,3,1
11,27,992,4,3,1
11,27,942,3,0,3
11,27,4126,82,31,51
11,27,993,1,0,1
11,27,1065,1,1,0
11,27,523,12,7,5
11,27,411,14,11,3
11,27,693,0,0,0
11,27,954,1,0,1
11,27,1538,9,6,3
11,27,450,6,1,5
11,27,935,4,2,2
11,27,1173,8,4,4
11,27,612,0,0,0
11,27,1147,3,1,2
11,27,822,7,3,4
11,27,865,19,11,8
11,27,392,2,2,0
11,27,1217,4,1,3
11,27,914,1,0,1
11,27,591,0,0,0
11,27,617,2,1,1
11,27,669,1,1,0
11,27,557,1,0,1
11,27,508,0,0,0
11,27,576,3,2,1
11,27,424,5,2,3
11,27,1066,14,7,7
11,27,1146,6,3,3
11,27,824,0,0,0
11,27,1500,4,3,1
11,27,8846,194,105,89
11,27,3975,55,20,35
11,27,564,3,2,1
11,27,1519,8,4,4
11,27,748,2,0,2
11,27,928,0,0,0
11,27,1515,3,0,3
11,27,895,11,6,5
11,27,952,1,1,0
11,27,511,1,1,0
11,27,362,3,3,0
11,27,427,8,2,6
11,27,767,5,2,3
11,27,2754,21,9,12
11,27,3901,30,13,17
11,27,5160,44,27,17
11,27,5228,72,30,42
11,27,2556,25,13,12
11,27,5798,256,129,127
11,27,885,3,1,2
11,27,1076,5,3,2
11,27,3451,2,0,2
11,27,6577,713,375,338
11,27,1451,5,0,5
11,27,1391,2,1,1
11,27,2291,8,4,4
11,27,487,0,0,0
11,27,5401,41,21,20
11,27,1061,2,1,1
11,27,893,6,5,1
11,27,11059,131,67,64
11,27,3173,20,8,12
11,27,1043,9,4,5
11,27,786,0,0,0
11,27,6587,26,11,15
11,27,3504,14,6,8
11,27,632,1,0,1
11,27,1439,3,3,0
11,27,315,1,1,0
11,27,1043,7,5,2
11,27,894,3,0,3
11,27,2368,3,1,2
11,27,693,2,1,1
11,27,1529,2,0,2
11,27,1296,2,1,1
11,27,1776,8,5,3
11,27,1849,9,7,2
11,27,1200,2,0,2
11,27,1017,3,2,1
11,27,1309,13,3,10
11,27,881,1,0,1
11,27,341,0,0,0
11,27,1195,7,3,4
11,27,2084,23,14,9
11,27,1817,2,1,1
11,27,1116,2,0,2
11,27,2295,14,8,6
11,27,1602,8,3,5
11,27,1082,1,1,0
11,27,1194,14,5,9
11,27,3592,25,13,12
11,27,1962,7,3,4
11,27,2177,3,2,1
11,27,2561,9,5,4
11,27,574,1,0,1
11,27,2621,12,5,7
11,27,1317,1,0,1
11,27,2240,13,6,7
11,27,9333,49,20,29
11,27,1918,15,10,5
11,27,2573,9,7,2
11,27,2199,5,2,3
11,27,665,2,1,1
11,27,1684,5,1,4
11,27,727,8,6,2
11,27,4139,47,20,27
11,27,1795,2,2,0
11,27,1259,2,0,2
11,27,2095,15,4,11
11,27,3249,30,17,13
11,27,2850,11,3,8
11,27,1589,22,13,9
11,27,2007,33,21,12
11,27,1308,12,6,6
11,27,1026,4,3,1
11,27,2163,5,2,3
11,27,1153,5,2,3
11,27,803,1,0,1
11,27,939,10,3,7
11,27,1461,48,27,21
11,27,2302,13,3,10
11,27,1204,5,2,3
11,27,1000,10,4,6
11,27,385,0,0,0
11,27,1106,0,0,0
11,27,1172,1,1,0
11,27,1125,1,0,1
11,27,2282,21,9,12
11,27,1457,6,4,2
11,27,1468,12,8,4
11,28,238,2,1,1
11,28,1024,0,0,0
11,28,3469,27,13,14
11,28,114,0,0,0
11,28,1188,5,3,2
11,28,3162,38,17,21
11,28,767,1,1,0
11,28,575,9,2,7
11,28,603,0,0,0
11,28,1041,5,3,2
11,28,1795,10,4,6
11,28,913,8,3,5
11,28,1123,3,1,2
11,28,3733,26,12,14
11,28,687,4,1,3
11,28,489,3,1,2
11,28,680,1,1,0
11,28,237,0,0,0
11,28,594,2,1,1
11,28,618,4,2,2
11,28,417,2,1,1
11,28,1283,4,2,2
11,28,4141,11,9,2
11,28,591,1,0,1
11,28,2383,7,3,4
11,28,1748,14,7,7
11,28,2330,7,4,3
11,28,857,0,0,0
11,28,1239,2,1,1
11,28,597,9,4,5
11,28,544,0,0,0
11,28,491,7,2,5
11,28,720,2,1,1
11,28,734,5,5,0
11,28,1719,21,9,12
11,28,555,0,0,0
11,28,1037,0,0,0
11,28,894,2,2,0
11,28,473,0,0,0
11,28,734,1,0,1
11,28,744,0,0,0
11,28,505,0,0,0
11,28,1240,3,2,1
11,28,919,10,4,6
11,28,548,1,0,1
11,28,997,0,0,0
11,28,528,12,7,5
11,28,705,4,1,3
11,28,1050,5,3,2
11,28,1199,2,1,1
11,28,1745,2,0,2
11,28,666,0,0,0
11,28,2169,3,0,3
11,28,1210,348,167,181
11,28,907,28,10,18
11,28,889,0,0,0
11,28,1223,2,2,0
11,28,2330,43,22,21
11,28,767,6,5,1
11,28,595,8,3,5
11,28,525,1,0,1
11,28,1242,3,1,2
11,28,816,9,5,4
11,28,1466,6,2,4
11,28,1786,3,1,2
11,28,1978,32,16,16
11,28,2332,128,64,64
11,28,1867,31,16,15
11,28,1110,5,1,4
11,28,1060,0,0,0
11,28,1138,1,0,1
11,28,890,1,1,0
11,28,1376,16,8,8
11,28,278,2,0,2
11,28,1263,9,7,2
11,28,1818,9,5,4
11,28,748,0,0,0
11,28,931,5,2,3
11,28,913,8,4,4
11,28,828,0,0,0
11,28,377,0,0,0
11,28,447,0,0,0
11,28,729,3,2,1
11,28,498,0,0,0
11,29,2018,125,68,57
11,29,2527,25,13,12
11,29,1535,34,19,15
11,29,2034,13,6,7
11,29,1220,4,2,2
11,29,1724,25,14,11
11,29,1045,1,0,1
11,29,1415,2,0,2
11,29,484,0,0,0
11,29,3275,14,8,6
11,29,507,0,0,0
11,29,2942,11,6,5
11,29,1704,1,0,1
11,29,1386,1,1,0
11,29,1185,1,1,0
11,29,279,1,0,1
11,29,1074,0,0,0
11,29,1256,0,0,0
11,29,1674,11,6,5
11,29,430,1,0,1
11,29,407,0,0,0
11,29,1882,4,2,2
11,29,1509,31,18,13
11,29,654,2,2,0
11,29,1687,4,3,1
11,29,502,0,0,0
11,29,1366,3,3,0
11,29,1601,0,0,0
11,30,2104,18,8,10
11,30,1606,9,6,3
11,30,2680,5,3,2
11,30,1429,2,2,0
11,30,3151,9,2,7
11,30,1367,1,0,1
11,30,1024,1,1,0
11,30,3505,30,19,11
11,30,1256,2,1,1
11,30,980,4,2,2
11,30,5745,35,16,19
11,30,1510,7,4,3
11,30,1245,1,0,1
11,30,2672,24,7,17
11,30,2582,12,5,7
11,30,4340,14,6,8
11,30,958,0,0,0
11,30,3283,7,2,5
11,30,2075,8,5,3
11,30,1060,0,0,0
11,30,1253,7,2,5
11,30,1157,4,3,1
11,30,1291,2,1,1
11,30,2406,11,6,5
11,30,3286,6,4,2
11,30,1625,9,3,6
11,30,2111,25,12,13
11,30,1203,5,4,1
11,30,893,9,5,4
11,30,842,1,0,1
11,30,2370,9,7,2
11,30,1890,10,6,4
11,30,2769,2,0,2
11,30,2619,3,0,3
11,30,3451,3,0,3
11,30,1191,2,0,2
11,30,1416,1,0,1
11,30,1187,25,11,14
11,30,3132,6,2,4
11,30,2802,4,2,2
11,30,1856,2,0,2
11,30,824,0,0,0
11,30,2056,3,1,2
11,30,749,2,0,2
11,30,720,1,0,1
11,30,2346,3,2,1
11,30,1539,3,2,1
11,30,1814,6,1,5
11,30,1106,24,13,11
11,30,1473,0,0,0
11,30,1488,0,0,0
11,30,1291,2,1,1
11,30,1734,1,1,0
11,30,587,1,1,0
11,30,1343,1,1,0
11,30,725,2,0,2
11,30,829,0,0,0
11,30,1111,4,0,4
11,30,1071,2,2,0
11,30,994,0,0,0
11,30,858,0,0,0
11,30,1398,1,1,0
11,30,893,0,0,0
11,30,697,3,2,1
11,30,1401,3,2,1
11,30,1136,2,1,1
11,30,1238,5,4,1
11,30,597,1,1,0
11,30,813,2,2,0
11,30,865,6,1,5
11,30,614,12,4,8
11,31,561,0,0,0
11,31,5796,236,120,116
11,31,1926,11,6,5
11,31,970,3,0,3
11,31,517,391,202,189
11,31,529,94,56,38
11,31,419,0,0,0
11,31,755,5,2,3
11,31,3226,25,11,14
11,31,482,1,1,0
11,31,524,14,5,9
11,31,902,133,70,63
11,31,811,4,2,2
11,31,1957,33,11,22
11,31,1473,188,106,82
11,31,825,3,2,1
11,31,638,5,4,1
11,31,733,17,7,10
11,31,1158,2,1,1
11,31,3511,14,7,7
11,31,722,1,1,0
11,31,347,2,1,1
11,31,1238,18,14,4
11,31,1066,1,0,1
11,31,5848,4,2,2
11,31,294,1,1,0
11,31,620,11,7,4
11,31,1125,13,6,7
11,31,2528,26,16,10
11,31,10047,122,76,46
11,31,843,1,0,1
11,31,16330,63,24,39
11,31,2253,4,0,4
11,31,1280,5,1,4
11,31,2054,15,6,9
11,31,7591,20,11,9
11,31,2038,1,1,0
11,31,1770,7,4,3
11,31,1228,8,4,4
11,31,3678,18,12,6
11,31,4300,20,13,7
11,31,1573,3,1,2
11,31,1516,11,4,7
11,31,1195,0,0,0
11,31,2413,2,1,1
11,31,1717,4,2,2
11,31,2271,6,1,5
11,31,1228,1,1,0
11,31,3121,21,13,8
11,31,1714,9,6,3
11,31,2680,0,0,0
11,31,1573,1,0,1
11,31,1365,3,2,1
11,31,1351,10,7,3
11,31,1145,2,1,1
11,31,1127,2,2,0
11,31,1425,0,0,0
11,31,1171,2,0,2
11,31,1712,5,2,3
11,32,3227,50,26,24
11,32,8311,56,23,33
11,32,3280,20,11,9
11,32,657,5,4,1
11,32,1660,29,12,17
11,32,1955,6,3,3
11,32,200,1,0,1
11,32,1746,26,17,9
11,32,1522,3,2,1
11,32,3042,17,4,13
11,32,2782,16,7,9
11,32,2097,0,0,0
11,32,1521,29,17,12
11,32,435,0,0,0
11,32,2077,3,1,2
11,32,2053,4,3,1
11,32,1471,0,0,0
11,32,1672,3,1,2
11,32,3945,29,15,14
11,32,3386,4,1,3
11,32,1905,13,9,4
11,32,1361,2,1,1
11,32,2713,25,8,17
11,32,2923,15,9,6
11,32,1846,3,1,2
11,32,1967,2,1,1
11,32,2842,23,13,10
11,32,5000,20,9,11
11,32,2015,7,3,4
11,32,1844,0,0,0
11,32,6761,64,38,26
11,32,1837,5,1,4
11,32,2059,106,55,51
11,32,1660,10,8,2
11,32,1064,0,0,0
11,32,1375,2,1,1
11,32,1333,0,0,0
11,32,2500,6,3,3
11,33,2536,34,18,16
11,33,3800,3,1,2
11,33,3956,20,12,8
11,33,1102,0,0,0
11,33,673,4,2,2
11,33,1829,11,9,2
11,33,2486,11,9,2
11,33,2447,10,6,4
11,33,7050,316,168,148
11,33,1499,5,4,1
11,33,1491,5,3,2
11,33,1440,4,3,1
11,33,705,5,3,2
11,33,2975,15,10,5
11,33,2826,3,2,1
11,33,3743,4,3,1
11,33,1850,15,8,7
11,33,3386,4,1,3
11,33,3811,5,2,3
11,33,280,0,0,0
11,33,176,0,0,0
11,33,184,0,0,0
11,33,143,0,0,0
11,33,591,1,1,0
11,33,83,0,0,0
11,33,663,0,0,0
11,33,1380,1,1,0
11,33,2367,1,1,0
11,33,2494,5,2,3
11,33,939,13,9,4
11,33,829,3,1,2
11,33,1318,1,0,1
11,33,647,1,0,1
11,33,3510,11,5,6
11,33,307,0,0,0
11,33,3955,19,11,8
11,33,2059,2,2,0
11,33,1600,1,1,0
11,33,2052,6,3,3
11,33,3025,48,19,29
11,33,3354,3,0,3
11,33,9777,25,11,14
11,33,4485,98,50,48
11,33,3143,13,7,6
11,33,1960,6,3,3
11,33,1616,54,30,24
11,33,1758,80,36,44
11,33,1824,17,8,9
11,33,1502,1,0,1
11,33,2818,28,14,14
11,33,1083,0,0,0
11,33,2019,4,2,2
11,33,3758,4,1,3
11,33,3147,5,3,2
11,33,1951,6,4,2
11,33,3306,28,12,16
11,33,3528,8,4,4
11,34,2467,7,4,3
11,34,1754,2,0,2
11,34,887,1,0,1
11,34,386,3,0,3
11,34,525,0,0,0
11,35,1886,1,1,0
11,35,2422,6,4,2
11,35,2432,6,3,3
11,35,902,0,0,0
11,35,3264,6,5,1
11,35,4528,43,25,18
11,35,1202,8,3,5
11,35,1213,2,0,2
11,35,536,4,2,2
11,35,2040,10,3,7
11,35,941,22,13,9
11,35,782,4,1,3
11,35,1261,40,21,19
11,35,2037,202,104,98
11,35,1459,8,4,4
11,35,2185,2,2,0
11,35,2635,10,4,6
11,35,5043,214,123,91
11,35,7425,50,23,27
11,35,715,12,10,2
11,35,1085,13,8,5
11,35,1324,0,0,0
11,35,3151,16,11,5
11,35,3853,8,3,5
11,35,1955,27,14,13
11,35,2592,7,6,1
11,35,1165,3,2,1
11,35,1921,6,3,3
11,35,4571,29,15,14
11,35,2563,15,8,7
11,35,2861,11,7,4
11,35,3088,29,14,15
11,35,1504,10,7,3
11,35,1830,18,11,7
11,35,2152,21,11,10
11,35,1792,7,5,2
11,36,724,18,9,9
11,36,911,12,4,8
11,36,691,0,0,0
11,36,1167,3,1,2
11,36,415,0,0,0
11,36,1008,1,0,1
11,36,523,1,0,1
11,36,235,0,0,0
11,36,487,3,1,2
11,36,713,4,1,3
11,37,5481,618,297,321
11,37,5791,132,64,68
11,37,5583,74,31,43
11,37,5078,96,51,45
11,37,1328,4,1,3
11,37,5047,45,13,32
11,37,1479,12,7,5
11,37,619,2,1,1
11,37,1207,2,0,2
11,37,1490,10,7,3
11,37,6681,17,6,11
11,37,1499,113,58,55
11,37,1005,8,6,2
11,37,590,1,1,0
11,37,833,5,3,2
11,37,1254,72,29,43
11,37,2146,25,15,10
11,37,1460,1,1,0
11,37,1801,3,1,2
11,37,1277,28,14,14
11,37,550,1,1,0
11,37,943,8,3,5
11,37,2537,44,24,20
11,37,1553,40,20,20
11,37,4955,11,6,5
11,37,936,1,1,0
11,37,786,7,4,3
11,37,1364,6,3,3
11,37,1756,18,7,11
11,37,6842,39,22,17
11,37,1578,3,1,2
11,37,1569,8,6,2
11,37,3615,8,5,3
11,37,2261,6,1,5
11,37,1833,19,10,9
11,37,1723,1,1,0
11,37,3174,89,52,37
11,37,1834,1,1,0
11,37,2762,1,0,1
11,37,1766,0,0,0
11,37,4629,27,8,19
11,37,3889,59,34,25
11,37,2627,226,117,109
11,37,820,0,0,0
11,37,2922,93,44,49
11,37,2974,4,1,3
11,37,3457,230,120,110
11,37,1441,59,26,33
11,37,4258,67,31,36
11,37,2737,2,0,2
11,37,2573,30,15,15
11,37,3874,9,3,6
11,37,2202,6,0,6
11,37,1460,20,12,8
11,37,366,24,13,11
11,37,3589,28,12,16
11,37,10932,218,109,109
11,37,1993,4,3,1
11,37,3737,4,2,2
11,37,1178,6,3,3
11,37,3809,18,5,13
11,37,3859,12,6,6
11,37,1738,5,3,2
11,37,5282,6,4,2
11,37,1246,5,3,2
11,37,2763,1,0,1
11,37,3198,13,5,8
11,37,2635,29,14,15
11,37,1662,2,1,1
11,37,1349,4,3,1
11,37,2554,3,1,2
11,37,3606,21,4,17
11,37,2749,59,26,33
11,37,4029,29,15,14
11,37,1696,4,3,1
11,37,1028,12,6,6
11,37,1661,4,2,2
11,37,532,2,2,0
11,38,1023,6,3,3
11,38,438,0,0,0
11,38,750,1,0,1
11,38,639,0,0,0
11,38,973,5,2,3
11,38,793,0,0,0
11,38,2130,12,5,7
11,38,518,0,0,0
11,38,492,0,0,0
11,38,1569,18,10,8
11,38,958,5,3,2
11,38,747,2,0,2
11,39,1437,8,2,6
11,39,996,0,0,0
11,39,1581,1,0,1
11,39,1930,5,1,4
11,39,194,0,0,0
11,39,2151,8,4,4
11,39,632,2,2,0
11,39,1736,2,0,2
11,39,2045,5,3,2
11,39,1055,3,2,1
11,39,215,2,2,0
11,39,266,4,4,0
11,39,254,2,2,0
11,39,525,1,0,1
11,39,553,1,1,0
11,39,662,0,0,0
11,39,316,0,0,0
11,39,2596,2,1,1
11,39,991,7,3,4
11,39,1177,14,7,7
11,39,406,0,0,0
11,39,1424,4,1,3
11,39,765,6,2,4
11,39,1773,2,2,0
11,39,1251,2,1,1
11,39,1098,1,0,1
11,39,878,2,2,0
11,39,1096,5,1,4
11,39,951,5,1,4
11,39,1195,12,6,6
11,39,885,1,0,1
11,39,725,2,0,2
11,39,767,0,0,0
11,39,1687,7,2,5
11,40,3352,7,4,3
11,40,2388,0,0,0
11,40,2039,13,7,6
11,40,3101,8,5,3
11,40,337,0,0,0
11,40,2904,1,1,0
11,40,2114,0,0,0
11,40,2734,7,2,5
11,40,113,0,0,0
11,40,693,20,8,12
11,40,158,0,0,0
11,41,5486,40,21,19
11,41,8055,25,10,15
11,41,1967,43,21,22
11,41,3502,0,0,0
11,41,3530,6,3,3
11,41,1856,4,2,2
11,41,1145,9,4,5
11,41,1791,8,5,3
11,41,2409,29,19,10
11,41,2177,11,7,4
11,41,1721,8,4,4
11,41,1424,3,1,2
11,41,1133,2,1,1
11,41,804,3,1,2
11,41,1934,8,3,5
11,41,1819,13,6,7
11,41,731,9,4,5
11,41,5132,48,19,29
11,41,2314,10,6,4
11,41,4779,17,12,5
11,41,1948,4,1,3
11,41,542,2,1,1
11,41,1392,7,4,3
11,41,1961,9,2,7
11,41,1026,0,0,0
11,41,724,15,10,5
11,42,7880,42,21,21
11,42,1674,3,2,1
11,42,1319,4,3,1
11,42,3511,27,19,8
11,42,706,29,15,14
11,42,1052,1,1,0
11,42,855,2,0,2
11,42,1304,12,9,3
11,42,1822,6,2,4
11,42,1868,5,2,3
11,42,1683,2,1,1
11,42,2615,3,1,2
11,42,1699,26,17,9
11,42,1598,5,0,5
11,42,1626,11,7,4
11,42,1544,8,5,3
11,42,1082,4,0,4
11,42,886,2,0,2
11,42,861,1,1,0
11,42,3200,16,8,8
11,42,1347,2,2,0
11,42,1340,1,1,0
11,42,2096,7,2,5
11,42,1810,10,6,4
11,42,1848,27,17,10
11,42,5418,15,4,11
11,42,2732,12,6,6
11,42,3351,10,6,4
11,42,2548,13,8,5
11,42,1521,8,4,4
11,42,2299,20,9,11
11,42,4027,37,18,19
11,42,1859,21,12,9
11,42,1254,47,23,24
11,42,1907,9,4,5
11,42,1410,0,0,0
11,42,3192,9,3,6
11,42,1090,0,0,0
11,42,480,0,0,0
11,42,2100,16,6,10
11,42,1771,35,22,13
11,42,1171,0,0,0
11,42,1139,7,3,4
11,42,1091,7,2,5
11,42,4210,9,6,3
11,42,2015,5,3,2
11,42,1932,7,4,3
11,42,2517,15,8,7
11,42,2513,7,5,2
11,42,1067,6,4,2
11,42,1681,0,0,0
11,42,4678,18,8,10
11,42,2509,12,6,6
11,42,2193,1,0,1
11,42,2044,4,3,1
11,42,1945,780,405,375
11,42,2411,58,29,29
11,42,1613,3,1,2
11,42,1852,2,1,1
11,42,2213,1,0,1
11,42,3355,37,13,24
11,42,2677,9,5,4
11,42,2819,22,12,10
11,42,1349,4,1,3
11,42,1655,2,2,0
11,42,1365,0,0,0
11,42,1909,3,1,2
11,42,1223,1,1,0
11,42,1213,7,0,7
11,42,1052,6,3,3
11,42,1108,2,1,1
11,42,1172,15,7,8
11,42,1895,140,58,82
11,42,812,10,6,4
11,42,1431,4,1,3
11,43,2314,12,8,4
11,43,3515,20,12,8
11,43,205,0,0,0
11,43,595,5,2,3
11,43,839,3,3,0
11,43,177,1,1,0
11,43,858,3,1,2
11,43,652,8,5,3
11,43,2099,2,1,1
11,43,1903,1,1,0
11,43,852,16,10,6
11,43,1702,4,2,2
11,43,2906,10,5,5
11,43,954,13,8,5
11,43,1654,10,6,4
11,44,3797,100,56,44
11,44,1993,122,64,58
11,44,7960,745,383,362
11,44,1168,30,17,13
11,44,1349,103,52,51
11,44,2718,2,1,1
11,44,1074,51,31,20
11,44,1266,0,0,0
11,44,2380,246,123,123
11,44,890,9,4,5
11,44,798,3,1,2
11,44,754,0,0,0
11,44,2444,9,5,4
11,44,767,4,2,2
11,44,1454,6,4,2
11,44,2859,71,33,38
11,44,2021,9,6,3
11,44,2131,12,6,6
11,44,1904,6,4,2
11,44,5744,43,19,24
11,44,6574,220,104,116
11,44,3136,17,7,10
11,44,1460,30,14,16
11,44,3686,8,1,7
11,44,1662,5,4,1
11,44,962,2,2,0
11,44,1809,3,1,2
11,44,1689,10,7,3
11,45,664,0,0,0
11,45,2360,1,1,0
11,45,517,0,0,0
11,45,471,0,0,0
11,45,486,0,0,0
11,45,411,0,0,0
11,45,1156,0,0,0
11,45,424,0,0,0
11,45,1316,0,0,0
11,45,621,0,0,0
11,45,966,0,0,0
11,45,438,0,0,0
11,45,449,0,0,0
11,45,490,1,0,1
11,46,2656,32,15,17
11,46,1025,8,6,2
11,46,1049,2,2,0
11,46,1049,26,10,16
11,46,973,5,3,2
11,46,920,3,2,1
11,46,1100,7,4,3
11,46,1355,10,6,4
11,46,935,2,2,0
11,46,1549,15,11,4
11,46,5163,74,43,31
11,46,2438,106,59,47
11,46,1068,2,1,1
11,46,2398,8,5,3
11,46,2340,11,7,4
11,46,1919,3,1,2
11,46,1774,0,0,0
11,46,797,2,0,2
11,46,924,2,1,1
11,46,527,2,0,2
11,46,650,9,7,2
11,46,741,2,0,2
11,46,686,5,2,3
11,46,685,1,1,0
11,46,702,2,1,1
11,46,897,0,0,0
11,46,1768,1,1,0
11,46,395,0,0,0
11,46,533,2,0,2
11,46,548,0,0,0
11,46,713,7,4,3
11,46,982,0,0,0
11,46,1069,4,1,3
11,46,468,1,0,1
11,46,1387,0,0,0
11,46,2824,7,4,3
11,46,461,16,4,12
11,46,1778,36,15,21
11,46,758,12,6,6
11,46,385,5,2,3
11,46,261,2,1,1
11,46,712,9,5,4
11,46,786,9,4,5
11,46,1107,2,1,1
11,46,1877,4,1,3
11,46,1273,10,4,6
11,46,722,5,2,3
11,46,1098,3,2,1
11,46,1410,18,9,9
11,46,1636,18,8,10
11,46,1168,0,0,0
11,46,1335,14,5,9
11,46,1620,2,1,1
11,46,1111,1,1,0
11,46,761,3,1,2
11,46,653,3,0,3
11,46,657,2,0,2
11,20,1693,31,20,11
11,20,2454,29,15,14
11,20,1012,21,9,12
11,20,1494,4,0,4
11,20,2194,3,1,2
11,20,1813,3,1,2
11,20,1543,5,2,3
11,20,2011,21,14,7
11,20,1755,37,19,18
11,20,13499,327,156,171
11,20,3232,21,12,9
11,20,1532,6,3,3
11,20,1219,2,1,1
11,20,1769,6,3,3
11,20,1775,25,11,14
11,20,1403,3,3,0
11,20,1363,7,3,4
11,20,1800,21,13,8
11,20,1766,10,5,5
11,20,1388,22,11,11
11,20,1870,72,37,35
11,20,1710,13,6,7
11,20,1557,10,5,5
11,20,1836,18,8,10
11,20,1787,8,3,5
11,20,1053,20,7,13
11,20,1051,8,2,6
11,20,1023,5,0,5
11,20,2038,77,39,38
11,20,930,2,1,1
11,20,1034,2,0,2
11,20,432,4,2,2
11,20,1394,72,40,32
11,20,1547,69,34,35
11,20,980,22,7,15
11,20,766,16,8,8
11,20,914,23,13,10
11,20,741,13,8,5
11,20,1113,4,0,4
11,20,988,11,9,2
11,20,966,13,6,7
11,20,1028,16,4,12
11,20,761,8,2,6
11,20,902,50,23,27
11,20,763,13,6,7
11,20,977,150,80,70
11,20,988,32,9,23
11,20,1009,1,0,1
11,20,1119,544,280,264
11,20,1485,7,3,4
11,20,721,7,4,3
11,20,851,2,2,0
11,20,579,2,1,1
11,20,1460,1,0,1
11,20,1234,6,3,3
11,20,1282,385,188,197
11,20,1452,12,4,8
11,20,954,208,96,112
11,20,1459,21,10,11
11,20,1209,2,0,2
11,20,903,272,139,133
11,20,488,6,3,3
11,20,1184,6,1,5
11,20,1732,123,62,61
11,20,808,4,1,3
11,20,2467,8,2,6
11,20,1076,4,0,4
11,20,2180,145,65,80
11,20,2192,274,135,139
11,20,833,2,0,2
11,20,2322,552,275,277
11,20,1541,135,70,65
11,20,1347,4,2,2
11,20,2033,44,21,23
11,20,1442,2,1,1
11,20,1942,8,2,6
11,20,851,3,1,2
11,20,1497,16,7,9
11,20,939,17,8,9
11,20,1253,14,7,7
11,20,1811,19,8,11
11,20,1447,126,60,66
11,20,777,0,0,0
11,20,940,19,8,11
11,20,1628,10,3,7
11,20,1453,33,13,20
11,20,1867,94,50,44
11,20,1360,14,6,8
11,20,1042,22,6,16
11,20,1215,35,14,21
11,20,1372,15,8,7
11,20,1299,17,7,10
11,20,1292,45,25,20
11,20,1358,0,0,0
11,20,1501,13,6,7
11,20,1063,11,4,7
11,7,1634,154,78,76
11,7,1875,35,15,20
11,7,1202,73,43,30
11,7,878,428,223,205
11,7,1438,26,10,16
11,7,994,34,18,16
11,7,2021,65,36,29
11,7,1357,42,19,23
11,7,954,62,36,26
11,7,2081,15,8,7
11,7,1567,31,14,17
11,7,1897,130,58,72
11,7,1748,27,15,12
11,7,1678,7,2,5
11,7,514,1,1,0
11,7,955,10,7,3
11,7,1644,12,8,4
11,7,1740,14,8,6
11,7,1346,8,4,4
11,20,2109,13,9,4
11,20,2076,18,8,10
11,20,2478,158,81,77
11,20,2435,46,25,21
11,20,2169,51,24,27
11,20,1750,181,91,90
11,20,2667,23,9,14
11,20,3283,57,28,29
11,20,2838,333,158,175
11,20,4001,10,4,6
11,20,3706,205,85,120
11,20,2989,43,24,19
11,20,2056,13,8,5
11,20,2369,373,185,188
11,20,4193,63,34,29
11,20,2539,43,18,25
11,20,1896,46,21,25
11,20,2477,30,10,20
11,20,2633,24,10,14
11,20,3643,57,20,37
11,20,3316,5,2,3
11,20,5131,31,14,17
11,20,2172,26,11,15
11,20,1657,5,3,2
11,20,1119,12,2,10
11,20,1652,4,1,3
11,20,1931,13,3,10
11,20,7653,90,32,58
11,20,1946,14,8,6
11,20,3689,15,10,5
11,20,2188,7,3,4
11,20,2178,12,5,7
11,20,2967,8,6,2
11,20,6041,115,63,52
11,20,4930,79,40,39
11,20,1174,19,10,9
11,20,10945,146,64,82
11,20,6762,333,158,175
11,20,5369,66,37,29
11,20,6912,116,58,58
11,20,5720,125,53,72
11,20,4764,249,127,122
11,20,7452,135,64,71
11,20,3536,24,11,13
11,20,3251,29,16,13
11,20,1789,11,4,7
11,20,1832,11,3,8
11,20,3192,32,17,15
11,15,2371,130,72,58
11,15,1298,49,28,21
11,15,3706,38,18,20
11,15,2644,21,10,11
11,15,3884,51,27,24
11,15,3936,38,15,23
11,15,3496,9,4,5
11,15,422,15,5,10
11,15,5707,53,30,23
11,15,2191,69,35,34
12,1,1350,117,58,59
12,1,1230,50,16,34
12,1,2765,235,111,124
12,1,1021,108,64,44
12,1,786,20,13,7
12,1,956,21,14,7
12,1,1349,40,18,22
12,1,889,59,31,28
12,1,951,60,31,29
12,1,1222,57,33,24
12,1,1016,40,18,22
12,1,824,98,54,44
12,1,1371,44,25,19
12,1,556,45,23,22
12,1,964,86,46,40
12,1,888,176,95,81
12,1,910,20,12,8
12,1,2012,160,88,72
12,1,3611,342,179,163
12,1,1206,38,19,19
12,1,1246,52,29,23
12,1,1425,61,32,29
12,1,2012,212,121,91
12,1,1398,58,32,26
12,1,1556,93,52,41
12,1,1102,45,25,20
12,1,2461,147,77,70
12,1,1771,95,59,36
12,1,1848,73,45,28
12,1,2250,65,30,35
12,1,4906,734,387,347
12,1,1132,41,22,19
12,1,2081,45,30,15
12,1,1134,52,31,21
12,1,932,145,82,63
12,1,1763,126,66,60
12,1,1613,84,50,34
12,1,1884,110,56,54
12,1,2208,181,104,77
12,1,1419,176,90,86
12,1,1641,153,79,74
12,1,1566,73,37,36
12,1,1010,18,7,11
12,1,1063,114,72,42
12,1,1183,208,121,87
12,1,971,200,108,92
12,1,1305,47,22,25
12,1,1635,156,84,72
12,1,2421,137,71,66
12,1,2019,127,70,57
12,1,1186,85,47,38
12,1,1188,94,56,38
12,1,1532,181,91,90
12,1,1243,150,87,63
12,1,782,74,40,34
12,1,1286,108,60,48
12,1,1172,200,111,89
12,1,464,21,12,9
12,1,852,97,56,41
12,1,1016,80,48,32
12,1,1189,97,51,46
12,1,503,20,12,8
12,1,835,57,34,23
12,1,547,33,20,13
12,1,583,58,28,30
12,1,832,165,80,85
12,1,452,71,37,34
12,1,850,80,43,37
12,1,1180,29,13,16
12,1,1131,91,52,39
12,1,1168,190,93,97
12,1,1593,91,54,37
12,1,979,208,119,89
12,1,978,20,15,5
12,1,889,25,13,12
12,1,681,73,41,32
12,1,919,40,20,20
12,1,358,11,5,6
12,1,564,33,13,20
12,1,1354,104,60,44
12,1,1324,107,55,52
12,1,536,37,28,9
12,1,727,22,12,10
12,1,509,51,31,20
12,1,814,61,32,29
12,1,1259,86,51,35
12,1,767,23,14,9
12,1,424,29,16,13
12,1,989,244,125,119
12,1,1556,192,91,101
12,1,820,81,43,38
12,1,1127,173,95,78
12,1,828,69,38,31
12,1,578,24,14,10
12,1,515,52,28,24
12,1,1061,118,63,55
12,1,328,8,2,6
12,1,766,44,25,19
12,1,1974,397,209,188
12,1,1410,383,199,184
12,1,1343,622,341,281
12,1,1004,184,101,83
12,1,1749,300,171,129
12,1,1714,170,85,85
12,1,2045,281,154,127
12,1,2111,320,168,152
12,1,1657,519,272,247
12,1,1268,232,123,109
12,1,6213,281,142,139
12,1,4371,881,472,409
12,1,5806,435,247,188
12,1,2995,195,99,96
12,1,8655,681,364,317
12,1,2197,47,26,21
12,1,2237,31,15,16
12,1,5474,176,92,84
12,1,3088,121,55,66
12,1,3529,133,66,67
12,1,2197,145,76,69
12,1,2568,708,379,329
12,1,5288,776,416,360
12,1,3375,256,136,120
12,1,2394,111,56,55
12,1,2303,63,31,32
12,1,261,13,7,6
12,1,2182,100,49,51
12,1,2870,668,338,330
12,1,1512,371,198,173
12,1,2206,326,160,166
12,1,2200,234,125,109
12,1,1994,524,285,239
12,1,2542,486,261,225
12,1,6963,316,161,155
12,1,4359,375,194,181
12,1,4651,187,90,97
12,1,1263,31,14,17
12,1,5203,892,454,438
12,1,1826,180,81,99
12,1,1543,338,171,167
12,1,1924,145,77,68
12,1,1752,276,153,123
12,1,4307,481,256,225
12,1,1613,147,76,71
12,1,1771,344,179,165
12,1,2131,247,126,121
12,1,1774,144,74,70
12,1,1948,167,91,76
12,1,2129,103,56,47
12,1,2179,178,102,76
12,1,1423,303,163,140
12,1,1359,152,88,64
12,1,1874,148,85,63
12,1,1457,87,50,37
12,1,1939,51,25,26
12,1,1608,164,90,74
12,1,1864,186,94,92
12,1,1824,256,145,111
12,1,1456,111,63,48
12,1,3019,110,60,50
12,1,4303,683,180,503
12,1,2509,203,109,94
12,1,467,32,18,14
12,1,5912,595,312,283
12,1,2903,152,76,76
12,1,2925,203,108,95
12,1,1488,126,65,61
12,1,1539,120,58,62
12,1,1634,73,43,30
12,1,2182,102,52,50
12,1,2048,243,113,130
12,1,1513,415,201,214
12,1,2041,126,56,70
12,1,1589,56,21,35
12,1,1472,130,63,67
12,1,1674,103,61,42
12,1,1700,270,143,127
12,1,1629,151,81,70
12,1,2327,162,93,69
12,1,4627,1032,551,481
12,1,1313,26,10,16
12,1,1594,67,35,32
12,1,1239,343,195,148
12,1,1560,61,29,32
12,1,2033,135,67,68
12,1,1727,170,89,81
12,1,1073,175,101,74
12,1,1804,153,73,80
12,1,1163,144,78,66
12,1,1493,55,24,31
12,1,1585,116,66,50
12,1,2705,109,57,52
12,1,2586,200,107,93
12,1,1788,90,50,40
12,1,1234,61,30,31
12,1,1665,131,68,63
12,1,1245,96,58,38
12,1,2534,306,154,152
12,1,1418,254,130,124
12,1,2241,266,138,128
12,1,939,42,20,22
12,1,1705,197,106,91
12,1,1422,164,89,75
12,1,2306,99,49,50
12,1,1012,12,6,6
12,1,1528,50,29,21
12,1,2886,325,151,174
12,1,3395,82,44,38
12,1,1491,122,67,55
12,1,2516,343,180,163
12,1,1289,36,23,13
12,1,2591,180,102,78
12,1,1719,167,92,75
12,1,1587,86,45,41
12,1,1886,257,127,130
12,1,1813,278,150,128
12,1,1907,24,17,7
12,1,1236,140,73,67
12,1,1492,59,28,31
12,1,644,32,18,14
12,1,1247,84,41,43
12,1,1105,625,325,300
12,1,1189,388,201,187
12,1,2049,238,129,109
12,1,2111,457,259,198
12,1,1785,249,131,118
12,1,1319,176,87,89
12,1,2102,277,144,133
12,1,1167,29,15,14
12,1,2103,186,100,86
12,1,1613,75,42,33
12,1,1665,395,220,175
12,1,1269,109,51,58
12,1,1100,101,57,44
12,1,774,46,31,15
12,1,872,48,28,20
12,1,940,78,41,37
12,1,882,66,30,36
12,1,1425,92,45,47
12,1,1083,30,17,13
12,1,1109,141,79,62
12,1,1078,155,71,84
12,1,2810,167,98,69
12,1,2197,236,120,116
12,1,2916,39,19,20
12,1,2557,336,182,154
12,1,3528,291,147,144
12,1,877,209,109,100
12,1,912,172,83,89
12,1,1135,48,27,21
12,1,1245,238,136,102
12,1,1465,254,128,126
12,1,974,36,21,15
12,1,1876,173,97,76
12,1,2049,48,23,25
12,1,5927,628,321,307
12,1,2185,433,238,195
12,1,967,60,29,31
12,1,1129,107,54,53
12,1,732,156,76,80
12,1,1557,125,66,59
12,1,3540,294,158,136
12,1,1597,161,78,83
12,1,2052,629,311,318
12,1,2666,80,45,35
12,1,3642,165,88,77
12,1,2474,224,113,111
12,1,1409,98,46,52
12,1,1127,90,44,46
12,1,1499,228,113,115
12,1,1109,173,93,80
12,1,1699,248,141,107
12,1,1449,226,127,99
12,1,1648,156,92,64
12,1,1034,217,131,86
12,1,639,32,20,12
12,1,1730,139,68,71
12,1,4011,244,141,103
12,1,5779,424,213,211
12,1,2643,1127,589,538
12,1,2310,191,91,100
12,1,1354,197,102,95
12,1,1162,414,222,192
12,1,3463,497,265,232
12,1,2265,249,134,115
12,1,1435,39,20,19
12,1,4335,112,61,51
12,1,1344,62,28,34
12,1,1408,107,56,51
12,1,1195,157,82,75
12,1,1106,79,45,34
12,1,1335,117,52,65
12,1,1738,248,140,108
12,1,15370,1337,691,646
12,1,4992,1356,715,641
12,1,1856,317,164,153
12,1,4441,785,409,376
12,1,4033,239,113,126
12,1,1689,44,27,17
12,1,3688,392,195,197
12,1,15208,1812,949,863
12,1,3478,406,203,203
12,1,4001,712,344,368
12,1,4209,669,340,329
12,1,17417,1484,802,682
12,1,9702,1065,581,484
12,1,1874,150,85,65
12,1,6554,450,236,214
12,1,17441,1576,839,737
12,1,2597,128,62,66
12,1,373,137,66,71
12,1,1013,31,18,13
12,1,591,10,5,5
12,1,1014,14,5,9
12,1,1215,39,23,16
12,1,1697,139,74,65
12,1,2070,181,100,81
12,1,2000,165,80,85
12,1,1612,109,57,52
12,1,440,228,112,116
12,1,1000,35,16,19
12,1,967,128,59,69
12,1,1838,68,40,28
12,1,308,264,121,143
12,1,769,46,20,26
12,1,889,7,4,3
12,1,1432,6,3,3
12,1,1061,6,2,4
12,1,856,6,3,3
12,1,1861,28,13,15
12,1,444,6,3,3
12,1,2533,166,83,83
12,1,2631,89,42,47
12,1,2023,177,89,88
12,1,1760,140,81,59
12,1,1391,0,0,0
12,1,1745,9,5,4
12,1,2309,23,14,9
12,1,965,414,209,205
12,1,802,6,3,3
12,1,248,159,74,85
12,1,2782,61,31,30
12,1,1590,13,6,7
12,1,967,112,56,56
12,1,767,37,19,18
12,1,14889,1044,530,514
12,1,407,211,94,117
12,1,1120,9,4,5
12,1,1427,2,0,2
12,1,2464,4,1,3
12,1,632,1,1,0
12,1,397,25,11,14
12,1,992,19,9,10
12,1,1404,22,11,11
12,1,3925,1206,619,587
12,1,1797,64,29,35
12,1,611,0,0,0
12,1,1524,3,2,1
12,1,270,1,1,0
12,1,477,6,2,4
12,1,2807,249,124,125
12,1,1286,32,14,18
12,1,4524,219,111,108
12,1,867,1,1,0
12,1,1459,1,0,1
12,1,1085,939,464,475
12,1,2007,42,18,24
12,1,2575,182,91,91
12,1,3787,359,179,180
12,1,2212,174,89,85
12,1,2970,60,27,33
12,1,4710,172,87,85
12,1,1052,63,33,30
12,1,953,2,0,2
12,1,1448,15,10,5
12,1,2355,71,35,36
12,1,3069,659,324,335
12,1,2064,194,82,112
12,1,1601,127,56,71
12,1,1076,60,31,29
12,1,1129,91,52,39
12,2,4328,201,109,92
12,2,783,20,7,13
12,2,769,0,0,0
12,2,713,1,0,1
12,2,651,0,0,0
12,2,1357,1,0,1
12,2,542,1,1,0
12,2,1255,11,3,8
12,2,47,0,0,0
12,2,557,4,4,0
12,2,443,26,14,12
12,2,469,0,0,0
12,2,235,5,2,3
12,2,670,0,0,0
12,2,610,1,1,0
12,2,488,8,5,3
12,2,1746,208,119,89
12,2,503,53,28,25
12,2,507,0,0,0
12,2,1348,17,9,8
12,2,623,3,1,2
12,2,1269,4,2,2
12,2,1055,23,8,15
12,2,159,3,1,2
12,2,1380,133,67,66
12,2,2660,14,8,6
12,3,1507,12,6,6
12,3,355,0,0,0
12,3,1120,2,1,1
12,3,3679,2,2,0
12,3,3265,1,1,0
12,3,1029,0,0,0
12,3,1312,11,8,3
12,3,1870,5,2,3
12,3,978,0,0,0
12,3,534,2,1,1
12,3,1455,0,0,0
12,3,1701,1,1,0
12,3,924,0,0,0
12,3,866,0,0,0
12,3,821,0,0,0
12,3,557,6,3,3
12,3,748,7,2,5
12,3,1345,22,12,10
12,3,178,1,0,1
12,3,209,0,0,0
12,3,267,2,1,1
12,3,981,0,0,0
12,3,348,0,0,0
12,3,1190,5,3,2
12,3,658,4,1,3
12,3,483,2,2,0
12,3,294,0,0,0
12,3,871,7,3,4
12,3,123,0,0,0
12,3,479,0,0,0
12,3,392,9,4,5
12,3,532,4,2,2
12,3,1068,7,4,3
12,3,339,1,1,0
12,3,1128,0,0,0
12,3,495,3,3,0
12,3,482,1,1,0
12,3,400,4,4,0
12,3,168,2,1,1
12,3,329,3,2,1
12,3,513,6,4,2
12,3,757,2,0,2
12,3,1051,1,1,0
12,4,3115,63,41,22
12,4,736,1,1,0
12,4,96,0,0,0
12,4,1816,62,26,36
12,4,419,1,1,0
12,4,615,3,0,3
12,4,231,146,77,69
12,4,1025,18,8,10
12,4,538,154,87,67
12,4,1536,35,18,17
12,4,422,28,15,13
12,4,2115,15,10,5
12,4,1241,3,1,2
12,4,1122,5,2,3
12,4,150,1,0,1
12,4,1111,3,1,2
12,4,2276,2,0,2
12,4,1245,0,0,0
12,5,1386,18,8,10
12,5,3312,106,66,40
12,5,1997,18,8,10
12,5,331,12,5,7
12,5,1214,82,42,40
12,6,687,1,1,0
12,6,1005,0,0,0
12,6,1448,3,1,2
12,6,1584,14,5,9
12,6,1283,10,6,4
12,6,1377,1,0,1
12,6,102,0,0,0
12,6,197,0,0,0
12,6,264,0,0,0
12,6,33,0,0,0
12,6,453,1,0,1
12,6,188,0,0,0
12,6,499,3,0,3
12,6,510,1,0,1
12,6,555,0,0,0
12,6,186,0,0,0
12,6,405,0,0,0
12,6,92,0,0,0
12,6,144,0,0,0
12,7,1945,66,34,32
12,7,2738,10,3,7
12,7,1590,5,3,2
12,7,1117,23,13,10
12,7,1634,20,11,9
12,7,1516,14,6,8
12,7,1340,12,6,6
12,7,1186,2,0,2
12,7,805,4,4,0
12,7,1200,1,0,1
12,7,3917,68,27,41
12,7,1351,2,2,0
12,7,2266,137,74,63
12,7,1040,2,0,2
12,7,367,0,0,0
12,7,346,0,0,0
12,7,255,1,1,0
12,7,670,0,0,0
12,7,185,0,0,0
12,7,263,0,0,0
12,7,210,0,0,0
12,7,146,0,0,0
12,7,612,0,0,0
12,7,185,0,0,0
12,7,184,0,0,0
12,7,136,0,0,0
12,7,163,0,0,0
12,7,237,0,0,0
12,7,232,1,1,0
12,7,345,1,1,0
12,7,263,0,0,0
12,7,472,0,0,0
12,7,207,0,0,0
12,7,1103,23,12,11
12,7,174,16,10,6
12,7,648,15,9,6
12,7,134,0,0,0
12,7,201,1,0,1
12,7,250,0,0,0
12,7,483,0,0,0
12,7,71,0,0,0
12,7,503,0,0,0
12,7,295,0,0,0
12,7,168,0,0,0
12,7,421,0,0,0
12,8,1449,114,62,52
12,8,1821,35,18,17
12,8,854,10,3,7
12,8,706,33,9,24
12,8,411,4,2,2
12,8,402,0,0,0
12,8,829,8,4,4
12,8,857,0,0,0
12,8,1147,0,0,0
12,8,739,0,0,0
12,9,972,16,9,7
12,9,646,1,0,1
12,9,435,0,0,0
12,9,285,0,0,0
12,9,332,1,1,0
12,9,664,0,0,0
12,9,1150,2,2,0
12,9,180,3,2,1
12,9,1577,1,0,1
12,10,3142,27,16,11
12,10,425,0,0,0
12,10,435,0,0,0
12,10,1281,4,1,3
12,10,488,0,0,0
12,10,1027,4,2,2
12,10,899,37,20,17
12,10,274,13,4,9
12,10,2921,41,18,23
12,10,893,5,1,4
12,10,1547,11,5,6
12,10,1443,1,1,0
12,10,3324,84,41,43
12,10,894,36,18,18
12,10,195,186,100,86
12,10,1554,335,170,165
12,10,860,4,3,1
12,10,1182,4,1,3
12,10,2004,22,11,11
12,10,497,0,0,0
12,10,1148,0,0,0
12,10,1885,60,29,31
12,11,965,20,9,11
12,11,1111,68,40,28
12,11,1312,5,0,5
12,11,1578,29,9,20
12,11,1475,13,9,4
12,11,770,69,35,34
12,11,473,144,72,72
12,11,1466,339,193,146
12,11,1096,4,2,2
12,11,815,224,116,108
12,11,1202,502,274,228
12,11,855,32,14,18
12,11,2095,16,6,10
12,11,1731,34,15,19
12,11,2754,69,32,37
12,11,666,21,7,14
12,11,402,14,5,9
12,11,183,1,0,1
12,11,284,41,21,20
12,11,403,3,2,1
12,11,899,3,1,2
12,11,220,2,1,1
12,11,686,0,0,0
12,11,1876,24,17,7
12,11,700,0,0,0
12,11,1776,9,7,2
12,11,275,0,0,0
12,11,797,11,4,7
12,11,497,346,177,169
12,11,537,1,0,1
12,11,353,0,0,0
12,11,464,363,184,179
12,11,505,2,1,1
12,11,325,0,0,0
12,11,317,0,0,0
12,11,699,150,75,75
12,11,261,4,2,2
12,11,858,1,0,1
12,11,169,0,0,0
12,11,966,4,2,2
12,11,310,5,1,4
12,11,319,10,4,6
12,11,1335,2,1,1
12,11,964,3,1,2
12,11,1473,12,7,5
12,11,166,0,0,0
12,11,1418,19,8,11
12,11,147,2,1,1
12,11,791,6,2,4
12,11,629,334,149,185
12,11,213,211,105,106
12,11,225,0,0,0
12,11,218,1,0,1
12,11,1267,230,111,119
12,11,481,0,0,0
12,11,2212,658,347,311
12,11,766,2,2,0
12,11,1137,9,6,3
12,11,636,100,52,48
12,11,1027,18,11,7
12,11,1138,81,36,45
12,11,1723,14,6,8
12,11,389,7,3,4
12,11,643,120,61,59
12,11,1639,88,45,43
12,11,1543,31,18,13
12,11,3177,113,60,53
12,12,6174,929,473,456
12,12,2720,1065,577,488
12,12,774,174,90,84
12,12,6289,415,192,223
12,12,2723,1085,561,524
12,12,437,7,4,3
12,12,1105,5,2,3
12,12,427,1,0,1
12,12,2060,1802,942,860
12,12,1325,13,5,8
12,12,0,0,0,0
12,12,1103,2,1,1
12,12,1454,58,33,25
12,12,2998,38,21,17
12,12,258,256,134,122
12,12,926,2,0,2
12,12,933,2,1,1
12,12,1223,10,6,4
12,12,846,0,0,0
12,12,1066,170,85,85
12,12,827,5,2,3
12,12,2432,266,128,138
12,12,480,13,7,6
12,12,1816,150,72,78
12,12,1403,1,1,0
12,12,379,110,60,50
12,12,864,24,8,16
12,12,127,0,0,0
12,12,590,6,2,4
12,12,1169,0,0,0
12,12,706,4,3,1
12,12,848,29,14,15
12,12,1235,105,50,55
12,12,325,10,3,7
12,12,1422,8,6,2
12,12,490,0,0,0
12,12,1533,8,3,5
12,12,443,4,2,2
12,12,966,0,0,0
12,12,1134,6,4,2
12,12,2297,12,5,7
12,12,1222,2,1,1
12,12,423,2,0,2
12,12,1288,12,3,9
12,12,538,0,0,0
12,12,295,7,5,2
12,12,1205,7,3,4
12,12,1505,0,0,0
12,12,1911,4,2,2
12,12,1219,30,14,16
12,12,497,86,42,44
12,12,329,1,1,0
12,12,238,6,3,3
12,12,332,1,1,0
12,13,1516,258,125,133
12,13,1624,316,174,142
12,13,1536,253,128,125
12,13,1798,193,106,87
12,13,834,57,34,23
12,13,1347,57,28,29
12,13,609,8,2,6
12,80,1463,198,105,93
12,13,481,29,13,16
12,13,481,3,1,2
12,80,591,31,11,20
12,13,298,0,0,0
12,13,820,114,62,52
12,13,97,26,16,10
12,81,236,4,1,3
12,81,341,214,91,123
12,13,1764,1556,790,766
12,13,732,5,4,1
12,81,1202,854,452,402
12,81,1376,1006,487,519
12,81,780,443,215,228
12,81,1182,520,237,283
12,80,621,378,202,176
12,81,708,249,128,121
12,81,185,54,21,33
12,81,265,176,92,84
12,13,501,428,209,219
12,80,2477,1026,533,493
12,80,1469,666,358,308
12,80,1221,644,341,303
12,80,2259,1035,529,506
12,80,2108,969,473,496
12,81,195,46,20,26
12,80,440,114,54,60
12,13,161,69,36,33
12,13,237,149,72,77
12,80,1201,845,398,447
12,14,1458,68,31,37
12,14,749,30,14,16
12,14,928,31,23,8
12,14,1767,28,13,15
12,14,2593,146,76,70
12,14,321,1,1,0
12,14,253,8,4,4
12,14,1133,65,34,31
12,14,214,2,1,1
12,14,525,41,15,26
12,14,1411,21,10,11
12,14,1609,24,8,16
12,14,986,5,2,3
12,14,939,9,2,7
12,14,758,56,24,32
12,15,2164,91,46,45
12,15,1500,25,14,11
12,15,1558,25,13,12
12,15,2194,14,6,8
12,15,1586,3,0,3
12,15,1031,28,9,19
12,15,1356,32,13,19
12,15,922,2,1,1
12,15,219,0,0,0
12,15,94,0,0,0
12,15,371,0,0,0
12,16,650,4,1,3
12,16,832,0,0,0
12,16,414,2,0,2
12,16,1509,2,1,1
12,16,834,0,0,0
12,16,663,0,0,0
12,16,442,1,0,1
12,16,291,0,0,0
12,16,385,0,0,0
12,16,189,0,0,0
12,16,238,0,0,0
12,16,565,2,1,1
12,16,268,1,1,0
12,16,237,0,0,0
12,16,159,0,0,0
12,16,366,5,4,1
12,16,314,0,0,0
12,16,206,0,0,0
12,16,186,0,0,0
12,16,388,3,2,1
12,16,248,0,0,0
12,16,201,1,1,0
12,16,213,0,0,0
12,16,317,0,0,0
12,16,246,6,2,4
12,16,422,0,0,0
12,16,237,1,1,0
12,16,254,0,0,0
12,16,1146,1,1,0
12,17,1282,57,29,28
12,17,1034,62,29,33
12,17,1324,50,24,26
12,17,636,119,63,56
12,17,295,6,2,4
12,17,772,4,3,1
12,17,201,0,0,0
12,17,531,4,3,1
12,17,165,0,0,0
12,17,433,0,0,0
12,17,817,18,9,9
12,17,393,4,3,1
12,17,460,7,1,6
12,17,1534,13,7,6
12,17,347,0,0,0
12,17,706,2,2,0
12,17,143,0,0,0
12,17,273,0,0,0
12,17,110,0,0,0
12,17,1650,1,0,1
12,17,694,1,1,0
12,17,476,3,2,1
12,17,304,4,2,2
12,17,999,5,2,3
12,18,2572,1607,832,775
12,18,1430,1226,621,605
12,18,1249,1070,596,474
12,18,1640,1237,647,590
12,18,864,433,212,221
12,18,713,444,237,207
12,18,981,666,360,306
12,18,364,13,6,7
12,18,942,305,153,152
12,18,919,473,235,238
12,18,440,10,3,7
12,18,276,116,55,61
12,18,1615,813,400,413
12,18,460,76,36,40
12,19,5103,664,350,314
12,19,3543,690,359,331
12,19,481,53,26,27
12,19,506,88,42,46
12,19,1573,467,249,218
12,19,697,3,1,2
12,19,592,18,7,11
12,19,626,18,11,7
12,19,624,0,0,0
12,19,1835,5,1,4
12,20,4152,97,48,49
12,20,671,4,3,1
12,20,1046,34,20,14
12,20,793,33,19,14
12,20,1528,49,27,22
12,20,2048,304,166,138
12,20,1198,19,10,9
12,20,1187,0,0,0
12,20,111,0,0,0
12,20,3327,67,44,23
12,20,2145,8,3,5
12,20,1766,145,75,70
12,20,177,1,1,0
12,20,1113,176,86,90
12,20,697,0,0,0
12,21,3232,468,238,230
12,21,1365,52,28,24
12,21,1592,56,31,25
12,21,799,149,82,67
12,21,878,18,10,8
12,21,2769,237,134,103
12,21,2553,86,38,48
12,21,2482,164,86,78
12,21,505,8,3,5
12,21,732,554,286,268
12,21,539,0,0,0
12,21,1189,192,100,92
12,21,2481,18,10,8
12,21,676,95,52,43
12,21,546,176,83,93
12,21,593,0,0,0
12,21,864,14,6,8
12,21,466,1,0,1
12,21,359,3,2,1
12,21,388,0,0,0
12,21,1596,4,2,2
12,21,232,21,13,8
12,21,582,1,0,1
12,21,391,13,5,8
12,21,1039,0,0,0
12,21,2563,2,0,2
12,21,1971,5,2,3
12,21,1165,1,1,0
12,21,694,3,2,1
12,21,1059,16,4,12
12,21,1282,41,19,22
12,21,943,128,58,70
12,21,1030,20,10,10
12,21,714,86,44,42
12,21,1861,16,8,8
12,21,1131,6,3,3
12,21,1122,2,1,1
12,21,376,27,14,13
12,21,553,30,15,15
12,21,828,83,43,40
12,21,641,49,18,31
12,21,230,4,2,2
12,21,2278,5,2,3
12,21,2020,51,22,29
12,21,713,7,5,2
12,21,1101,30,14,16
12,21,1351,37,15,22
12,21,1057,0,0,0
12,21,2409,9,4,5
12,21,2149,27,15,12
12,21,2563,202,98,104
12,21,977,19,9,10
12,21,1017,7,2,5
12,21,3375,34,12,22
12,21,1334,2,0,2
12,21,4020,201,99,102
12,21,767,95,42,53
12,21,941,95,53,42
12,21,942,14,8,6
12,22,1571,56,30,26
12,22,468,26,12,14
12,22,2635,7,7,0
12,22,2614,43,25,18
12,22,75,0,0,0
12,22,154,0,0,0
12,22,61,0,0,0
12,22,991,1,1,0
12,22,234,0,0,0
12,22,688,0,0,0
12,22,756,1,0,1
12,22,775,0,0,0
12,22,494,2,1,1
12,22,1276,2,2,0
12,22,458,0,0,0
12,22,750,0,0,0
12,22,706,0,0,0
12,22,529,0,0,0
12,22,492,0,0,0
12,22,548,0,0,0
12,22,646,0,0,0
12,22,721,5,4,1
12,22,261,0,0,0
12,22,663,1,1,0
12,22,767,0,0,0
12,22,480,1,0,1
12,22,1910,1,0,1
12,22,1048,1,0,1
12,22,235,0,0,0
12,22,486,0,0,0
12,22,325,2,1,1
12,22,666,1,0,1
12,22,619,3,1,2
12,22,440,0,0,0
12,22,173,1,1,0
12,22,765,5,2,3
12,22,467,1,0,1
12,22,524,4,1,3
12,22,259,0,0,0
12,22,1582,0,0,0
12,22,176,0,0,0
12,22,218,0,0,0
12,22,126,1,0,1
12,22,1167,5,2,3
12,22,545,2,2,0
12,22,569,2,0,2
12,22,528,1,1,0
12,22,270,0,0,0
12,22,325,4,2,2
12,22,1313,3,0,3
12,22,221,0,0,0
12,22,992,2,2,0
12,22,224,1,0,1
12,22,1046,1,0,1
12,22,514,4,2,2
12,22,662,0,0,0
12,23,1792,1350,705,645
12,23,1581,1274,677,597
12,23,2325,1707,890,817
12,23,1358,1130,575,555
12,23,1124,983,513,470
12,23,1064,956,498,458
12,23,1251,1016,535,481
12,23,882,683,341,342
12,23,253,109,70,39
12,23,573,422,210,212
12,23,339,216,99,117
12,23,971,826,401,425
12,23,1199,581,297,284
12,23,1584,1215,573,642
12,23,665,239,121,118
12,23,714,551,272,279
12,23,844,718,359,359
12,80,430,255,121,134
12,23,489,450,221,229
12,23,936,887,429,458
12,23,233,181,86,95
12,23,906,828,384,444
12,23,1294,1159,576,583
12,23,910,854,424,430
12,23,1048,940,465,475
12,23,485,380,174,206
12,23,1081,981,475,506
12,23,430,360,170,190
12,23,582,541,265,276
12,24,2335,39,15,24
12,24,898,0,0,0
12,24,200,2,0,2
12,24,1428,0,0,0
12,24,1073,0,0,0
12,24,821,3,2,1
12,24,884,5,2,3
12,25,1579,377,192,185
12,25,2995,561,298,263
12,25,1828,1012,509,503
12,25,1267,424,227,197
12,25,600,4,3,1
12,25,1216,138,65,73
12,25,366,256,125,131
12,25,765,37,18,19
12,25,1938,828,425,403
12,25,1065,209,105,104
12,25,724,661,341,320
12,25,1446,1040,522,518
12,25,865,752,389,363
12,26,585,13,7,6
12,26,407,0,0,0
12,26,546,12,7,5
12,26,744,18,6,12
12,26,388,27,16,11
12,26,758,15,8,7
12,26,638,7,3,4
12,26,622,11,3,8
12,26,753,8,3,5
12,26,886,0,0,0
12,26,277,0,0,0
12,26,276,1,0,1
12,26,430,2,1,1
12,26,540,2,1,1
12,26,97,0,0,0
12,26,435,4,1,3
12,27,1242,8,3,5
12,27,1176,9,4,5
12,27,841,2,1,1
12,27,1336,2,1,1
12,27,736,0,0,0
12,27,512,0,0,0
12,27,155,1,0,1
12,27,184,0,0,0
12,27,251,0,0,0
12,27,228,0,0,0
12,27,153,0,0,0
12,27,173,0,0,0
12,27,1168,0,0,0
12,27,235,0,0,0
12,27,397,0,0,0
12,27,926,1,0,1
12,27,630,1,0,1
12,27,905,1,1,0
12,27,254,0,0,0
12,27,190,0,0,0
12,27,219,2,1,1
12,27,187,0,0,0
12,27,461,0,0,0
12,27,148,0,0,0
12,27,535,0,0,0
12,27,354,0,0,0
12,27,171,0,0,0
12,27,172,0,0,0
12,27,747,1,1,0
12,27,381,0,0,0
12,27,360,0,0,0
12,27,523,0,0,0
12,27,359,0,0,0
12,27,506,2,0,2
12,27,1101,2,1,1
12,27,180,1,1,0
12,27,337,1,1,0
12,27,266,2,1,1
12,27,282,0,0,0
12,27,576,4,2,2
12,27,270,0,0,0
12,27,777,0,0,0
12,28,8448,750,387,363
12,28,6684,294,152,142
12,28,4375,131,70,61
12,28,1828,55,36,19
12,28,1398,27,18,9
12,28,2046,115,61,54
12,28,1446,159,77,82
12,28,2887,188,103,85
12,28,1736,14,10,4
12,28,1972,44,22,22
12,28,2960,90,46,44
12,28,1977,8,2,6
12,28,1746,9,6,3
12,28,1298,3,2,1
12,28,2240,1,1,0
12,28,1534,3,2,1
12,28,1415,2,0,2
12,28,1862,2,0,2
12,28,741,1,1,0
12,28,1025,2,1,1
12,28,2644,33,18,15
12,28,803,4,2,2
12,28,720,1,0,1
12,28,1598,17,8,9
12,28,1078,202,110,92
12,28,344,1,1,0
12,28,722,116,61,55
12,28,1251,9,0,9
12,28,827,0,0,0
12,28,532,0,0,0
12,28,855,71,35,36
12,28,475,0,0,0
12,28,1193,6,2,4
12,28,653,12,10,2
12,28,250,2,1,1
12,28,284,10,7,3
12,28,737,7,2,5
12,28,934,10,6,4
12,28,998,14,7,7
12,28,2314,16,12,4
12,28,918,41,19,22
12,28,317,1,1,0
12,28,1530,13,7,6
12,28,1229,3,2,1
12,28,644,19,8,11
12,28,2340,131,71,60
12,28,622,8,5,3
12,28,761,6,2,4
12,28,549,12,7,5
12,28,1193,42,23,19
12,28,880,183,102,81
12,28,641,2,1,1
12,28,1615,21,9,12
12,28,525,0,0,0
12,28,1062,53,32,21
12,28,1936,13,11,2
12,28,500,32,15,17
12,28,701,534,278,256
12,28,1501,14,8,6
12,28,548,246,140,106
12,28,902,317,172,145
12,28,1511,17,9,8
12,28,438,4,3,1
12,28,3076,38,27,11
12,28,531,132,76,56
12,28,2314,204,114,90
12,28,2020,401,207,194
12,28,971,21,9,12
12,28,102,1,1,0
12,28,3118,37,20,17
12,28,702,0,0,0
12,28,971,22,11,11
12,28,1725,2,1,1
12,77,2243,2,1,1
12,28,599,2,2,0
12,28,1260,183,93,90
12,28,671,0,0,0
12,28,1337,4,2,2
12,77,2704,25,15,10
12,77,1204,2,1,1
12,77,761,11,4,7
12,28,459,1,1,0
12,28,1428,12,5,7
12,77,4055,80,43,37
12,77,1692,8,3,5
12,28,411,1,0,1
12,77,2914,3,3,0
12,77,1997,6,6,0
12,28,2730,128,67,61
12,28,2578,133,72,61
12,28,1483,3,3,0
12,28,3435,74,40,34
12,29,14426,2049,1060,989
12,29,3491,296,163,133
12,29,2326,307,170,137
12,29,6163,550,296,254
12,29,5160,613,313,300
12,29,1197,75,39,36
12,29,3630,328,172,156
12,29,2489,303,160,143
12,29,3995,713,391,322
12,29,19798,1495,746,749
12,29,2159,278,160,118
12,29,1170,184,102,82
12,29,3275,319,158,161
12,29,2639,480,253,227
12,29,3091,154,77,77
12,29,1609,127,63,64
12,29,1859,194,102,92
12,29,3826,190,105,85
12,29,4253,481,260,221
12,29,1723,104,47,57
12,29,1080,39,23,16
12,29,845,19,9,10
12,29,1662,95,51,44
12,29,2282,208,100,108
12,29,3556,191,101,90
12,29,1872,151,78,73
12,29,1245,69,40,29
12,29,805,48,31,17
12,29,2799,345,184,161
12,29,1124,122,63,59
12,29,2487,293,140,153
12,29,1959,202,104,98
12,29,1291,82,43,39
12,29,1783,125,67,58
12,29,1689,172,101,71
12,29,894,74,41,33
12,29,1441,68,34,34
12,29,1308,150,83,67
12,29,2190,260,127,133
12,29,4122,284,149,135
12,29,2961,124,70,54
12,29,3894,168,99,69
12,29,1336,56,33,23
12,29,1858,120,76,44
12,29,1494,53,25,28
12,29,1377,59,22,37
12,29,1309,129,80,49
12,29,1688,113,74,39
12,29,3443,478,250,228
12,29,1268,125,49,76
12,29,1470,208,115,93
12,29,1097,46,30,16
12,29,1470,61,28,33
12,29,5846,281,149,132
12,29,2185,132,72,60
12,29,7686,838,460,378
12,29,1829,122,63,59
12,29,1765,89,35,54
12,29,1067,66,34,32
12,29,3936,290,170,120
12,29,2699,496,272,224
12,29,7388,808,429,379
12,29,4169,431,220,211
12,29,22476,2290,1150,1140
12,29,1796,146,81,65
12,29,2108,236,132,104
12,29,4506,527,284,243
12,29,7533,955,530,425
12,29,1519,11,4,7
12,29,236,3,1,2
12,29,539,1,0,1
12,29,2480,3,2,1
12,29,275,1,1,0
12,29,1469,1,1,0
12,29,5440,293,161,132
12,29,2720,118,58,60
12,29,4345,698,357,341
12,29,1864,52,31,21
12,29,495,2,2,0
12,29,907,1,0,1
12,29,1231,5,1,4
12,29,1985,26,7,19
12,29,2153,62,36,26
12,29,2393,84,48,36
12,29,2674,249,133,116
12,29,5,0,0,0
12,29,662,1,1,0
12,29,1083,2,0,2
12,29,609,26,13,13
12,29,1167,0,0,0
12,29,1595,12,7,5
12,29,1283,63,35,28
12,29,648,32,17,15
12,29,357,0,0,0
12,29,721,3,2,1
12,29,1253,112,58,54
12,29,1914,421,227,194
12,29,951,657,325,332
12,29,2573,137,72,65
12,29,4637,232,118,114
12,29,1346,136,68,68
12,29,521,0,0,0
12,29,2022,86,44,42
12,29,903,268,138,130
12,30,1860,105,56,49
12,30,1933,233,121,112
12,30,1531,181,93,88
12,30,1675,193,95,98
12,30,1457,105,47,58
12,30,3641,78,44,34
12,30,1922,129,61,68
12,30,1646,67,30,37
12,30,3856,286,147,139
12,30,3783,359,180,179
12,30,4869,438,220,218
12,30,695,14,8,6
12,30,1048,0,0,0
12,30,3232,47,24,23
12,30,2543,34,14,20
12,30,593,2,1,1
12,30,1458,0,0,0
12,30,257,2,2,0
12,30,1541,18,11,7
12,30,1336,31,14,17
12,30,2198,21,8,13
12,30,1507,467,239,228
12,30,1391,535,271,264
12,30,440,11,7,4
12,30,2175,18,11,7
12,30,2370,25,17,8
12,30,825,38,21,17
12,30,959,6,5,1
12,30,564,0,0,0
12,31,4729,2636,1344,1292
12,31,776,463,265,198
12,31,2604,1549,811,738
12,31,3161,1662,883,779
12,31,2393,1129,564,565
12,31,664,112,51,61
12,31,333,146,76,70
12,31,826,511,267,244
12,31,798,539,264,275
12,31,455,318,158,160
12,31,193,89,45,44
12,31,517,472,223,249
12,31,1194,322,165,157
12,31,743,383,175,208
12,31,377,203,106,97
12,31,931,245,114,131
12,31,1150,775,387,388
12,31,738,100,49,51
12,32,1495,2,2,0
12,32,569,0,0,0
12,32,237,0,0,0
12,32,759,6,4,2
12,32,549,0,0,0
12,32,227,0,0,0
12,32,174,0,0,0
12,32,151,0,0,0
12,32,494,0,0,0
12,32,299,0,0,0
12,32,231,4,1,3
12,32,211,0,0,0
12,32,208,2,1,1
12,32,211,0,0,0
12,32,164,0,0,0
12,32,172,0,0,0
12,32,0,0,0,0
12,33,2411,19,14,5
12,33,2232,16,8,8
12,33,4026,140,78,62
12,33,1064,6,5,1
12,33,246,1,0,1
12,33,619,21,9,12
12,33,241,0,0,0
12,33,305,1,1,0
12,33,284,0,0,0
12,33,800,1,0,1
12,33,375,0,0,0
12,33,336,4,3,1
12,33,352,6,2,4
12,33,71,0,0,0
12,33,691,74,44,30
12,33,251,1,0,1
12,33,413,1,0,1
12,33,1154,5,1,4
12,33,506,2,0,2
12,33,754,0,0,0
12,33,493,0,0,0
12,33,651,0,0,0
12,33,275,75,33,42
12,33,477,0,0,0
12,33,602,7,3,4
12,33,867,44,20,24
12,33,645,0,0,0
12,33,236,4,2,2
12,33,324,0,0,0
12,33,579,0,0,0
12,33,700,1,1,0
12,33,338,0,0,0
12,33,1060,0,0,0
12,33,972,13,5,8
12,33,722,1,0,1
12,33,717,8,3,5
12,33,1219,3,2,1
12,33,604,0,0,0
12,33,309,1,0,1
12,33,579,4,2,2
12,33,235,1,0,1
12,33,741,7,5,2
12,33,361,0,0,0
12,33,1245,13,6,7
12,33,2167,7,4,3
12,33,803,2,1,1
12,33,1942,17,10,7
12,34,3441,58,32,26
12,34,1895,39,19,20
12,34,2509,75,43,32
12,34,371,150,74,76
12,34,404,1,1,0
12,34,2439,71,39,32
12,34,780,2,1,1
12,34,1301,68,34,34
12,34,1359,2,1,1
12,34,1382,5,4,1
12,34,1048,20,6,14
12,34,817,1,1,0
12,35,1340,6,5,1
12,35,1707,6,3,3
12,35,2255,4,1,3
12,35,1205,18,11,7
12,35,848,6,3,3
12,35,1933,55,27,28
12,35,1006,17,8,9
12,35,1000,23,10,13
12,35,1352,17,7,10
12,35,1604,67,33,34
12,35,3325,344,181,163
12,35,1290,22,12,10
12,35,819,5,2,3
12,35,202,0,0,0
12,35,862,0,0,0
12,35,668,0,0,0
12,35,633,1,1,0
12,35,205,1,1,0
12,35,508,10,4,6
12,35,1152,25,14,11
12,35,1297,7,4,3
12,35,1178,9,4,5
12,35,205,0,0,0
12,35,329,0,0,0
12,35,615,4,3,1
12,35,1089,6,2,4
12,35,255,0,0,0
12,35,351,7,5,2
12,35,650,12,8,4
12,35,898,3,2,1
12,35,870,0,0,0
12,35,299,0,0,0
12,35,228,4,2,2
12,35,1826,12,5,7
12,35,1685,3,1,2
12,35,889,15,7,8
12,36,7392,69,27,42
12,36,1554,34,19,15
12,36,934,4,2,2
12,36,1521,38,20,18
12,36,4173,83,43,40
12,36,7921,185,90,95
12,36,2147,48,28,20
12,36,2652,135,69,66
12,36,1059,21,11,10
12,36,1197,123,59,64
12,36,1685,77,52,25
12,36,1926,60,29,31
12,36,2316,102,59,43
12,36,3501,56,32,24
12,36,2328,21,13,8
12,36,4996,57,37,20
12,36,667,46,25,21
12,36,950,56,32,24
12,36,1019,54,36,18
12,36,3296,97,46,51
12,36,3647,103,44,59
12,36,2085,41,14,27
12,36,1016,36,20,16
12,36,912,144,73,71
12,36,705,29,12,17
12,36,899,63,34,29
12,36,782,14,6,8
12,36,1119,30,17,13
12,36,1171,11,4,7
12,36,1571,17,9,8
12,36,2281,108,49,59
12,36,1351,45,21,24
12,36,1355,14,6,8
12,36,1363,22,9,13
12,36,928,18,10,8
12,36,1468,64,31,33
12,36,5231,121,60,61
12,36,3390,86,42,44
12,36,1901,29,15,14
12,36,1190,9,6,3
12,36,964,10,5,5
12,36,1425,94,44,50
12,36,1905,78,37,41
12,36,1175,67,36,31
12,36,1392,35,21,14
12,36,1023,3,2,1
12,36,1450,29,17,12
12,36,1497,4,2,2
12,36,910,8,4,4
12,36,885,6,5,1
12,36,898,6,2,4
12,36,1344,7,3,4
12,36,2106,104,50,54
12,36,1661,7,3,4
12,36,2512,40,21,19
12,36,2353,119,58,61
12,36,2263,4,2,2
12,36,1491,16,9,7
12,36,1833,11,6,5
12,36,8047,149,77,72
12,36,1013,12,7,5
12,36,1399,0,0,0
12,36,2431,32,17,15
12,36,4087,24,14,10
12,36,1052,38,23,15
12,36,666,3,1,2
12,36,1838,311,148,163
12,36,3755,117,38,79
12,36,482,0,0,0
12,36,708,4,3,1
12,36,1606,0,0,0
12,36,808,3,1,2
12,36,496,14,10,4
12,36,589,33,18,15
12,36,321,36,17,19
12,36,428,15,7,8
12,36,210,1,1,0
12,36,1723,20,6,14
12,36,948,1,1,0
12,36,744,110,60,50
12,36,1131,43,15,28
12,36,145,1,0,1
12,36,1146,48,28,20
12,36,768,1,1,0
12,36,787,4,1,3
12,37,947,153,82,71
12,37,1217,431,212,219
12,37,1323,639,320,319
12,37,1127,120,62,58
12,37,1449,173,87,86
12,37,807,168,94,74
12,37,485,8,2,6
12,37,782,173,98,75
12,37,624,81,45,36
12,37,453,92,41,51
12,37,1567,994,541,453
12,38,1709,1,1,0
12,38,1036,3,1,2
12,38,214,1,1,0
12,38,258,0,0,0
12,38,413,0,0,0
12,38,365,0,0,0
12,38,122,0,0,0
12,38,449,1,0,1
12,38,439,1,1,0
12,38,154,0,0,0
12,38,152,0,0,0
12,38,827,0,0,0
12,39,2462,47,25,22
12,39,7349,324,169,155
12,39,1729,53,31,22
12,39,1892,14,7,7
12,39,3238,77,42,35
12,39,2732,48,16,32
12,39,3024,75,33,42
12,39,930,73,36,37
12,39,1378,30,13,17
12,39,843,3,1,2
12,39,2343,159,83,76
12,39,1086,20,10,10
12,39,930,22,10,12
12,39,918,100,54,46
12,39,1991,73,30,43
12,39,643,63,28,35
12,39,931,79,36,43
12,39,1363,76,31,45
12,39,932,80,38,42
12,39,538,12,5,7
12,39,4721,613,302,311
12,39,1602,23,7,16
12,39,2568,181,82,99
12,39,1490,422,211,211
12,39,2139,356,183,173
12,39,2175,46,29,17
12,39,3048,197,99,98
12,39,5476,188,105,83
12,39,1857,35,18,17
12,39,1735,248,126,122
12,39,1702,299,158,141
12,39,1256,161,82,79
12,39,574,8,5,3
12,39,289,6,4,2
12,39,483,11,6,5
12,39,1187,6,2,4
12,39,1058,35,21,14
12,39,218,0,0,0
12,39,455,4,1,3
12,39,667,8,3,5
12,39,152,1,0,1
12,39,366,12,6,6
12,39,1016,13,3,10
12,39,533,82,41,41
12,39,3197,20,10,10
12,39,1275,3,2,1
12,39,234,2,2,0
12,39,5724,356,169,187
12,39,1840,33,15,18
12,39,2369,436,225,211
12,39,3173,104,55,49
12,39,474,41,26,15
12,39,8772,641,323,318
12,39,6155,308,143,165
12,39,2021,837,412,425
12,39,2867,17,12,5
12,39,3742,103,49,54
12,39,2301,397,205,192
12,39,1463,167,79,88
12,39,736,6,4,2
12,39,1165,6,3,3
12,39,1813,23,12,11
12,39,2655,87,40,47
12,40,2486,617,320,297
12,40,1617,223,118,105
12,40,3795,701,333,368
12,40,1367,319,157,162
12,40,180,11,4,7
12,40,743,103,42,61
12,40,1412,214,119,95
12,40,1471,82,37,45
12,40,793,10,6,4
12,40,776,5,2,3
12,40,686,35,17,18
12,40,1413,1005,502,503
12,40,908,2,1,1
12,40,1099,319,146,173
12,40,638,128,66,62
12,40,449,0,0,0
12,40,581,36,16,20
12,40,176,32,17,15
12,40,150,33,15,18
12,40,280,181,86,95
12,40,1738,1142,558,584
12,40,294,26,16,10
12,40,2320,1567,829,738
12,41,2206,105,49,56
12,41,1585,44,24,20
12,41,782,1,1,0
12,41,4247,19,6,13
12,41,1415,21,9,12
12,41,2258,30,13,17
12,41,308,3,0,3
12,41,760,8,4,4
12,41,354,2,1,1
12,41,939,1,0,1
12,41,146,0,0,0
12,41,1078,4,3,1
12,41,1223,5,3,2
12,41,505,2,1,1
12,41,1222,4,1,3
12,41,850,4,3,1
12,41,797,0,0,0
12,41,238,1,0,1
12,41,2864,8,5,3
12,41,908,9,4,5
12,41,523,0,0,0
12,41,1217,1,0,1
12,42,2547,584,311,273
12,42,3507,1318,679,639
12,42,1510,0,0,0
12,42,1565,741,400,341
12,42,2713,1406,757,649
12,42,1377,202,93,109
12,42,538,465,251,214
12,42,1467,567,304,263
12,42,2688,125,67,58
12,42,1831,119,64,55
12,78,817,6,0,6
12,42,2531,765,380,385
12,42,1548,255,131,124
12,78,3153,157,87,70
12,78,3530,410,224,186
12,78,1877,7,6,1
12,42,532,1,0,1
12,42,3406,369,187,182
12,42,2660,2,0,2
12,42,1592,9,3,6
12,43,1596,60,28,32
12,43,1762,28,18,10
12,43,1559,136,68,68
12,43,415,3,1,2
12,43,694,2,1,1
12,43,791,3,1,2
12,43,705,5,0,5
12,43,565,7,4,3
12,43,1864,4,3,1
12,43,202,1,0,1
12,43,516,3,1,2
12,43,434,0,0,0
12,43,626,1,0,1
12,43,2744,9,2,7
12,43,2712,12,7,5
12,43,1869,119,69,50
12,44,2483,7,5,2
12,44,3035,6,4,2
12,44,732,1,0,1
12,44,634,0,0,0
12,44,759,0,0,0
12,44,726,2,1,1
12,44,850,5,3,2
12,44,534,3,2,1
12,79,402,1,1,0
12,44,516,0,0,0
12,44,1386,0,0,0
12,44,1126,1,0,1
12,79,667,0,0,0
12,79,1498,1,0,1
12,44,807,0,0,0
12,79,1574,1,0,1
12,79,5987,43,17,26
12,44,1043,18,12,6
12,44,2119,1,0,1
12,79,1949,48,24,24
12,44,592,1,0,1
12,79,1259,17,7,10
12,79,808,1,1,0
12,79,1354,5,3,2
12,79,1679,7,3,4
12,79,1209,3,3,0
12,79,914,0,0,0
12,44,2359,35,13,22
12,37,754,3,1,2
12,45,1371,58,34,24
12,45,1320,19,9,10
12,45,1821,51,26,25
12,45,1699,27,15,12
12,45,611,58,27,31
12,45,732,16,8,8
12,45,892,123,56,67
12,45,326,22,10,12
12,45,237,19,11,8
12,45,443,89,43,46
12,45,380,80,41,39
12,45,820,33,20,13
12,45,751,82,42,40
12,45,310,2,2,0
12,45,165,0,0,0
12,45,197,16,6,10
12,45,245,8,4,4
12,46,2179,28,15,13
12,46,1968,11,3,8
12,46,3349,77,39,38
12,46,652,254,127,127
12,46,245,47,24,23
12,46,1165,863,468,395
12,46,416,28,10,18
12,46,715,22,16,6
12,46,1597,478,259,219
12,46,848,638,327,311
12,46,751,561,306,255
12,46,510,18,7,11
12,46,284,1,1,0
12,46,1291,126,70,56
12,46,4364,1376,722,654
12,46,767,253,128,125
12,46,2698,430,226,204
12,46,752,3,1,2
12,46,281,13,5,8
12,46,429,232,122,110
12,46,865,83,45,38
12,46,449,51,30,21
12,46,175,0,0,0
12,46,564,505,279,226
12,46,1122,2,2,0
12,47,8221,2021,1053,968
12,47,3596,708,358,350
12,47,2293,475,253,222
12,47,3751,860,447,413
12,47,2724,551,291,260
12,47,2355,529,301,228
12,47,1527,327,143,184
12,47,3273,476,271,205
12,47,2194,241,116,125
12,47,2808,12,6,6
12,47,4595,9,5,4
12,47,2621,3,2,1
12,47,3802,2796,1392,1404
12,47,919,275,137,138
12,47,671,139,71,68
12,47,5185,93,34,59
12,47,453,74,38,36
12,47,1252,96,51,45
12,47,427,20,11,9
12,47,1470,300,142,158
12,47,745,222,121,101
12,47,3387,342,176,166
12,47,396,39,19,20
12,47,715,382,186,196
12,47,761,700,341,359
12,47,333,46,24,22
12,47,206,15,5,10
12,47,199,2,1,1
12,47,614,376,188,188
12,47,704,609,315,294
12,47,948,15,6,9
12,47,2566,206,113,93
12,47,391,219,125,94
12,47,294,84,42,42
12,47,581,223,112,111
12,47,171,19,8,11
12,47,652,466,239,227
12,47,127,109,47,62
12,48,1107,0,0,0
12,48,395,0,0,0
12,48,215,1,0,1
12,48,476,0,0,0
12,48,51,0,0,0
12,48,406,1,1,0
12,48,456,0,0,0
12,48,132,0,0,0
12,48,182,1,1,0
12,48,179,0,0,0
12,48,234,0,0,0
12,48,429,0,0,0
12,48,99,1,1,0
12,48,562,4,4,0
12,48,75,0,0,0
12,48,325,0,0,0
12,48,468,0,0,0
12,48,608,0,0,0
12,48,144,0,0,0
12,48,168,0,0,0
12,48,141,0,0,0
12,48,100,0,0,0
12,48,111,0,0,0
12,49,3937,106,55,51
12,49,219,2,0,2
12,49,702,4,2,2
12,49,1394,20,12,8
12,49,1274,19,11,8
12,49,2496,28,12,16
12,49,1266,32,18,14
12,49,1168,18,9,9
12,49,975,6,3,3
12,49,988,63,25,38
12,49,1658,31,11,20
12,49,1080,13,7,6
12,49,4199,500,262,238
12,49,1451,83,50,33
12,49,830,25,10,15
12,49,433,0,0,0
12,49,224,0,0,0
12,49,186,32,18,14
12,49,446,65,28,37
12,49,141,0,0,0
12,49,258,0,0,0
12,49,285,188,90,98
12,49,296,1,1,0
12,49,37,0,0,0
12,49,222,1,1,0
12,49,121,0,0,0
12,49,242,0,0,0
12,49,624,1,0,1
12,49,195,0,0,0
12,49,498,4,4,0
12,49,318,5,1,4
12,49,2465,16,7,9
12,49,1514,27,8,19
12,49,1868,12,5,7
12,49,1148,11,5,6
12,49,1554,57,27,30
12,49,489,0,0,0
12,49,539,29,14,15
12,49,353,6,1,5
12,49,532,0,0,0
12,49,147,1,0,1
12,49,384,8,5,3
12,49,239,12,7,5
12,49,268,6,3,3
12,49,178,1,0,1
12,49,785,22,9,13
12,49,508,4,2,2
12,49,238,1,0,1
12,49,254,44,20,24
12,49,1591,25,13,12
12,49,381,38,19,19
12,49,647,37,20,17
12,49,146,0,0,0
12,50,2196,86,45,41
12,50,925,14,7,7
12,50,3320,17,7,10
12,50,1206,13,5,8
12,50,435,2,1,1
12,50,439,0,0,0
12,50,366,5,2,3
12,50,479,1,1,0
12,50,263,4,1,3
12,50,253,0,0,0
12,50,750,21,9,12
12,50,1153,42,20,22
12,50,386,0,0,0
12,50,437,0,0,0
12,50,281,8,4,4
12,50,6,0,0,0
12,51,2515,132,59,73
12,51,2931,20,10,10
12,51,2386,68,37,31
12,51,1667,28,12,16
12,51,1958,3,2,1
12,51,3175,12,3,9
12,51,2287,14,8,6
12,51,1290,5,2,3
12,51,1568,7,3,4
12,51,1652,8,5,3
12,51,3227,60,35,25
12,51,1740,24,13,11
12,51,3,0,0,0
12,51,267,1,1,0
12,51,720,266,140,126
12,51,540,0,0,0
12,51,389,1,1,0
12,51,404,1,0,1
12,51,2356,4,1,3
12,51,1790,5,2,3
12,51,783,7,5,2
12,51,3294,5,4,1
12,51,1472,2,2,0
12,52,1689,421,214,207
12,52,1649,590,334,256
12,52,2095,790,398,392
12,52,2856,946,497,449
12,52,417,129,60,69
12,52,1083,484,260,224
12,52,1035,154,89,65
12,52,1188,624,316,308
12,52,763,3,1,2
12,52,2954,770,415,355
12,52,987,46,22,24
12,52,130,20,10,10
12,52,950,107,53,54
12,52,1092,277,143,134
12,52,1075,854,423,431
12,52,348,0,0,0
12,52,234,0,0,0
12,52,2062,2,1,1
12,52,587,1,1,0
12,52,215,110,56,54
12,52,789,0,0,0
12,52,677,1,0,1
12,52,933,0,0,0
12,52,792,1,1,0
12,52,428,32,18,14
12,52,498,367,191,176
12,52,473,7,3,4
12,52,744,4,3,1
12,52,773,4,1,3
12,52,407,0,0,0
12,52,418,2,1,1
12,52,356,6,5,1
12,52,709,40,20,20
12,52,554,345,159,186
12,52,478,5,2,3
12,52,637,0,0,0
12,52,509,7,3,4
12,52,562,177,95,82
12,52,711,9,7,2
12,52,1167,20,9,11
12,53,3910,319,162,157
12,53,2153,283,156,127
12,53,3534,712,361,351
12,53,1523,121,61,60
12,78,743,357,194,163
12,53,1437,222,106,116
12,53,1577,109,60,49
12,53,866,6,3,3
12,53,1045,3,1,2
12,53,4240,16,5,11
12,53,1476,2,0,2
12,53,4518,250,131,119
12,53,686,0,0,0
12,53,2196,622,305,317
12,53,745,1,0,1
12,53,3883,29,14,15
12,53,1044,135,68,67
12,53,738,273,142,131
12,53,616,3,2,1
12,53,234,0,0,0
12,53,3494,21,9,12
12,53,339,32,17,15
12,53,398,0,0,0
12,53,274,18,11,7
12,53,1556,197,98,99
12,53,751,42,18,24
12,54,1188,379,189,190
12,54,1354,460,216,244
12,54,1565,758,418,340
12,54,1366,265,134,131
12,54,598,70,40,30
12,54,1672,761,393,368
12,54,1776,456,223,233
12,54,760,336,193,143
12,54,1813,291,162,129
12,54,2897,114,51,63
12,54,2887,331,183,148
12,54,633,12,5,7
12,54,1711,250,130,120
12,54,411,384,190,194
12,54,849,0,0,0
12,54,1600,855,434,421
12,54,674,4,2,2
12,54,877,120,63,57
12,54,1295,273,142,131
12,54,1618,12,7,5
12,54,442,9,4,5
12,54,764,4,2,2
12,54,287,3,1,2
12,54,897,715,369,346
12,54,238,229,128,101
12,54,685,3,1,2
12,54,1264,7,4,3
12,54,795,342,165,177
12,54,492,144,79,65
12,54,1396,249,131,118
12,54,841,41,22,19
12,54,1479,378,172,206
12,54,1506,186,101,85
12,54,1202,157,82,75
12,54,1407,291,154,137
12,54,658,0,0,0
12,54,489,52,24,28
12,54,1517,299,148,151
12,54,1359,4,3,1
12,54,901,86,45,41
12,54,1724,54,26,28
12,54,722,120,54,66
12,54,206,21,12,9
12,54,351,1,0,1
12,54,636,0,0,0
12,54,1100,27,14,13
12,54,868,1,0,1
12,55,711,0,0,0
12,55,1362,2,0,2
12,55,1484,3,1,2
12,55,1092,0,0,0
12,55,692,4,1,3
12,55,1060,1,1,0
12,55,224,0,0,0
12,55,362,1,0,1
12,55,635,3,1,2
12,55,1626,3,3,0
12,55,700,0,0,0
12,55,243,0,0,0
12,55,779,1,0,1
12,55,376,0,0,0
12,55,204,0,0,0
12,55,99,1,0,1
12,55,172,1,1,0
12,55,437,0,0,0
12,55,100,0,0,0
12,55,259,0,0,0
12,55,424,0,0,0
12,55,398,5,3,2
12,55,663,0,0,0
12,55,500,0,0,0
12,55,489,3,0,3
12,55,325,0,0,0
12,55,263,12,6,6
12,55,412,3,1,2
12,55,808,2,2,0
12,55,515,1,1,0
12,55,327,4,3,1
12,55,534,1,1,0
12,55,347,0,0,0
12,55,348,0,0,0
12,55,458,1,0,1
12,55,1454,0,0,0
12,55,1135,3,0,3
12,55,863,3,0,3
12,55,1321,16,9,7
12,56,377,4,1,3
12,56,737,91,50,41
12,56,1635,29,12,17
12,56,3066,52,31,21
12,56,1370,63,35,28
12,56,1904,27,12,15
12,56,1970,31,17,14
12,56,844,16,8,8
12,56,2073,41,20,21
12,56,719,30,18,12
12,56,457,5,2,3
12,56,178,0,0,0
12,56,602,1,1,0
12,56,1086,0,0,0
12,56,2832,120,66,54
12,56,908,5,1,4
12,56,1091,15,7,8
12,56,1249,13,8,5
12,56,579,2,0,2
12,56,1536,33,11,22
12,56,1047,9,4,5
12,56,1926,32,18,14
12,56,1422,80,32,48
12,56,705,9,5,4
12,56,2666,63,35,28
12,56,1455,3,0,3
12,56,1075,20,11,9
12,56,3667,43,24,19
12,56,1727,47,22,25
12,56,1624,21,13,8
12,56,847,0,0,0
12,56,1294,7,4,3
12,56,472,0,0,0
12,56,2236,69,31,38
12,56,3949,17,9,8
12,56,223,1,0,1
12,56,42,0,0,0
12,56,139,0,0,0
12,56,128,0,0,0
12,56,71,5,2,3
12,56,611,6,3,3
12,56,455,0,0,0
12,56,1102,0,0,0
12,56,472,4,0,4
12,56,583,0,0,0
12,56,1245,2,2,0
12,56,562,32,22,10
12,56,1690,15,9,6
12,56,1621,14,10,4
12,56,652,1,0,1
12,56,298,0,0,0
12,56,124,0,0,0
12,56,386,1,0,1
12,56,212,0,0,0
12,56,152,0,0,0
12,56,226,0,0,0
12,56,3425,8,2,6
12,56,540,0,0,0
12,56,1452,3,1,2
12,56,719,18,8,10
12,56,3533,25,15,10
12,56,1821,0,0,0
12,56,638,1,0,1
12,56,804,2,0,2
12,56,603,4,3,1
12,56,467,0,0,0
12,56,914,66,34,32
12,56,135,1,1,0
12,56,1935,1,1,0
12,56,460,0,0,0
12,56,1733,0,0,0
12,56,1736,18,10,8
12,56,1350,3,2,1
12,56,3739,293,155,138
12,56,1783,4,2,2
12,56,1298,5,3,2
12,56,700,0,0,0
12,56,395,0,0,0
12,56,983,3,3,0
12,56,138,0,0,0
12,56,368,1,0,1
12,56,389,2,1,1
12,56,437,0,0,0
12,56,666,3,2,1
12,56,409,17,9,8
12,56,376,7,3,4
12,56,245,0,0,0
12,56,2601,15,9,6
12,57,2184,1419,765,654
12,57,2482,1862,957,905
12,57,591,187,95,92
12,57,666,1,1,0
12,57,756,48,25,23
12,57,904,5,1,4
12,57,840,464,224,240
12,57,569,535,258,277
12,57,1579,160,84,76
12,57,2175,332,172,160
12,57,1480,9,2,7
12,57,1821,761,374,387
12,57,1419,324,174,150
12,57,933,45,22,23
12,57,2097,63,26,37
12,57,1986,1398,713,685
12,57,1712,1199,631,568
12,57,1621,164,82,82
12,57,897,1,1,0
12,57,1067,70,27,43
12,57,771,39,22,17
12,57,2356,8,5,3
12,57,625,324,157,167
12,57,405,355,188,167
12,57,3108,201,104,97
12,57,1291,3,1,2
12,57,1637,3,0,3
12,57,967,2,0,2
12,57,610,24,11,13
12,57,692,8,4,4
12,57,387,1,0,1
12,57,863,0,0,0
12,57,733,15,8,7
12,57,387,2,1,1
12,57,1565,22,10,12
12,57,404,0,0,0
12,57,479,12,6,6
12,57,431,71,32,39
12,57,309,4,2,2
12,58,2680,23,13,10
12,58,1228,9,7,2
12,58,1555,14,7,7
12,58,3974,16,12,4
12,58,1317,22,8,14
12,58,2253,50,28,22
12,58,1460,25,14,11
12,58,3895,39,21,18
12,58,2401,32,16,16
12,58,1858,62,34,28
12,58,1419,50,13,37
12,58,458,2,1,1
12,58,1447,22,14,8
12,58,316,4,1,3
12,58,707,6,2,4
12,58,516,5,4,1
12,58,515,6,3,3
12,58,612,68,24,44
12,58,459,0,0,0
12,58,278,12,6,6
12,58,311,9,5,4
12,58,218,157,73,84
12,58,666,10,5,5
12,58,527,214,103,111
12,49,363,57,27,30
12,58,226,76,37,39
12,58,587,6,3,3
12,58,623,13,7,6
12,58,206,6,4,2
12,58,1462,28,10,18
12,58,957,9,6,3
12,58,939,14,6,8
12,58,264,1,1,0
12,58,268,12,5,7
12,58,333,0,0,0
12,58,354,0,0,0
12,58,187,1,1,0
12,58,684,11,6,5
12,58,389,3,1,2
12,58,1437,72,34,38
12,58,434,20,10,10
12,58,1652,12,6,6
12,58,901,7,4,3
12,58,832,15,8,7
12,58,1908,91,48,43
12,58,2284,37,21,16
12,58,1050,15,11,4
12,58,1918,143,79,64
12,58,145,6,4,2
12,58,468,37,17,20
12,58,1285,386,191,195
12,58,357,2,0,2
12,58,168,0,0,0
12,58,620,2,1,1
12,58,268,0,0,0
12,58,888,5,1,4
12,58,686,4,0,4
12,58,708,6,3,3
12,58,162,2,0,2
12,58,1461,123,54,69
12,58,712,26,9,17
12,58,172,6,5,1
12,58,1580,8,2,6
12,58,1133,34,20,14
12,58,954,7,4,3
12,58,316,61,27,34
12,58,2055,4,2,2
12,59,2314,47,22,25
12,59,2070,24,7,17
12,59,2110,177,89,88
12,59,1278,23,16,7
12,59,1400,19,9,10
12,59,1383,3,1,2
12,59,1014,3,2,1
12,59,1409,5,2,3
12,59,1026,6,3,3
12,59,681,5,2,3
12,59,1718,7,4,3
12,59,3083,8,5,3
12,59,5347,5,1,4
12,59,1143,8,2,6
12,59,1771,14,6,8
12,59,529,0,0,0
12,59,237,0,0,0
12,59,124,0,0,0
12,59,359,0,0,0
12,59,259,0,0,0
12,59,170,2,2,0
12,59,127,0,0,0
12,59,0,0,0,0
12,59,386,1,1,0
12,59,196,0,0,0
12,59,248,0,0,0
12,59,481,2,2,0
12,59,84,0,0,0
12,59,169,0,0,0
12,59,201,1,0,1
12,59,140,1,1,0
12,59,317,0,0,0
12,59,188,1,1,0
12,59,259,2,1,1
12,59,188,0,0,0
12,59,173,1,1,0
12,59,341,0,0,0
12,59,0,0,0,0
12,59,677,1,0,1
12,59,157,0,0,0
12,59,193,1,0,1
12,59,125,0,0,0
12,59,580,1,0,1
12,59,280,0,0,0
12,59,216,0,0,0
12,59,333,0,0,0
12,59,380,3,1,2
12,59,177,0,0,0
12,59,861,2,2,0
12,59,123,1,1,0
12,59,425,19,10,9
12,59,663,3,2,1
12,59,340,0,0,0
12,59,444,0,0,0
12,59,518,0,0,0
12,59,615,3,2,1
12,59,915,1,1,0
12,59,719,2,1,1
12,59,163,1,0,1
12,59,1554,5,1,4
12,59,1301,0,0,0
12,59,248,0,0,0
12,59,175,0,0,0
12,59,297,0,0,0
12,59,178,1,0,1
12,59,429,0,0,0
12,59,710,12,7,5
12,59,346,0,0,0
12,59,705,0,0,0
12,59,389,1,0,1
12,59,142,3,3,0
12,59,1223,0,0,0
12,59,267,0,0,0
12,59,189,0,0,0
12,59,266,0,0,0
12,59,623,14,12,2
12,59,486,0,0,0
12,59,213,0,0,0
12,59,258,0,0,0
12,59,1950,4,4,0
12,60,1420,9,1,8
12,60,1625,13,7,6
12,60,819,18,8,10
12,60,2138,18,7,11
12,60,923,2,0,2
12,60,1237,139,77,62
12,60,680,3,1,2
12,60,1204,6,2,4
12,60,411,0,0,0
12,60,883,2,0,2
12,60,1003,5,3,2
12,60,652,3,2,1
12,60,345,0,0,0
12,60,1232,13,7,6
12,60,1523,3,1,2
12,60,210,8,3,5
12,60,382,3,2,1
12,60,703,0,0,0
12,60,1028,3,1,2
12,60,1289,271,132,139
12,60,605,11,8,3
12,60,422,0,0,0
12,60,1081,10,5,5
12,60,805,0,0,0
12,60,1076,6,3,3
12,60,953,0,0,0
12,60,1504,57,31,26
12,60,1467,31,17,14
12,60,1952,4,1,3
12,60,370,8,6,2
12,60,877,3,1,2
12,61,1097,130,65,65
12,61,1288,60,33,27
12,61,419,0,0,0
12,61,229,14,6,8
12,61,627,21,6,15
12,61,903,2,0,2
12,61,14,0,0,0
12,61,275,2,1,1
12,61,563,0,0,0
12,61,364,7,3,4
12,61,436,9,2,7
12,61,734,0,0,0
12,61,204,28,17,11
12,61,470,0,0,0
12,61,248,3,2,1
12,61,480,0,0,0
12,61,757,16,8,8
12,61,203,2,0,2
12,61,1273,10,5,5
12,61,433,17,5,12
12,61,1527,6,2,4
12,61,563,0,0,0
12,61,277,0,0,0
12,62,3897,130,60,70
12,62,1350,148,76,72
12,62,4906,241,133,108
12,62,1278,68,37,31
12,62,942,51,20,31
12,62,1375,40,25,15
12,62,3533,185,86,99
12,62,1376,118,58,60
12,62,1090,39,18,21
12,62,1952,13,5,8
12,62,1273,41,21,20
12,62,2444,183,23,160
12,62,1246,4,2,2
12,62,2276,56,34,22
12,62,1421,13,7,6
12,62,2594,54,25,29
12,62,1497,9,5,4
12,62,789,44,16,28
12,62,1346,197,103,94
12,62,753,122,73,49
12,62,141,39,21,18
12,62,474,13,6,7
12,62,403,37,23,14
12,62,511,1,0,1
12,62,1190,42,24,18
12,62,1015,32,20,12
12,62,390,1,1,0
12,62,596,0,0,0
12,62,1158,5,3,2
12,63,2337,215,107,108
12,63,2758,672,334,338
12,63,2724,24,16,8
12,63,2166,14,7,7
12,63,807,3,1,2
12,63,2474,6,6,0
12,63,1356,51,22,29
12,63,1024,25,13,12
12,63,1057,7,4,3
12,63,2530,712,377,335
12,63,1313,25,14,11
12,63,452,16,7,9
12,63,731,502,262,240
12,63,1634,319,175,144
12,64,2874,74,44,30
12,64,754,0,0,0
12,64,158,0,0,0
12,64,449,0,0,0
12,64,890,3,2,1
12,64,2108,32,14,18
12,64,287,1,1,0
12,64,336,0,0,0
12,64,1606,33,15,18
12,64,896,43,21,22
12,65,788,4,2,2
12,65,1392,7,2,5
12,65,1623,1,0,1
12,65,571,0,0,0
12,65,795,3,2,1
12,65,51,0,0,0
12,65,382,0,0,0
12,65,1182,3,1,2
12,65,90,0,0,0
12,65,291,0,0,0
12,65,271,0,0,0
12,65,386,3,0,3
12,65,366,0,0,0
12,65,370,1,0,1
12,65,119,1,1,0
12,65,968,3,3,0
12,65,925,1,0,1
12,65,1111,0,0,0
12,66,821,71,36,35
12,66,1890,84,41,43
12,66,654,16,10,6
12,66,243,3,2,1
12,66,499,0,0,0
12,66,336,1,1,0
12,66,1525,17,13,4
12,66,1423,3,1,2
12,67,2635,155,78,77
12,67,2271,199,103,96
12,67,10211,1166,620,546
12,67,12142,640,350,290
12,67,4268,658,358,300
12,67,5832,210,99,111
12,67,3510,159,79,80
12,67,7198,78,35,43
12,67,4520,197,107,90
12,67,4455,375,204,171
12,67,5428,70,43,27
12,67,956,30,13,17
12,67,732,18,10,8
12,67,1118,3,2,1
12,67,499,3,1,2
12,67,1350,1,0,1
12,67,1259,6,2,4
12,67,1180,2,1,1
12,67,1126,1,1,0
12,67,3176,268,134,134
12,67,1574,26,12,14
12,67,1487,10,4,6
12,67,1637,51,29,22
12,67,3168,9,3,6
12,67,1242,1,0,1
12,67,1011,0,0,0
12,67,1222,185,97,88
12,67,1062,274,141,133
12,67,147,20,13,7
12,67,1152,9,4,5
12,67,3245,162,94,68
12,67,381,85,49,36
12,67,3041,14,6,8
12,67,451,10,3,7
12,67,332,14,8,6
12,67,326,4,2,2
12,67,210,132,74,58
12,68,3106,16,9,7
12,68,1042,4,3,1
12,68,2396,24,12,12
12,68,344,3,0,3
12,68,1433,0,0,0
12,68,733,1,0,1
12,68,477,2,2,0
12,68,1677,10,3,7
12,68,311,3,2,1
12,68,324,0,0,0
12,68,1098,1,0,1
12,68,1111,28,10,18
12,68,1712,33,14,19
12,68,575,0,0,0
12,68,2069,172,84,88
12,68,1313,36,18,18
12,68,903,5,1,4
12,68,524,486,259,227
12,68,388,0,0,0
12,68,217,0,0,0
12,68,309,3,1,2
12,68,223,10,6,4
12,69,1962,138,54,84
12,69,913,51,20,31
12,69,1165,56,24,32
12,69,536,1,0,1
12,69,402,0,0,0
12,69,387,13,4,9
12,69,380,0,0,0
12,69,376,0,0,0
12,69,560,2,0,2
12,69,393,1,1,0
12,69,867,3,2,1
12,69,414,0,0,0
12,69,456,2,1,1
12,69,544,0,0,0
12,69,1570,13,6,7
12,69,254,4,3,1
12,69,610,0,0,0
12,69,885,0,0,0
12,69,1235,34,14,20
12,69,2290,46,20,26
12,69,2073,34,14,20
12,69,1328,164,83,81
12,69,316,3,1,2
12,69,245,0,0,0
12,69,349,5,2,3
12,69,471,5,2,3
12,69,666,1,0,1
12,69,197,0,0,0
12,69,580,1,1,0
12,69,920,8,3,5
12,69,223,5,3,2
12,69,331,16,8,8
12,69,2524,116,54,62
12,70,4473,36,18,18
12,70,179,15,11,4
12,70,548,0,0,0
12,70,450,6,1,5
12,70,733,7,2,5
12,70,1322,2,1,1
12,70,880,2,0,2
12,70,1016,36,25,11
12,70,1323,0,0,0
12,70,739,24,11,13
12,70,457,0,0,0
12,70,65,0,0,0
12,70,191,0,0,0
12,70,434,0,0,0
12,71,1506,14,9,5
12,71,1958,3,1,2
12,71,2112,63,28,35
12,71,937,16,9,7
12,71,483,2,0,2
12,71,502,38,17,21
12,71,143,9,6,3
12,71,208,1,1,0
12,72,3043,259,144,115
12,72,2681,167,95,72
12,72,391,0,0,0
12,72,1228,67,33,34
12,72,1180,86,60,26
12,72,674,105,54,51
12,72,742,22,9,13
12,72,1280,139,67,72
12,72,1402,152,77,75
12,72,1539,729,382,347
12,72,2644,1465,751,714
12,72,1249,447,215,232
12,72,1857,175,90,85
12,72,6117,346,178,168
12,72,3837,311,158,153
12,73,1119,80,42,38
12,73,2547,91,53,38
12,73,881,87,45,42
12,73,1599,29,14,15
12,73,1083,46,21,25
12,73,1178,10,6,4
12,73,1091,7,3,4
12,73,7448,63,32,31
12,76,323,0,0,0
12,73,705,0,0,0
12,76,1579,3,2,1
12,76,895,63,33,30
12,76,799,0,0,0
12,76,594,0,0,0
12,76,904,0,0,0
12,76,2345,17,8,9
12,76,222,7,2,5
12,76,744,0,0,0
12,76,893,3,1,2
12,76,1119,0,0,0
12,76,588,0,0,0
12,76,779,0,0,0
12,76,410,1,0,1
12,76,2409,0,0,0
12,76,2294,5,2,3
12,76,456,1,1,0
12,76,1547,7,4,3
12,12,442,0,0,0
12,76,1326,1,0,1
12,74,1519,6,4,2
12,74,2860,2,1,1
12,74,2037,2,1,1
12,74,315,0,0,0
12,74,348,4,3,1
12,74,796,0,0,0
12,74,2663,85,37,48
12,74,767,1,1,0
12,74,168,0,0,0
12,74,511,0,0,0
12,74,780,0,0,0
12,74,542,0,0,0
12,74,313,0,0,0
12,74,326,1,0,1
12,74,148,0,0,0
12,74,494,1,0,1
12,74,1669,2,2,0
12,74,366,0,0,0
12,74,398,0,0,0
12,74,486,0,0,0
12,74,231,0,0,0
12,74,296,0,0,0
12,75,2416,16,7,9
12,75,2279,9,7,2
12,75,2243,25,15,10
12,75,388,6,3,3
12,75,240,0,0,0
12,75,423,3,1,2
12,75,1259,32,17,15
12,75,233,2,1,1
12,75,893,5,3,2
12,75,264,9,5,4
12,75,639,6,2,4
12,75,1299,4,1,3
12,75,303,7,1,6
12,75,985,0,0,0
12,75,410,0,0,0
12,75,825,1,0,1
12,75,3143,103,55,48
12,75,497,1,0,1
12,75,2787,69,35,34
12,76,3805,127,65,62
12,76,1207,3,3,0
12,76,1429,7,5,2
12,76,2895,38,20,18
12,76,1735,27,12,15
12,76,985,3,1,2
12,77,1107,1,0,1
12,40,927,194,94,100
12,28,99,2,1,1
12,76,3637,3,3,0
12,78,1395,41,21,20
12,79,92,1,1,0
12,79,644,84,41,43
12,79,708,1,0,1
12,79,497,1,1,0
12,81,871,436,216,220
12,81,218,68,25,43
12,56,4052,7,2,5
12,56,2450,9,5,4
12,1,720,22,9,13
12,1,2893,101,48,53
13,1,1663,39,21,18
13,1,1650,6,2,4
13,1,278,1,1,0
13,1,405,2,0,2
13,1,952,3,2,1
13,1,1513,13,8,5
13,1,1482,1,1,0
13,1,2574,2,1,1
13,1,3966,15,7,8
13,1,3589,29,14,15
13,1,2928,32,15,17
13,1,640,2,1,1
13,2,2828,91,47,44
13,2,2266,158,90,68
13,2,799,2,1,1
13,2,963,68,36,32
13,2,2121,14,10,4
13,2,214,0,0,0
13,2,2271,12,5,7
13,2,1689,7,4,3
13,2,3650,14,9,5
13,2,1670,1,0,1
13,2,3275,2,2,0
13,2,3480,12,5,7
13,2,1747,4,1,3
13,2,269,0,0,0
13,2,4639,9,5,4
13,2,1469,2,1,1
13,2,2969,197,95,102
13,2,4428,20,12,8
13,2,1522,2,1,1
13,2,1832,74,41,33
13,2,2067,90,47,43
13,3,6848,90,53,37
13,3,3962,25,16,9
13,3,1692,1,1,0
13,3,2590,18,8,10
13,3,1528,41,24,17
13,3,1888,39,20,19
13,3,2054,1,0,1
13,3,3136,53,23,30
13,3,1763,2,1,1
13,3,1191,11,7,4
13,3,1465,10,2,8
13,3,1423,22,13,9
13,3,2095,25,13,12
13,3,1268,7,4,3
13,3,136,0,0,0
13,3,269,1,0,1
13,3,396,4,2,2
13,3,1564,11,8,3
13,3,1066,18,6,12
13,3,1801,13,7,6
13,3,1283,7,5,2
13,3,1279,2,2,0
13,3,718,0,0,0
13,3,663,3,2,1
13,3,1827,4,2,2
13,3,2668,3,1,2
13,3,878,4,3,1
13,3,2299,24,13,11
13,3,964,6,3,3
13,3,729,2,1,1
13,3,1677,1,1,0
13,3,2968,26,14,12
13,3,2077,6,4,2
13,3,1839,42,14,28
13,4,3749,68,40,28
13,4,176,0,0,0
13,4,242,2,1,1
13,4,579,2,2,0
13,4,456,5,4,1
13,4,502,1,0,1
13,4,400,29,14,15
13,4,336,0,0,0
13,4,929,0,0,0
13,4,1417,20,8,12
13,4,1628,109,56,53
13,4,601,0,0,0
13,5,2265,12,7,5
13,5,1691,3,2,1
13,5,2289,2,0,2
13,5,1828,3,1,2
13,5,1844,26,14,12
13,5,2649,41,24,17
13,5,308,0,0,0
13,5,3541,129,61,68
13,5,1449,14,6,8
13,5,637,2,1,1
13,5,537,0,0,0
13,6,3025,41,19,22
13,6,1242,5,3,2
13,6,1085,0,0,0
13,6,456,0,0,0
13,6,516,4,2,2
13,6,829,1,1,0
13,6,162,1,0,1
13,6,1324,34,18,16
13,6,1471,2,1,1
13,6,1981,24,16,8
13,6,409,9,5,4
13,6,1048,70,37,33
13,6,1118,21,10,11
13,6,420,0,0,0
13,6,1011,5,3,2
13,6,766,2,0,2
13,6,456,0,0,0
13,6,363,1,0,1
13,6,227,0,0,0
13,6,1057,0,0,0
13,6,141,0,0,0
13,6,436,1,1,0
13,7,2591,43,19,24
13,7,2640,28,16,12
13,7,272,0,0,0
13,7,546,0,0,0
13,7,320,2,1,1
13,7,712,2,0,2
13,7,209,0,0,0
13,7,869,0,0,0
13,7,1029,1,0,1
13,7,613,2,1,1
13,7,936,1,0,1
13,7,575,11,8,3
13,7,262,3,1,2
13,8,8781,61,36,25
13,8,2149,14,7,7
13,8,3515,64,31,33
13,8,2132,35,17,18
13,8,1197,79,39,40
13,8,913,14,7,7
13,8,987,8,5,3
13,8,1959,26,13,13
13,8,4177,21,11,10
13,8,1540,43,24,19
13,8,2514,13,9,4
13,8,2356,16,6,10
13,8,766,3,1,2
13,8,318,0,0,0
13,8,376,1,0,1
13,8,771,1,0,1
13,8,2736,11,8,3
13,8,927,1,1,0
13,8,1119,6,3,3
13,8,2178,33,17,16
13,8,1407,27,9,18
13,8,2267,23,10,13
13,8,512,16,9,7
13,8,815,1,1,0
13,8,1239,18,9,9
13,9,3176,92,53,39
13,9,4610,52,27,25
13,9,2813,12,5,7
13,9,2779,87,42,45
13,9,3687,5,2,3
13,9,5017,169,80,89
13,9,3027,18,9,9
13,9,963,9,3,6
13,9,1025,19,9,10
13,9,4913,32,14,18
13,10,3295,20,12,8
13,10,1326,2,1,1
13,10,861,0,0,0
13,10,1729,2,0,2
13,10,1077,12,5,7
13,10,163,0,0,0
13,10,926,7,3,4
13,10,738,1,1,0
13,10,1113,0,0,0
13,10,1765,31,12,19
13,10,542,3,2,1
13,10,639,1,0,1
13,10,1257,3,1,2
13,10,1293,426,218,208
13,10,899,73,37,36
13,10,1257,4,2,2
13,11,4527,28,17,11
13,11,1394,38,17,21
13,11,1966,15,10,5
13,11,1843,11,5,6
13,11,271,0,0,0
13,11,211,0,0,0
13,11,957,4,2,2
13,11,144,9,6,3
13,11,449,0,0,0
13,11,1383,16,10,6
13,11,487,15,7,8
13,11,216,8,6,2
13,11,692,8,6,2
13,11,1512,2,1,1
13,11,734,7,4,3
13,11,1240,1,0,1
13,11,595,1,0,1
13,11,934,5,2,3
13,11,789,0,0,0
13,11,1417,1,1,0
13,11,205,0,0,0
13,11,664,2,1,1
13,11,1702,1,0,1
13,11,1735,82,42,40
13,11,925,1,1,0
13,11,1146,4,4,0
13,11,2187,4,1,3
13,11,291,2,2,0
13,12,2769,21,8,13
13,12,1684,166,78,88
13,12,2708,237,122,115
13,12,3017,22,10,12
13,12,911,5,2,3
13,12,1826,14,9,5
13,12,1503,48,28,20
13,12,1419,2,1,1
13,12,1711,100,51,49
13,12,2504,7,6,1
13,12,5262,58,28,30
13,12,764,11,6,5
13,12,225,0,0,0
13,12,426,0,0,0
13,12,5981,129,74,55
13,12,25343,811,421,390
13,12,1545,81,44,37
13,12,1512,12,4,8
13,13,2809,3,0,3
13,13,1745,11,4,7
13,13,647,4,3,1
13,13,597,0,0,0
13,13,1727,30,15,15
13,13,710,0,0,0
13,13,862,1,0,1
13,13,453,1,1,0
13,13,2541,13,11,2
13,13,639,0,0,0
13,13,727,1,1,0
13,13,635,18,10,8
13,13,1157,3,2,1
13,13,337,1,0,1
13,13,562,0,0,0
13,14,1232,8,4,4
13,14,1340,6,2,4
13,14,354,7,2,5
13,14,702,55,26,29
13,14,333,0,0,0
13,14,1432,51,28,23
13,14,1762,13,4,9
13,14,856,113,56,57
13,14,762,0,0,0
13,14,1457,70,46,24
13,14,3636,18,9,9
13,14,300,0,0,0
13,14,1538,17,9,8
13,14,752,17,9,8
13,14,281,1,0,1
13,14,1842,13,7,6
13,14,1220,4,3,1
13,15,4907,10,1,9
13,15,3593,2,1,1
13,15,1651,9,6,3
13,15,1033,10,5,5
13,15,1736,19,13,6
13,15,3148,6,1,5
13,15,465,0,0,0
13,15,7662,10,5,5
13,15,3051,7,4,3
13,15,1625,0,0,0
13,15,880,0,0,0
13,15,659,2,1,1
13,15,4511,7,4,3
13,15,1987,7,5,2
13,15,5412,11,8,3
13,15,1117,2,1,1
13,15,4864,8,3,5
13,15,3753,12,6,6
13,15,913,9,2,7
13,15,907,3,2,1
13,15,858,1,0,1
13,15,735,0,0,0
13,15,818,0,0,0
13,15,704,3,2,1
13,16,1543,13,5,8
13,16,1826,34,10,24
13,16,829,14,3,11
13,16,732,0,0,0
13,16,1709,23,12,11
13,16,1712,29,12,17
13,16,675,2,1,1
13,16,1663,6,2,4
13,16,1590,6,3,3
13,16,911,1,0,1
13,17,2534,19,8,11
13,17,2153,9,6,3
13,17,620,0,0,0
13,17,828,2,1,1
13,17,498,5,1,4
13,17,803,4,1,3
13,17,1087,16,9,7
13,17,968,1,1,0
13,17,256,0,0,0
13,17,457,1,0,1
13,17,699,1,1,0
13,17,714,3,2,1
13,17,280,0,0,0
13,17,892,1,0,1
13,17,835,3,1,2
13,17,309,0,0,0
13,17,860,0,0,0
13,17,830,2,2,0
13,17,1927,24,8,16
13,17,998,6,3,3
13,17,1020,0,0,0
13,17,1294,0,0,0
13,17,309,0,0,0
13,17,459,0,0,0
13,17,1231,2,2,0
13,18,2841,21,11,10
13,18,932,8,3,5
13,18,908,1,1,0
13,18,769,110,62,48
13,18,708,11,5,6
13,18,1128,3,1,2
13,18,1270,5,2,3
13,18,1828,630,334,296
13,18,1207,1,1,0
13,18,436,9,5,4
13,18,270,2,2,0
13,18,1808,13,7,6
13,18,1855,9,5,4
13,18,2516,1,1,0
13,18,227,0,0,0
13,19,3699,12,7,5
13,19,1755,4,4,0
13,19,993,1,0,1
13,19,561,1,0,1
13,19,1176,4,4,0
13,19,2865,11,5,6
13,19,484,0,0,0
13,19,1104,17,8,9
13,19,869,2,0,2
13,19,4798,34,20,14
13,19,1696,12,5,7
13,20,689,8,4,4
13,20,147,5,4,1
13,20,1008,1,0,1
13,20,194,9,6,3
13,20,104,0,0,0
13,20,238,2,2,0
13,20,163,0,0,0
13,21,1114,25,11,14
13,21,2500,101,53,48
13,21,2324,117,57,60
13,21,1767,19,11,8
13,21,2085,49,27,22
13,21,1781,23,13,10
13,21,1621,2,2,0
13,21,1992,19,8,11
13,22,1806,396,216,180
13,22,1712,54,27,27
13,22,1166,5,3,2
13,22,1013,12,5,7
13,22,718,2,1,1
13,22,2654,28,16,12
13,22,792,45,28,17
13,22,388,1,1,0
13,22,147,1,1,0
13,22,3566,83,45,38
13,22,2160,25,13,12
13,23,3208,19,8,11
13,23,1623,32,12,20
13,23,2985,17,8,9
13,23,1196,5,2,3
13,23,1901,14,5,9
13,23,2405,4,2,2
13,23,2034,20,9,11
13,23,920,15,9,6
13,23,1009,0,0,0
13,23,2214,8,3,5
13,23,2877,8,6,2
13,23,1454,2,2,0
13,23,1907,2,2,0
13,23,2046,23,12,11
13,23,3245,18,8,10
13,23,3035,80,39,41
13,23,3035,60,28,32
13,24,1005,3,1,2
13,24,1368,0,0,0
13,24,274,0,0,0
13,24,339,4,3,1
13,24,231,4,2,2
13,24,531,0,0,0
13,24,1182,3,1,2
13,24,450,2,1,1
13,24,462,1,0,1
13,24,725,2,1,1
13,24,1343,0,0,0
13,24,1250,3,3,0
13,24,1059,7,4,3
13,24,2134,11,4,7
13,24,2034,14,9,5
13,24,464,0,0,0
13,24,747,0,0,0
13,24,1465,11,4,7
13,24,347,8,3,5
13,25,2236,7,4,3
13,25,1618,9,5,4
13,25,414,2,0,2
13,25,549,0,0,0
13,25,625,5,3,2
13,25,344,0,0,0
13,25,552,1,0,1
13,25,469,11,5,6
13,25,808,2,1,1
13,25,696,8,6,2
13,25,711,0,0,0
13,25,656,1,1,0
13,25,1855,4,1,3
13,25,297,0,0,0
13,25,1459,0,0,0
13,25,312,0,0,0
13,25,363,0,0,0
13,25,1245,0,0,0
13,25,242,0,0,0
13,25,568,0,0,0
13,25,799,0,0,0
13,25,593,0,0,0
13,25,283,1,1,0
13,25,799,0,0,0
13,25,1335,71,43,28
13,25,592,2,1,1
13,26,1619,67,35,32
13,26,1047,0,0,0
13,26,1855,6,2,4
13,26,3048,1082,556,526
13,26,1756,3,2,1
13,26,474,0,0,0
13,26,942,0,0,0
13,26,932,3,2,1
13,26,722,0,0,0
13,26,894,0,0,0
13,27,4177,4,3,1
13,27,414,0,0,0
13,27,501,0,0,0
13,27,1614,3,1,2
13,27,241,0,0,0
13,27,771,0,0,0
13,27,2488,0,0,0
13,27,992,10,4,6
13,27,1195,1,1,0
13,27,824,1,1,0
13,27,2153,7,3,4
13,27,1505,0,0,0
13,27,1695,3,2,1
13,27,1754,11,7,4
13,27,1161,718,380,338
13,27,1254,84,42,42
13,28,5383,251,126,125
13,28,1500,121,66,55
13,28,5237,60,27,33
13,28,6941,59,20,39
13,28,1357,5,2,3
13,28,679,9,6,3
13,28,1542,4,2,2
13,28,4242,483,252,231
13,28,375,6,4,2
13,28,943,1,0,1
13,28,5054,19,11,8
13,28,3078,23,12,11
13,28,2413,4,3,1
13,28,6316,744,391,353
13,28,1951,9,6,3
13,28,1047,38,21,17
13,28,2399,38,20,18
13,28,778,0,0,0
13,28,634,0,0,0
13,28,494,26,12,14
13,28,3819,62,35,27
13,28,2110,12,4,8
13,28,1468,1,0,1
13,28,2008,5,3,2
13,28,1264,0,0,0
13,28,3686,102,55,47
13,28,5097,9,3,6
13,28,2472,17,7,10
13,28,1903,4,2,2
13,28,3027,2,1,1
13,28,2644,13,8,5
13,28,1679,5,2,3
13,28,1151,9,3,6
13,28,1600,9,7,2
13,28,1555,4,3,1
13,28,1542,5,2,3
13,28,1250,2,0,2
13,28,1454,2,1,1
13,28,4289,11,7,4
13,28,1787,25,12,13
13,28,1258,3,1,2
13,28,148,0,0,0
13,28,2954,3,3,0
13,28,2745,0,0,0
13,28,2410,2,1,1
13,28,3474,1,0,1
13,28,2430,10,4,6
13,28,3353,3,2,1
13,28,1843,5,3,2
13,28,1364,0,0,0
13,28,2355,4,1,3
13,28,3299,11,6,5
13,28,805,2,1,1
13,29,1940,11,9,2
13,29,2548,4,1,3
13,29,2393,8,2,6
13,29,3061,27,17,10
13,29,521,1,1,0
13,29,234,0,0,0
13,29,469,0,0,0
13,29,1203,1,0,1
13,29,1675,1,1,0
13,29,989,7,4,3
13,29,2102,63,31,32
13,29,829,1,0,1
13,29,1018,1,1,0
13,29,2451,43,20,23
13,29,551,2,1,1
13,29,854,0,0,0
13,29,284,0,0,0
13,29,1123,8,4,4
13,29,1393,2,2,0
13,29,168,0,0,0
13,29,1038,0,0,0
13,29,2626,52,26,26
13,29,582,8,3,5
13,29,1096,12,6,6
13,29,2518,6,4,2
13,29,1276,15,8,7
13,29,804,6,2,4
13,29,1638,3,0,3
13,29,575,3,1,2
13,29,1264,0,0,0
13,29,2225,11,8,3
13,29,389,0,0,0
13,29,447,0,0,0
13,29,1005,5,1,4
13,29,2260,13,8,5
13,29,1040,9,3,6
13,29,531,0,0,0
13,30,1361,0,0,0
13,30,2627,12,7,5
13,30,1175,6,4,2
13,30,2783,18,8,10
13,30,3085,22,9,13
13,30,1601,32,16,16
13,30,5792,55,26,29
13,30,2061,5,1,4
13,30,2168,39,21,18
13,30,1470,35,18,17
13,30,4459,168,88,80
13,30,1835,77,39,38
13,30,1414,11,5,6
13,30,1799,16,8,8
13,30,2055,4,3,1
13,30,1921,45,25,20
13,30,2424,39,21,18
13,30,233,0,0,0
13,30,413,1,1,0
13,30,386,1,0,1
13,30,228,0,0,0
13,30,1033,9,3,6
13,30,1016,4,1,3
13,30,294,0,0,0
13,30,278,2,2,0
13,30,342,3,1,2
13,30,133,0,0,0
13,30,743,2,1,1
13,30,2279,30,16,14
13,30,520,0,0,0
13,30,1634,24,10,14
13,30,476,4,3,1
13,30,1227,3,1,2
13,30,1661,1,1,0
13,30,2231,5,3,2
13,30,920,3,2,1
13,30,513,1,1,0
13,30,492,1,1,0
13,30,108,0,0,0
13,30,1380,1,0,1
13,30,1230,2,2,0
13,30,961,6,3,3
13,30,632,3,1,2
13,30,1936,27,16,11
13,30,1592,5,2,3
13,30,608,3,2,1
13,30,4928,61,33,28
13,30,3328,59,32,27
13,30,4467,61,34,27
13,30,2355,12,6,6
13,30,3264,10,4,6
13,30,1345,30,16,14
13,30,642,15,9,6
13,30,1610,63,34,29
13,30,3637,268,139,129
13,30,1005,9,4,5
13,30,1871,4,3,1
13,30,141,2,1,1
13,30,536,0,0,0
13,30,1247,4,3,1
13,30,2023,8,3,5
13,31,2853,27,9,18
13,31,1952,2,0,2
13,31,570,6,3,3
13,31,422,0,0,0
13,31,455,15,6,9
13,31,740,1,0,1
13,31,866,8,6,2
13,31,206,0,0,0
13,31,202,0,0,0
13,31,101,0,0,0
13,31,358,0,0,0
13,31,768,1,0,1
13,31,454,4,3,1
13,31,378,2,2,0
13,31,156,0,0,0
13,31,192,0,0,0
13,31,601,7,3,4
13,31,346,1,1,0
13,31,396,0,0,0
13,32,969,6,5,1
13,32,2592,32,16,16
13,32,2484,10,6,4
13,32,812,0,0,0
13,32,971,11,7,4
13,32,263,0,0,0
13,32,237,6,1,5
13,32,184,0,0,0
13,32,254,2,2,0
13,32,515,5,3,2
13,32,845,1,0,1
13,32,588,1,0,1
13,33,596,9,3,6
13,33,439,0,0,0
13,33,864,118,61,57
13,33,992,20,9,11
13,34,1073,1,1,0
13,34,1088,0,0,0
13,34,826,1,0,1
13,34,810,1,1,0
13,34,1358,0,0,0
13,34,832,8,4,4
13,34,502,0,0,0
13,34,628,0,0,0
13,34,824,2,1,1
13,34,1466,1,0,1
13,34,504,0,0,0
13,35,756,0,0,0
13,35,525,0,0,0
13,35,901,3,0,3
13,35,1507,6,2,4
13,35,1497,3,1,2
13,35,947,3,1,2
13,35,1367,12,5,7
13,35,1049,6,3,3
13,36,3630,20,8,12
13,36,432,4,2,2
13,36,1194,614,323,291
13,36,3024,182,97,85
13,36,563,1,0,1
13,36,942,2,1,1
13,36,1447,3,1,2
13,36,314,0,0,0
13,36,1066,0,0,0
13,37,1663,4,2,2
13,37,2095,16,9,7
13,37,713,7,3,4
13,37,430,0,0,0
13,37,1266,2,2,0
13,37,708,0,0,0
13,37,1449,0,0,0
13,37,1704,11,7,4
13,37,113,0,0,0
13,37,227,0,0,0
13,37,946,6,3,3
13,37,434,0,0,0
13,37,885,7,4,3
13,37,672,1,0,1
13,37,707,30,12,18
13,37,945,2,2,0
13,37,222,9,6,3
13,37,796,29,14,15
13,37,578,0,0,0
13,37,459,3,1,2
13,37,823,12,7,5
13,37,1142,4,2,2
13,37,249,0,0,0
13,37,1243,19,9,10
13,37,449,8,3,5
13,37,447,0,0,0
13,38,894,24,8,16
13,38,442,3,2,1
13,38,139,0,0,0
13,38,1905,28,13,15
13,38,131,0,0,0
13,38,328,5,2,3
13,38,663,1,0,1
13,38,236,1,1,0
13,38,1554,27,12,15
13,38,354,3,2,1
13,38,1855,25,13,12
13,39,1373,6,1,5
13,39,1240,2,0,2
13,39,1687,33,19,14
13,39,1141,9,4,5
13,39,829,5,3,2
13,39,1734,2,0,2
13,39,1480,19,11,8
13,39,1847,54,32,22
13,39,984,4,2,2
13,39,347,17,9,8
13,39,1477,30,14,16
13,39,144,0,0,0
13,40,5160,71,30,41
13,40,6175,104,58,46
13,40,3692,29,14,15
13,40,3227,26,14,12
13,40,6220,126,65,61
13,40,18510,426,222,204
13,40,1444,6,4,2
13,40,704,0,0,0
13,40,9002,455,263,192
13,40,848,1,1,0
13,40,1010,9,7,2
13,40,19084,178,77,101
13,40,1355,15,5,10
13,40,44846,1310,677,633
13,40,6917,153,73,80
13,47,1064,101,55,46
13,41,2377,88,49,39
13,41,1573,22,12,10
13,41,2290,85,39,46
13,41,2439,25,13,12
13,41,2129,13,5,8
13,41,3181,17,9,8
13,41,1566,23,12,11
13,41,3348,26,13,13
13,41,4481,32,18,14
13,41,2259,5,3,2
13,41,1887,8,4,4
13,41,875,5,4,1
13,41,1962,4,2,2
13,41,2436,9,5,4
13,41,1965,7,4,3
13,41,2266,1,0,1
13,41,2325,13,9,4
13,41,962,6,3,3
13,41,3480,38,23,15
13,41,1106,13,7,6
13,41,1347,1,0,1
13,41,807,2,0,2
13,42,2595,10,6,4
13,42,2913,4,1,3
13,42,457,1,0,1
13,42,507,0,0,0
13,42,681,0,0,0
13,42,190,0,0,0
13,42,634,9,2,7
13,42,733,0,0,0
13,42,647,1,0,1
13,42,212,0,0,0
13,42,410,1,0,1
13,42,219,0,0,0
13,42,271,0,0,0
13,42,327,0,0,0
13,42,774,0,0,0
13,43,1076,2,1,1
13,43,292,259,136,123
13,43,289,1,1,0
13,43,119,8,3,5
13,43,290,197,99,98
13,43,200,2,1,1
13,43,192,69,36,33
13,43,508,10,5,5
13,43,311,0,0,0
13,43,366,3,2,1
13,43,375,5,3,2
13,43,185,0,0,0
13,43,444,1,1,0
13,43,279,59,36,23
13,43,242,0,0,0
13,43,218,2,0,2
13,43,556,1,0,1
13,43,55,6,3,3
13,43,327,2,2,0
13,44,3732,9,2,7
13,44,2478,1,0,1
13,44,2459,12,9,3
13,44,974,1,1,0
13,44,1268,8,5,3
13,44,2349,710,377,333
13,44,611,78,40,38
13,44,500,2,1,1
13,44,1276,1,1,0
13,44,1188,1,1,0
13,45,2160,6,3,3
13,45,1480,6,3,3
13,45,579,2,2,0
13,45,867,1,1,0
13,45,548,1,0,1
13,45,732,0,0,0
13,45,1260,1,1,0
13,45,673,0,0,0
13,45,515,2,1,1
13,45,292,0,0,0
13,46,594,2,2,0
13,46,544,0,0,0
13,46,1106,4,3,1
13,46,381,0,0,0
13,46,342,0,0,0
13,46,252,0,0,0
13,46,458,0,0,0
13,46,488,0,0,0
13,46,201,0,0,0
13,46,361,1,0,1
13,47,1202,10,5,5
13,47,958,10,6,4
13,47,508,1,0,1
13,47,806,5,3,2
13,47,770,3,1,2
13,47,1271,2,1,1
13,47,442,15,10,5
13,47,682,6,2,4
13,47,1192,4,2,2
13,47,625,10,4,6
13,47,683,10,5,5
13,47,853,21,9,12
13,47,1205,1,1,0
13,47,537,3,1,2
13,47,860,12,7,5
13,47,951,20,7,13
13,47,1703,16,9,7
13,47,502,0,0,0
13,47,1644,10,3,7
13,47,1639,37,19,18
13,47,21121,250,123,127
13,47,2289,157,96,61
13,47,1695,31,15,16
13,47,1408,36,23,13
13,47,1428,22,8,14
13,47,1187,6,3,3
13,47,549,1,1,0
13,47,620,9,5,4
13,47,700,21,11,10
13,47,407,30,17,13
13,47,501,18,12,6
13,47,1823,41,20,21
13,47,1193,7,6,1
13,47,1865,33,18,15
13,47,1849,16,8,8
13,47,1030,22,13,9
13,47,1574,38,19,19
13,47,515,23,14,9
13,47,696,29,16,13
13,47,770,11,7,4
13,47,452,18,8,10
13,47,973,14,6,8
13,47,674,14,8,6
13,47,832,8,5,3
13,47,1501,36,18,18
13,47,1409,29,12,17
13,47,2568,18,10,8
13,47,5632,19,9,10
13,47,12825,190,93,97
13,47,1573,3,1,2
13,47,1188,7,2,5
13,47,995,66,27,39
13,47,799,16,7,9
13,47,1121,55,29,26
13,47,904,1,1,0
13,47,1169,99,56,43
13,47,975,4,0,4
13,47,696,9,4,5
13,47,815,64,34,30
13,47,993,14,7,7
13,47,398,2,2,0
13,47,276,9,6,3
13,47,671,16,9,7
13,47,804,17,9,8
13,47,859,32,22,10
13,47,1613,35,20,15
13,47,1787,32,17,15
13,47,1413,28,15,13
13,47,2445,35,19,16
13,47,859,6,2,4
13,47,1133,21,16,5
13,47,820,53,34,19
13,47,938,19,11,8
13,47,589,6,5,1
13,47,425,2,2,0
13,47,581,10,5,5
13,47,630,12,5,7
13,47,1113,13,7,6
13,47,1445,14,8,6
13,47,2220,4,1,3
13,47,1994,7,5,2
13,47,2359,9,1,8
13,47,2521,117,58,59
13,47,1834,30,19,11
13,47,2160,67,44,23
13,47,18618,411,217,194
13,47,3164,91,52,39
13,47,2354,8,5,3
13,47,1050,2,2,0
13,47,1141,13,8,5
13,47,2010,14,4,10
13,47,1646,17,9,8
13,47,920,65,35,30
13,47,957,81,48,33
13,47,564,16,8,8
13,47,598,2,2,0
13,47,1396,7,5,2
13,40,1152,9,4,5
13,47,2833,19,11,8
13,47,1964,38,19,19
13,47,3763,349,193,156
13,47,3858,98,51,47
13,47,11444,163,87,76
13,47,6374,202,109,93
13,47,1049,26,11,15
13,40,745,4,2,2
13,40,870,23,11,12
13,47,3894,152,75,77
13,47,4925,34,17,17
13,47,943,3,1,2
13,47,816,58,28,30
13,47,1250,7,4,3
13,47,3137,8,4,4
13,47,794,17,8,9
13,47,1098,37,20,17
13,47,925,35,23,12
13,47,4476,26,14,12
13,47,1284,6,1,5
13,47,1265,23,11,12
13,47,4100,104,60,44
13,47,5134,177,84,93
13,47,2449,41,17,24
13,47,12067,388,176,212
13,47,6398,66,33,33
13,47,4642,27,15,12
13,47,11477,189,86,103
13,47,10863,223,123,100
13,47,8196,51,23,28
13,47,22315,393,192,201
13,47,2010,33,18,15
13,48,3642,12,4,8
13,48,1001,0,0,0
13,48,537,0,0,0
13,48,449,0,0,0
13,48,949,0,0,0
13,48,1963,1,0,1
13,48,187,0,0,0
13,48,426,0,0,0
13,48,1597,4,3,1
13,48,823,0,0,0
13,48,2475,5,4,1
13,48,526,1,1,0
13,48,722,0,0,0
13,48,328,1,0,1
13,48,671,0,0,0
13,48,357,0,0,0
13,48,865,1,0,1
13,48,352,0,0,0
13,48,285,0,0,0
13,48,544,0,0,0
13,49,2111,23,16,7
13,49,3016,38,23,15
13,49,1624,9,7,2
13,49,1129,1,1,0
13,49,2118,8,4,4
13,49,2675,159,83,76
13,49,3258,130,64,66
13,49,776,34,16,18
13,49,1209,10,3,7
13,49,4290,12,3,9
13,49,1583,5,1,4
13,49,811,1,0,1
13,50,2765,29,14,15
13,50,315,0,0,0
13,50,1493,8,3,5
13,50,803,3,1,2
13,50,193,0,0,0
13,50,670,1,1,0
13,50,619,1,1,0
13,50,728,25,13,12
13,50,677,0,0,0
13,50,105,1,1,0
13,50,335,4,3,1
13,50,453,1,0,1
13,50,253,1,0,1
13,50,134,0,0,0
13,51,3450,37,14,23
13,51,2351,15,9,6
13,51,3628,43,21,22
13,51,3476,34,19,15
13,51,798,3,2,1
13,51,2515,101,57,44
13,51,2382,4,2,2
13,51,4602,61,24,37
13,51,3954,169,74,95
13,51,1453,19,11,8
13,51,402,1,1,0
13,51,544,0,0,0
13,51,1581,5,3,2
13,51,2027,11,3,8
13,51,897,0,0,0
13,51,1329,39,18,21
13,51,2194,0,0,0
13,51,1171,10,5,5
13,52,2287,7,4,3
13,52,4120,20,8,12
13,52,492,1,0,1
13,52,472,1,0,1
13,52,1188,1,0,1
13,52,1507,2,2,0
13,52,896,4,3,1
13,52,489,2,2,0
13,52,659,2,1,1
13,52,382,0,0,0
13,52,1268,5,0,5
13,52,925,0,0,0
13,52,511,2,1,1
13,52,1676,9,6,3
13,52,318,0,0,0
13,52,276,0,0,0
13,52,315,0,0,0
13,53,1673,9,5,4
13,53,3739,23,9,14
13,53,3101,43,19,24
13,53,1347,2,1,1
13,53,670,1,0,1
13,53,1818,4,1,3
13,53,799,0,0,0
13,53,919,3,2,1
13,53,1064,1,1,0
13,53,661,0,0,0
13,53,991,16,10,6
13,53,368,1,0,1
13,53,2072,1,0,1
13,53,1319,6,3,3
13,53,1722,6,3,3
13,53,855,4,1,3
13,53,1695,44,20,24
13,53,2321,20,12,8
13,53,4112,7,4,3
13,53,3376,0,0,0
13,53,1709,2,1,1
13,53,689,1,1,0
13,53,574,0,0,0
13,53,1104,0,0,0
13,54,2558,17,9,8
13,54,2151,22,13,9
13,54,829,0,0,0
13,54,2423,14,11,3
13,54,788,0,0,0
13,54,1550,12,5,7
13,54,1231,0,0,0
13,54,1995,3,1,2
13,54,251,0,0,0
13,54,755,7,2,5
13,54,1026,7,3,4
13,54,1344,3,2,1
13,54,3009,56,26,30
13,54,863,2,1,1
13,54,2326,34,16,18
13,54,619,2,1,1
13,54,315,0,0,0
13,54,876,1,1,0
13,54,3211,8,4,4
13,54,2490,6,3,3
13,54,1754,8,4,4
13,54,1302,0,0,0
13,54,1159,2,1,1
13,54,2282,1,0,1
13,55,2669,30,16,14
13,55,244,0,0,0
13,55,123,1,0,1
13,55,180,3,1,2
13,55,216,0,0,0
13,55,897,6,4,2
13,55,950,15,5,10
13,55,490,9,7,2
13,55,3085,9,2,7
13,55,2053,12,5,7
13,55,655,149,81,68
13,55,584,1,1,0
13,55,449,0,0,0
13,55,433,0,0,0
13,55,841,3,2,1
13,55,534,1,0,1
13,55,1070,1,1,0
13,55,1156,29,17,12
13,55,1282,37,21,16
13,56,4975,14,8,6
13,56,2051,9,3,6
13,56,2832,8,6,2
13,56,2848,5,4,1
13,56,7052,39,25,14
13,56,382,0,0,0
13,56,11065,96,55,41
13,56,3100,5,3,2
13,56,3052,13,8,5
13,56,466,2,1,1
13,56,1002,2,2,0
13,57,4275,44,23,21
13,57,1880,12,7,5
13,57,1526,14,8,6
13,57,1243,3,2,1
13,57,1982,11,5,6
13,57,1264,11,5,6
13,57,530,7,2,5
13,57,589,5,4,1
13,57,824,0,0,0
13,57,684,0,0,0
13,57,606,2,2,0
13,58,790,5,4,1
13,58,1951,8,4,4
13,58,2607,57,35,22
13,58,357,4,2,2
13,58,50,0,0,0
13,58,1058,0,0,0
13,58,806,18,8,10
13,58,412,3,2,1
13,58,108,1,1,0
13,58,251,0,0,0
13,58,607,6,3,3
13,58,343,5,2,3
13,58,566,0,0,0
13,58,231,0,0,0
13,58,939,4,4,0
13,58,1118,16,7,9
13,58,663,0,0,0
13,58,933,0,0,0
13,58,1325,0,0,0
13,58,1834,12,6,6
13,59,3949,54,30,24
13,59,3722,72,36,36
13,59,974,4,1,3
13,59,956,4,3,1
13,59,928,2,0,2
13,59,2080,12,4,8
13,59,1341,0,0,0
13,59,3862,4,3,1
13,59,557,0,0,0
13,59,2057,3,1,2
13,59,3095,17,8,9
13,59,2206,15,8,7
13,59,547,3,1,2
13,59,841,0,0,0
13,59,405,0,0,0
13,59,326,0,0,0
13,59,574,2,0,2
13,59,298,1,0,1
13,59,1576,356,186,170
13,59,1682,28,13,15
13,59,309,0,0,0
13,59,1650,36,23,13
13,59,3100,68,34,34
13,59,916,9,5,4
13,59,291,0,0,0
13,60,1896,135,73,62
13,60,3297,15,8,7
13,60,490,1,0,1
13,60,2444,5,2,3
13,60,860,2,2,0
13,60,658,17,10,7
13,60,1233,5,3,2
13,60,471,3,1,2
13,60,804,1,1,0
13,60,704,18,8,10
13,60,682,5,2,3
13,60,1322,72,37,35
13,60,1381,2,2,0
13,60,1433,1,1,0
13,61,2754,12,8,4
13,61,2639,27,17,10
13,61,1729,3,1,2
13,61,850,59,33,26
13,61,1067,3,1,2
13,61,1340,15,6,9
13,61,2645,48,21,27
13,61,1156,4,3,1
13,61,2602,26,16,10
13,61,212,8,7,1
13,61,442,10,2,8
13,61,935,3,2,1
13,61,138,0,0,0
13,61,656,0,0,0
13,61,1080,2,0,2
13,61,755,0,0,0
13,61,803,11,7,4
13,61,1860,19,7,12
13,61,1683,6,3,3
13,61,1400,14,8,6
13,61,840,13,11,2
13,61,1241,7,4,3
13,61,1111,18,9,9
13,61,1600,6,1,5
13,61,1218,2,2,0
13,61,740,12,6,6
13,61,1040,5,3,2
13,61,816,13,8,5
13,61,1539,6,3,3
13,61,1325,0,0,0
13,61,1091,4,3,1
13,61,3071,28,13,15
13,61,972,3,2,1
13,61,7229,67,31,36
13,61,1503,6,1,5
13,61,1322,17,11,6
13,61,1111,0,0,0
13,61,1879,146,74,72
13,62,1474,3,1,2
13,62,1600,8,4,4
13,62,215,0,0,0
13,62,1696,3,1,2
13,62,790,1,1,0
13,62,571,0,0,0
13,62,1141,6,3,3
13,62,1926,1,1,0
13,62,2151,1,0,1
13,62,311,0,0,0
13,62,168,20,12,8
13,62,2241,9,3,6
13,62,604,14,8,6
13,62,1016,1,0,1
13,62,1729,3,2,1
13,62,810,0,0,0
13,62,1318,1,0,1
13,62,1492,1,1,0
13,62,506,0,0,0
13,62,702,0,0,0
13,62,2006,9,3,6
13,62,677,0,0,0
13,62,568,2,1,1
13,62,454,5,2,3
13,62,851,1,0,1
13,62,1121,1,1,0
13,62,339,0,0,0
13,62,899,1,0,1
13,62,349,0,0,0
13,62,804,1,0,1
13,62,627,2,1,1
13,62,1065,1,0,1
13,62,518,0,0,0
13,63,1583,24,12,12
13,63,3224,12,6,6
13,63,4872,48,23,25
13,63,1111,14,9,5
13,63,2539,92,54,38
13,63,2363,48,25,23
13,63,991,15,5,10
13,63,2190,27,13,14
13,63,7135,29,12,17
13,63,1823,40,26,14
13,63,5225,49,27,22
13,63,1236,6,1,5
13,63,2425,7,3,4
13,63,2314,65,34,31
13,63,2206,13,7,6
13,63,1395,35,19,16
13,63,3941,50,20,30
13,63,2366,22,10,12
13,63,2175,14,8,6
13,63,3280,20,9,11
13,63,2567,3,3,0
13,63,2358,124,61,63
13,63,4177,144,66,78
13,63,1385,4,2,2
13,63,1741,150,74,76
13,63,6662,81,43,38
13,63,2771,40,20,20
13,63,1714,5,3,2
13,63,2065,43,27,16
13,63,2640,20,12,8
13,63,2280,7,3,4
13,63,4319,19,10,9
13,63,2846,53,32,21
13,64,2644,11,4,7
13,64,1093,1,0,1
13,64,251,0,0,0
13,64,297,1,0,1
13,64,1615,12,7,5
13,64,1257,0,0,0
13,64,1929,13,9,4
13,64,1834,0,0,0
13,65,2403,17,10,7
13,65,1406,60,27,33
13,65,1312,526,287,239
13,65,3423,359,183,176
13,65,677,1,0,1
13,65,991,13,8,5
13,65,1749,40,18,22
13,66,5256,47,19,28
13,66,2803,10,8,2
13,66,1448,7,4,3
13,66,1697,3,1,2
13,66,3259,21,6,15
13,66,1536,22,14,8
13,66,3525,4,2,2
13,66,4227,12,6,6
13,66,2904,7,3,4
13,66,4142,3,2,1
13,66,1689,1,0,1
13,66,1334,9,4,5
13,66,1706,16,9,7
13,66,1129,1,0,1
13,66,1829,6,3,3
13,66,2407,3,0,3
13,66,2380,6,4,2
13,66,2267,3,2,1
13,66,3716,5,1,4
13,66,1819,1,0,1
13,66,912,0,0,0
13,66,775,0,0,0
13,66,1787,3,2,1
13,67,1226,2,1,1
13,67,1280,2,1,1
13,67,279,1,1,0
13,67,727,0,0,0
13,67,548,0,0,0
13,67,1098,0,0,0
13,67,213,2,0,2
13,67,853,0,0,0
13,67,726,3,1,2
13,67,1393,8,4,4
13,67,458,0,0,0
13,67,2207,4,2,2
13,67,794,1,0,1
13,67,842,0,0,0
13,67,964,5,2,3
13,67,732,4,2,2
13,68,1645,9,2,7
13,68,1545,0,0,0
13,68,4800,43,21,22
13,68,3885,133,68,65
13,68,1326,4,2,2
13,68,1497,5,2,3
13,68,842,4,1,3
13,68,13655,158,84,74
13,68,8825,122,59,63
13,68,1323,1,0,1
13,68,1581,9,6,3
13,68,629,6,1,5
13,68,6766,117,66,51
13,68,19403,291,123,168
13,68,11103,321,170,151
13,68,5885,184,101,83
13,68,3277,535,272,263
13,68,4975,47,20,27
13,68,15574,271,140,131
13,69,1357,10,5,5
13,69,1478,33,19,14
13,69,986,6,2,4
13,69,1089,15,8,7
13,69,2073,72,40,32
13,69,2448,203,91,112
13,69,2107,10,5,5
13,69,3755,14,7,7
13,69,4016,53,20,33
13,70,874,19,11,8
13,70,841,1,1,0
13,70,1119,16,8,8
13,70,824,0,0,0
13,70,369,0,0,0
13,70,29,0,0,0
13,70,192,0,0,0
13,70,302,0,0,0
13,70,482,0,0,0
13,70,176,0,0,0
13,70,896,3,2,1
13,70,276,2,1,1
13,70,337,0,0,0
13,70,886,5,2,3
13,70,538,0,0,0
13,70,382,9,5,4
13,70,154,0,0,0
13,71,1860,3,2,1
13,71,1039,0,0,0
13,71,751,2,1,1
13,71,4176,8,6,2
13,71,879,4,2,2
13,71,475,0,0,0
13,71,522,0,0,0
13,71,1264,5,0,5
13,72,3665,16,8,8
13,72,532,0,0,0
13,72,687,0,0,0
13,72,1056,6,4,2
13,72,1316,3,2,1
13,72,1156,3,0,3
13,72,993,0,0,0
13,72,3107,108,54,54
13,72,1034,28,15,13
13,72,1144,14,5,9
13,72,813,3,3,0
13,72,2510,3,2,1
13,72,1622,7,4,3
13,72,487,8,3,5
13,72,1187,5,3,2
13,72,1776,4,3,1
13,72,1763,13,5,8
13,72,604,3,1,2
13,72,736,0,0,0
13,72,2168,0,0,0
13,72,1855,5,1,4
13,72,1320,2,2,0
13,72,1611,0,0,0
13,72,1414,6,3,3
13,72,648,5,2,3
13,72,2950,12,4,8
13,73,3086,41,21,20
13,73,3033,36,16,20
13,73,1857,16,7,9
13,73,2594,4,4,0
13,73,2594,98,53,45
13,73,1554,4,3,1
13,73,1728,1,0,1
13,73,2232,1,0,1
13,73,2854,24,10,14
13,73,3156,58,29,29
13,73,1980,12,7,5
13,73,1133,7,3,4
13,74,1040,20,12,8
13,74,2866,45,26,19
13,74,84,0,0,0
13,74,1812,21,7,14
13,74,5843,53,29,24
13,74,1460,8,4,4
13,74,7823,70,33,37
13,74,409,1,1,0
13,75,2147,45,26,19
13,75,2254,38,17,21
13,75,1648,71,39,32
13,75,2138,65,31,34
13,75,1843,47,27,20
13,75,1167,19,6,13
13,75,969,7,3,4
13,75,3656,64,37,27
13,75,1707,52,28,24
13,75,2157,31,17,14
13,75,1504,25,13,12
13,75,2434,39,20,19
13,75,3407,27,14,13
13,75,2228,43,22,21
13,75,802,1,1,0
13,75,2823,10,4,6
13,75,325,1,1,0
13,75,3202,5,3,2
13,75,259,3,1,2
13,75,1399,51,23,28
13,75,383,2,2,0
13,75,414,1,1,0
13,75,2000,19,11,8
13,75,1732,14,8,6
13,75,4286,104,46,58
13,75,768,2,2,0
13,75,3177,10,4,6
13,75,3181,37,23,14
13,75,4507,149,68,81
13,75,2365,76,38,38
13,75,5072,45,16,29
13,75,3011,5,2,3
13,75,1582,9,7,2
13,75,1843,5,2,3
13,75,1938,2,1,1
13,75,7940,94,55,39
13,75,1803,5,2,3
13,75,1787,27,12,15
13,75,1739,10,5,5
13,75,880,82,42,40
13,75,438,1,0,1
13,75,2377,46,21,25
13,75,4319,39,18,21
13,75,4445,316,156,160
13,75,1631,6,3,3
13,75,2978,32,17,15
13,75,988,15,5,10
13,75,2740,38,25,13
13,75,3299,2,1,1
13,75,723,3,2,1
13,75,2318,28,14,14
13,75,197,0,0,0
13,76,15645,400,193,207
13,76,5522,12,7,5
13,76,7001,35,23,12
13,76,6306,87,42,45
13,76,3367,144,79,65
13,76,1943,15,7,8
13,76,1266,7,4,3
13,76,2466,20,7,13
13,76,4040,27,15,12
13,76,9194,42,17,25
13,76,4396,297,168,129
13,76,2492,47,24,23
13,76,2039,21,8,13
13,76,1959,75,38,37
13,76,1731,18,10,8
13,76,1321,34,19,15
13,76,904,12,8,4
13,76,659,29,16,13
13,76,1776,34,15,19
13,76,656,2,0,2
13,76,885,1,1,0
13,76,872,1,1,0
13,76,1127,13,7,6
13,76,2324,52,30,22
13,76,2442,24,14,10
13,76,1347,0,0,0
13,76,7671,150,70,80
13,76,2928,14,9,5
13,76,2307,2,2,0
13,76,1164,3,1,2
13,76,1228,1,0,1
13,76,1054,15,8,7
13,76,1204,11,6,5
13,76,2172,4,1,3
13,76,7197,155,78,77
13,76,2015,20,9,11
13,76,3996,11,4,7
13,76,7027,77,33,44
13,76,526,0,0,0
13,76,1165,3,1,2
13,76,959,7,4,3
13,76,1965,13,6,7
13,76,4593,389,214,175
13,76,3803,28,15,13
13,76,1643,4,1,3
13,76,276,0,0,0
13,76,6702,81,44,37
13,76,7540,105,52,53
13,76,1279,5,2,3
13,76,2291,15,8,7
13,76,1243,1,0,1
13,76,1609,239,128,111
13,76,11978,81,41,40
13,76,1106,1,1,0
13,77,1361,14,5,9
13,77,3216,29,15,14
13,77,2794,13,7,6
13,77,444,5,2,3
13,77,2414,12,7,5
13,77,1280,0,0,0
13,77,1822,16,10,6
13,78,2806,21,14,7
13,78,842,109,56,53
13,78,788,3,3,0
13,78,681,4,2,2
13,78,2707,10,3,7
13,78,2456,4,3,1
13,78,1022,7,4,3
13,78,1855,4,2,2
13,78,1212,7,5,2
13,78,1618,2,0,2
13,78,400,100,58,42
13,78,582,0,0,0
13,78,1347,56,31,25
13,79,951,16,8,8
13,79,805,1,0,1
13,79,973,1,1,0
13,79,1073,0,0,0
13,79,151,0,0,0
13,79,479,0,0,0
13,79,437,1,0,1
13,79,1099,0,0,0
13,79,1082,2,1,1
13,80,2757,8,4,4
13,80,2606,7,5,2
13,80,2469,3,3,0
13,80,1412,8,3,5
13,80,397,0,0,0
13,80,1430,4,3,1
13,80,596,3,2,1
13,80,1568,4,3,1
13,80,1785,3,0,3
13,80,636,0,0,0
13,80,780,3,1,2
13,80,727,2,1,1
13,80,856,7,4,3
13,80,4708,9,6,3
13,80,1891,4,4,0
13,81,7477,17,8,9
13,81,2919,7,4,3
13,81,4266,10,4,6
13,81,1908,7,5,2
13,81,1972,4,1,3
13,81,3471,15,8,7
13,81,2946,17,10,7
13,81,1482,0,0,0
13,81,3694,5,3,2
13,81,469,5,3,2
13,81,791,18,10,8
13,81,827,342,176,166
13,81,193,0,0,0
13,81,860,7,3,4
13,81,1013,601,319,282
13,81,1099,26,14,12
13,81,923,17,8,9
13,81,311,1,1,0
13,81,1279,5,3,2
13,82,2742,14,8,6
13,82,2303,3,1,2
13,82,4509,47,22,25
13,82,2882,13,6,7
13,82,2156,53,25,28
13,82,1722,42,22,20
13,82,4955,24,11,13
13,82,1575,8,5,3
13,83,2212,39,19,20
13,83,2231,135,69,66
13,83,2702,38,19,19
13,83,26041,469,241,228
13,83,3814,43,23,20
13,83,2390,261,126,135
13,83,3637,61,33,28
13,83,1008,6,5,1
13,83,1418,24,11,13
13,83,1246,3,1,2
13,83,2742,8,3,5
13,83,1766,27,12,15
13,83,385,1,0,1
13,83,862,0,0,0
13,83,1241,53,29,24
13,83,2601,25,13,12
13,83,687,0,0,0
13,84,2829,14,8,6
13,84,1576,16,8,8
13,84,1004,4,2,2
13,84,1490,45,26,19
13,84,2750,21,12,9
13,84,853,0,0,0
13,84,2338,0,0,0
13,84,93,0,0,0
13,84,669,0,0,0
13,84,136,4,3,1
13,84,200,0,0,0
13,84,164,2,2,0
13,84,302,0,0,0
13,84,106,1,0,1
13,84,296,0,0,0
13,84,198,3,2,1
13,84,418,71,41,30
13,84,323,65,33,32
13,84,283,0,0,0
13,84,175,0,0,0
13,84,682,12,9,3
13,84,151,0,0,0
13,84,329,2,0,2
13,84,154,0,0,0
13,84,504,0,0,0
13,84,1079,0,0,0
13,84,1561,8,3,5
13,84,2389,6,4,2
13,84,2328,32,16,16
13,84,745,1,1,0
13,84,157,1,0,1
13,84,562,12,5,7
13,84,3182,1,0,1
13,84,952,1,0,1
13,84,255,6,4,2
13,84,586,1,1,0
13,84,850,20,13,7
13,84,118,0,0,0
13,84,164,0,0,0
13,84,624,4,1,3
13,84,558,3,1,2
13,84,1079,11,7,4
13,84,178,1,0,1
13,84,594,11,6,5
13,84,158,0,0,0
13,84,191,1,0,1
13,84,673,2,2,0
13,84,491,1,1,0
13,84,223,0,0,0
13,84,661,8,4,4
13,84,918,0,0,0
13,84,224,1,0,1
13,84,240,4,1,3
13,84,179,0,0,0
13,40,802,4,1,3
13,40,1145,8,3,5
13,40,2971,34,14,20
13,40,907,2,1,1
13,40,1169,11,7,4
13,40,1054,19,6,13
13,40,628,1,1,0
13,40,972,13,8,5
13,40,1607,15,12,3
13,40,3021,47,23,24
13,47,952,101,52,49
13,40,981,63,36,27
13,40,854,11,4,7
13,40,1386,93,52,41
13,40,447,42,25,17
13,40,786,12,7,5
13,40,1134,27,18,9
13,40,838,30,12,18
13,40,721,9,4,5
13,40,1294,5,2,3
13,40,827,1,0,1
13,40,744,5,2,3
13,40,821,48,26,22
13,40,257,4,1,3
13,40,938,1,1,0
13,40,900,11,9,2
13,40,791,0,0,0
13,40,643,11,4,7
13,40,913,96,52,44
13,40,857,14,6,8
13,40,1074,18,8,10
13,40,755,3,1,2
13,40,1211,17,11,6
13,40,1000,47,23,24
13,40,1134,37,19,18
13,40,763,54,24,30
13,40,1116,2,0,2
13,40,1379,34,13,21
13,40,998,4,0,4
13,40,1196,8,2,6
13,40,1224,2,1,1
13,40,993,9,5,4
13,40,3042,35,14,21
13,40,2643,46,23,23
13,40,1974,17,11,6
13,40,656,4,2,2
13,40,1331,5,3,2
13,40,1370,6,3,3
13,40,1305,17,5,12
13,40,2213,50,22,28
13,40,1082,3,0,3
13,40,2181,30,15,15
13,40,1379,25,12,13
13,40,1735,44,24,20
13,40,2099,49,22,27
13,40,1317,18,8,10
13,40,1482,14,8,6
13,40,1612,58,31,27
13,40,1162,13,6,7
13,68,2478,47,27,20
13,68,3729,103,60,43
13,68,2392,85,40,45
13,68,15992,420,209,211
13,68,1247,11,11,0
13,68,1808,25,9,16
13,68,2043,10,2,8
13,68,2935,37,18,19
13,68,2162,71,36,35
13,68,1953,53,29,24
13,68,2036,40,20,20
13,68,1955,41,22,19
13,68,1410,11,6,5
13,68,4920,100,55,45
13,68,2180,131,70,61
13,68,3000,54,24,30
13,68,1998,57,30,27
13,68,1355,49,28,21
13,68,2225,5,2,3
13,68,748,7,3,4
13,68,1188,1,1,0
14,1,2335,40,24,16
14,1,1423,6,2,4
14,1,2717,223,108,115
14,1,3304,974,491,483
14,1,3186,131,69,62
14,1,1844,58,26,32
14,1,770,1,0,1
14,1,379,2,1,1
14,1,3474,70,30,40
14,1,2379,4,1,3
14,1,1040,3,1,2
14,2,2531,109,46,63
14,2,1246,1,0,1
14,2,2361,8,2,6
14,2,3670,18,8,10
14,2,1497,1,1,0
14,2,4331,21,10,11
14,2,1859,21,9,12
14,2,1142,16,6,10
14,2,1036,3,1,2
14,2,3000,12,4,8
14,2,1051,3,0,3
14,3,3196,4,2,2
14,3,1096,4,2,2
14,3,953,4,1,3
14,3,2404,5,4,1
14,3,1970,16,10,6
14,3,2476,87,37,50
14,3,979,2,2,0
14,3,4142,115,55,60
14,3,343,3,1,2
14,3,1620,21,11,10
14,3,2733,11,5,6
14,3,1718,2,1,1
14,4,1093,27,14,13
14,4,1940,71,37,34
14,4,392,0,0,0
14,4,2318,37,17,20
14,5,4202,19,6,13
14,5,1781,25,11,14
14,5,3701,22,14,8
14,5,3301,9,5,4
14,5,653,1,0,1
14,5,656,3,2,1
14,5,619,0,0,0
14,5,1577,3,0,3
14,6,3418,17,10,7
14,6,2897,12,9,3
14,6,1534,9,5,4
14,6,3949,16,8,8
14,6,1013,20,12,8
14,6,1082,21,10,11
14,6,1039,8,3,5
14,6,3176,2,2,0
14,6,1217,2,2,0
14,6,659,17,10,7
14,6,620,1,0,1
14,6,636,0,0,0
14,6,1028,54,35,19
14,6,1877,3,2,1
14,6,2243,1,1,0
14,6,1845,7,4,3
14,6,1344,10,3,7
14,6,1367,3,0,3
14,6,4759,23,14,9
14,6,597,173,80,93
14,6,1936,10,5,5
14,6,640,1,0,1
14,6,1666,6,2,4
14,6,2764,10,3,7
14,6,540,0,0,0
14,6,389,1,1,0
14,6,855,1,0,1
14,6,1283,3,1,2
14,6,1262,13,4,9
14,6,914,4,2,2
14,6,1576,1,1,0
14,6,1787,3,2,1
14,6,1073,5,3,2
14,6,302,4,1,3
14,6,589,1,1,0
14,6,1317,8,0,8
14,6,462,0,0,0
14,6,1283,10,5,5
14,6,835,0,0,0
14,6,776,0,0,0
14,6,503,0,0,0
14,6,947,5,3,2
14,6,93,0,0,0
14,6,349,0,0,0
14,7,2274,8,4,4
14,7,1647,0,0,0
14,7,1529,1,0,1
14,7,820,7,1,6
14,7,860,1,1,0
14,7,518,0,0,0
14,7,665,1,0,1
14,7,1173,5,3,2
14,8,3875,9,4,5
14,8,1727,6,4,2
14,8,2831,12,3,9
14,8,1637,10,6,4
14,8,6865,112,64,48
14,8,11172,41,19,22
14,8,1472,2,1,1
14,8,978,4,1,3
14,8,1001,1,0,1
14,8,5399,31,13,18
14,8,2794,40,20,20
14,8,1580,12,8,4
14,8,4424,11,7,4
14,8,4788,44,18,26
14,8,4813,45,19,26
14,8,8368,43,19,24
14,8,1939,60,27,33
14,8,1813,19,11,8
14,125,3165,12,7,5
14,125,2112,1,1,0
14,125,2951,12,8,4
14,125,3253,25,12,13
14,8,946,9,2,7
14,8,775,2,1,1
14,8,455,4,2,2
14,8,1865,9,5,4
14,8,419,12,5,7
14,8,185,0,0,0
14,8,295,3,0,3
14,8,739,7,2,5
14,8,992,15,9,6
14,8,1341,4,0,4
14,8,1939,12,3,9
14,125,881,1,0,1
14,125,2072,12,3,9
14,8,1943,9,5,4
14,125,2825,7,3,4
14,9,4081,22,8,14
14,9,3402,7,3,4
14,9,8063,58,29,29
14,9,3074,13,6,7
14,9,2229,6,2,4
14,10,2297,18,6,12
14,10,2770,77,36,41
14,10,1767,8,5,3
14,10,469,0,0,0
14,10,654,0,0,0
14,11,1060,14,7,7
14,11,927,7,6,1
14,11,311,1,1,0
14,11,526,1,1,0
14,11,2372,11,4,7
14,11,403,0,0,0
14,12,1452,1,0,1
14,12,426,1,0,1
14,12,88,0,0,0
14,12,229,0,0,0
14,12,1732,8,4,4
14,12,274,0,0,0
14,13,1368,3,2,1
14,13,1851,4,2,2
14,13,1303,12,5,7
14,13,8265,83,37,46
14,13,1461,8,2,6
14,13,2255,19,8,11
14,13,3356,17,9,8
14,13,696,24,15,9
14,13,1082,1,1,0
14,13,9870,34,15,19
14,13,3830,10,4,6
14,13,3107,13,5,8
14,13,1080,14,8,6
14,13,1136,2,1,1
14,13,1100,1,1,0
14,13,3406,11,3,8
14,13,2656,42,26,16
14,13,163,0,0,0
14,13,620,2,2,0
14,13,1351,21,11,10
14,13,2415,45,21,24
14,13,2006,2,2,0
14,13,1105,11,2,9
14,13,3133,13,5,8
14,13,1947,2,1,1
14,13,1581,7,3,4
14,13,1835,33,15,18
14,14,2180,19,11,8
14,14,1781,6,3,3
14,14,1432,12,5,7
14,14,709,1,0,1
14,14,1387,6,3,3
14,14,1239,36,18,18
14,15,3962,19,10,9
14,15,3735,18,8,10
14,15,1118,14,7,7
14,15,4578,12,5,7
14,15,943,9,5,4
14,15,1552,1,0,1
14,15,1355,27,14,13
14,15,3150,41,22,19
14,15,5539,30,15,15
14,15,1626,0,0,0
14,15,1512,1,0,1
14,15,1004,7,6,1
14,15,1494,16,7,9
14,15,3452,49,30,19
14,15,2048,15,11,4
14,15,2045,9,5,4
14,15,4984,37,19,18
14,15,1323,3,1,2
14,15,6949,26,13,13
14,15,1047,2,0,2
14,15,1208,0,0,0
14,15,679,0,0,0
14,15,1617,14,5,9
14,15,1870,38,0,38
14,15,1567,81,41,40
14,15,1185,0,0,0
14,15,469,0,0,0
14,15,340,0,0,0
14,15,1245,0,0,0
14,15,1335,4,0,4
14,16,3484,22,11,11
14,16,5285,54,32,22
14,16,2926,18,9,9
14,16,3586,21,11,10
14,16,1776,1,0,1
14,16,1388,1,1,0
14,16,3387,10,6,4
14,16,1656,2,0,2
14,16,4355,4,3,1
14,16,4099,13,8,5
14,16,192,0,0,0
14,16,1152,0,0,0
14,16,322,0,0,0
14,16,1106,6,2,4
14,16,527,2,1,1
14,16,1058,1,0,1
14,16,855,0,0,0
14,16,1424,1,0,1
14,16,2939,6,0,6
14,17,3642,97,51,46
14,17,1376,19,13,6
14,17,1074,12,4,8
14,17,1161,20,6,14
14,17,1048,17,8,9
14,17,475,5,3,2
14,17,864,12,5,7
14,17,907,8,5,3
14,17,323,1,0,1
14,17,834,0,0,0
14,17,649,0,0,0
14,17,558,0,0,0
14,18,2634,5,4,1
14,18,4789,27,10,17
14,18,7846,45,21,24
14,18,2553,46,22,24
14,18,4974,18,9,9
14,18,1978,4,2,2
14,18,2380,18,10,8
14,18,2602,6,3,3
14,18,1471,4,4,0
14,18,1694,4,2,2
14,18,853,3,2,1
14,18,1165,1,0,1
14,18,1102,1,1,0
14,18,3631,11,3,8
14,18,1726,11,5,6
14,18,1079,1,1,0
14,18,729,0,0,0
14,18,2141,5,1,4
14,18,937,3,0,3
14,18,967,5,1,4
14,18,994,1,0,1
14,18,641,1,0,1
14,18,1159,2,0,2
14,18,879,0,0,0
14,18,1164,0,0,0
14,18,1020,0,0,0
14,18,1140,7,4,3
14,18,1542,14,6,8
14,18,585,2,1,1
14,18,1461,16,9,7
14,18,508,0,0,0
14,18,2203,3,0,3
14,18,2286,6,4,2
14,18,1263,3,1,2
14,18,2381,0,0,0
14,18,1318,1,1,0
14,19,1859,2,0,2
14,19,788,14,7,7
14,19,3860,1,1,0
14,19,702,0,0,0
14,20,1909,26,11,15
14,20,3775,19,6,13
14,20,1497,1,0,1
14,20,1447,4,3,1
14,20,1773,4,3,1
14,20,858,1,0,1
14,21,1804,3,2,1
14,21,1458,2,2,0
14,21,1812,2,1,1
14,21,2030,6,2,4
14,21,1178,2,2,0
14,21,1254,14,4,10
14,21,1607,3,2,1
14,21,1361,2,0,2
14,21,1407,6,3,3
14,21,2435,17,11,6
14,21,1330,5,1,4
14,21,1081,6,3,3
14,21,1315,14,6,8
14,21,477,1,1,0
14,22,3471,18,6,12
14,22,2434,33,11,22
14,22,2786,8,4,4
14,22,1168,0,0,0
14,22,2097,20,6,14
14,22,2182,12,7,5
14,22,1447,8,3,5
14,22,1040,9,6,3
14,22,1307,8,3,5
14,22,3693,19,14,5
14,22,872,5,2,3
14,22,2471,66,35,31
14,22,4306,261,138,123
14,22,1146,3,2,1
14,22,3250,10,7,3
14,22,6194,143,74,69
14,22,275,0,0,0
14,23,7748,63,24,39
14,23,1890,112,64,48
14,23,3627,59,31,28
14,23,2447,27,10,17
14,23,978,4,2,2
14,23,1610,56,24,32
14,23,811,6,4,2
14,23,990,7,4,3
14,23,901,13,6,7
14,23,3350,40,23,17
14,23,673,13,9,4
14,23,653,9,3,6
14,23,1059,13,9,4
14,23,721,7,5,2
14,23,1334,10,5,5
14,23,1623,20,10,10
14,23,1234,1,0,1
14,23,572,3,1,2
14,23,1116,4,2,2
14,23,868,2,0,2
14,23,764,10,2,8
14,23,2690,20,8,12
14,23,1529,5,0,5
14,23,3557,15,8,7
14,23,4395,82,47,35
14,23,1540,0,0,0
14,23,946,0,0,0
14,23,1488,23,11,12
14,23,1317,28,7,21
14,23,3321,43,19,24
14,23,1543,5,0,5
14,23,1152,7,5,2
14,23,1108,8,3,5
14,23,256,1,1,0
14,23,1139,3,2,1
14,23,967,5,3,2
14,23,3075,42,18,24
14,23,5359,156,80,76
14,23,1575,6,1,5
14,23,1257,8,7,1
14,23,1554,6,3,3
14,23,2151,70,34,36
14,23,16578,90,37,53
14,23,2258,17,7,10
14,23,2226,12,4,8
14,23,4921,25,9,16
14,23,1008,18,7,11
14,23,2853,7,5,2
14,23,5755,18,13,5
14,23,715,4,3,1
14,23,1949,49,11,38
14,24,2103,19,11,8
14,24,1779,4,1,3
14,24,1688,8,5,3
14,24,1840,14,6,8
14,24,1721,4,3,1
14,24,1623,2,0,2
14,24,254,11,5,6
14,24,1450,14,9,5
14,24,2606,53,23,30
14,24,1461,11,6,5
14,25,2601,7,3,4
14,25,2331,2,0,2
14,25,897,8,4,4
14,25,5071,36,19,17
14,25,2129,60,27,33
14,25,1201,117,56,61
14,25,425,3,1,2
14,25,2511,8,4,4
14,25,1476,4,2,2
14,25,1202,2,1,1
14,25,1157,7,3,4
14,25,1395,5,0,5
14,25,1416,45,21,24
14,25,674,2,0,2
14,25,2642,6,3,3
14,25,1259,1,1,0
14,25,951,6,2,4
14,26,2843,31,14,17
14,26,499,4,2,2
14,26,1574,34,18,16
14,26,2360,22,8,14
14,26,1062,44,21,23
14,26,1112,16,9,7
14,26,1526,68,36,32
14,26,2163,43,23,20
14,26,1476,20,10,10
14,26,2672,16,8,8
14,26,749,10,4,6
14,26,93,0,0,0
14,26,203,5,3,2
14,26,338,0,0,0
14,26,692,1,0,1
14,26,338,1,1,0
14,27,1184,2,1,1
14,27,1660,2,2,0
14,27,2615,12,5,7
14,27,103,0,0,0
14,27,690,2,0,2
14,28,1433,2,1,1
14,28,2509,4,0,4
14,28,2511,32,18,14
14,28,3454,15,8,7
14,28,2571,12,5,7
14,28,2703,16,8,8
14,28,379,0,0,0
14,28,2385,5,5,0
14,28,425,0,0,0
14,29,898,38,19,19
14,29,748,15,5,10
14,29,161,1,0,1
14,29,334,0,0,0
14,30,2793,7,4,3
14,30,2965,6,4,2
14,30,1365,0,0,0
14,30,1787,4,4,0
14,30,1019,1,1,0
14,30,1462,1,0,1
14,30,862,2,0,2
14,30,944,0,0,0
14,30,1326,3,2,1
14,30,1224,2,0,2
14,30,1296,1,1,0
14,30,1059,3,0,3
14,31,6479,1160,587,573
14,31,3711,29,17,12
14,31,3977,5,2,3
14,31,1090,18,12,6
14,31,1618,130,68,62
14,31,3127,183,81,102
14,31,3384,222,123,99
14,31,1449,8,2,6
14,31,844,14,9,5
14,31,4066,448,216,232
14,31,2775,13,4,9
14,31,2063,135,64,71
14,31,2595,26,13,13
14,31,3918,62,30,32
14,31,1253,12,6,6
14,31,2193,7,5,2
14,31,1876,36,16,20
14,31,2073,4,0,4
14,31,6571,150,75,75
14,32,1162,19,8,11
14,32,1440,13,8,5
14,32,392,0,0,0
14,33,2023,3,2,1
14,33,2642,11,7,4
14,33,471,1,1,0
14,33,649,4,2,2
14,34,4541,11,5,6
14,34,1504,0,0,0
14,34,1087,7,3,4
14,34,1008,1,0,1
14,34,1913,2,0,2
14,34,2297,3,3,0
14,34,1724,3,1,2
14,34,1248,5,5,0
14,34,690,2,1,1
14,34,166,0,0,0
14,34,752,8,5,3
14,34,147,1,1,0
14,34,1235,7,2,5
14,34,1173,9,6,3
14,34,931,2,1,1
14,34,893,0,0,0
14,35,1605,3,0,3
14,35,363,13,6,7
14,36,5624,44,20,24
14,36,1162,3,1,2
14,36,1221,4,4,0
14,36,4481,9,5,4
14,36,5332,12,5,7
14,36,1990,25,8,17
14,36,969,4,3,1
14,36,1716,178,93,85
14,36,3829,11,8,3
14,36,1936,10,5,5
14,36,1315,3,2,1
14,36,2517,17,11,6
14,36,723,0,0,0
14,36,260,0,0,0
14,36,499,0,0,0
14,36,497,1,1,0
14,36,2955,15,8,7
14,36,1911,7,4,3
14,36,674,1,0,1
14,36,290,0,0,0
14,36,306,0,0,0
14,36,2606,6,3,3
14,36,2122,11,7,4
14,36,2673,38,16,22
14,36,452,0,0,0
14,36,508,2,0,2
14,37,3186,11,5,6
14,37,3634,10,6,4
14,37,2035,2,0,2
14,37,1698,12,8,4
14,37,741,1,0,1
14,37,1193,8,5,3
14,37,2499,8,3,5
14,37,960,0,0,0
14,37,1579,91,42,49
14,37,2193,12,4,8
14,37,240,2,2,0
14,38,4210,153,79,74
14,38,3427,12,6,6
14,38,1518,24,13,11
14,38,2078,78,39,39
14,38,3692,94,57,37
14,38,937,105,52,53
14,38,273,16,8,8
14,38,302,2,2,0
14,39,3940,12,7,5
14,39,2929,20,12,8
14,39,1290,19,8,11
14,39,3242,20,10,10
14,39,4350,39,19,20
14,39,958,4,4,0
14,39,2800,11,8,3
14,39,811,1,0,1
14,39,870,3,2,1
14,39,2121,6,2,4
14,39,2169,3,2,1
14,39,406,1,0,1
14,40,1377,0,0,0
14,40,844,2,1,1
14,40,660,2,1,1
14,40,96,0,0,0
14,40,475,1,0,1
14,40,134,0,0,0
14,40,291,0,0,0
14,40,322,5,3,2
14,41,621,20,13,7
14,41,576,8,4,4
14,41,785,3,2,1
14,41,699,13,7,6
14,41,708,21,12,9
14,41,666,7,4,3
14,41,758,18,6,12
14,41,754,11,5,6
14,41,985,2,1,1
14,41,807,8,1,7
14,41,447,1,0,1
14,41,894,4,0,4
14,41,1087,14,7,7
14,41,633,4,1,3
14,41,868,10,3,7
14,41,697,22,8,14
14,41,1236,11,5,6
14,41,1343,10,6,4
14,41,774,3,0,3
14,41,767,3,1,2
14,41,830,2,0,2
14,41,1141,5,3,2
14,41,1046,15,12,3
14,41,2033,8,5,3
14,41,828,28,16,12
14,41,712,15,9,6
14,41,642,26,13,13
14,41,948,27,14,13
14,41,515,0,0,0
14,41,965,14,5,9
14,41,1222,25,13,12
14,41,1046,12,7,5
14,41,1094,12,8,4
14,41,799,6,3,3
14,41,623,10,4,6
14,41,756,3,1,2
14,41,840,7,4,3
14,41,1008,16,8,8
14,41,886,4,3,1
14,41,1091,4,2,2
14,41,742,0,0,0
14,41,937,1,0,1
14,41,901,11,7,4
14,41,962,31,16,15
14,41,1086,18,7,11
14,41,622,4,2,2
14,41,1353,26,13,13
14,41,883,13,7,6
14,41,563,5,3,2
14,41,433,4,1,3
14,41,561,0,0,0
14,41,512,14,9,5
14,41,923,16,6,10
14,41,744,27,11,16
14,41,777,24,11,13
14,41,615,28,15,13
14,41,1018,23,17,6
14,41,755,10,5,5
14,41,624,8,3,5
14,41,523,4,2,2
14,41,1349,11,5,6
14,41,2151,4,3,1
14,41,565,5,4,1
14,41,1245,8,5,3
14,41,1111,10,7,3
14,41,1253,5,4,1
14,41,1070,7,4,3
14,41,2371,12,5,7
14,41,2172,3,1,2
14,41,1143,14,5,9
14,41,1396,0,0,0
14,41,1724,2,2,0
14,41,2411,9,3,6
14,41,1532,7,3,4
14,41,1621,14,4,10
14,41,2046,21,10,11
14,41,1726,10,5,5
14,41,2305,430,235,195
14,41,1803,146,73,73
14,41,1725,22,11,11
14,41,1809,12,7,5
14,41,1684,42,23,19
14,41,1691,140,70,70
14,41,2339,8,1,7
14,41,1491,20,9,11
14,41,2056,9,4,5
14,41,1222,19,12,7
14,41,314,1,0,1
14,41,471,0,0,0
14,41,640,18,9,9
14,41,1873,19,14,5
14,41,1636,3,2,1
14,41,1260,5,5,0
14,41,2132,46,25,21
14,41,1891,11,5,6
14,41,3106,57,28,29
14,41,2247,43,23,20
14,41,1566,9,2,7
14,41,1358,24,13,11
14,41,1796,18,6,12
14,41,986,1,1,0
14,41,1033,3,0,3
14,41,1334,6,4,2
14,41,1414,8,3,5
14,41,1865,61,35,26
14,41,1280,17,5,12
14,41,1082,22,10,12
14,41,1289,15,5,10
14,41,1175,15,6,9
14,41,1448,11,3,8
14,41,1331,18,10,8
14,41,1127,31,15,16
14,41,1216,34,15,19
14,41,1528,13,5,8
14,41,1674,53,32,21
14,41,1550,16,7,9
14,41,1162,21,9,12
14,41,1448,68,36,32
14,41,1212,20,8,12
14,41,889,2,1,1
14,41,1241,18,10,8
14,41,1489,9,5,4
14,41,1549,50,27,23
14,41,1255,5,1,4
14,41,1205,7,3,4
14,41,1540,6,2,4
14,41,1835,5,1,4
14,41,1521,19,7,12
14,41,1373,1,0,1
14,41,1488,5,2,3
14,41,1460,52,23,29
14,41,1779,26,9,17
14,41,1359,6,1,5
14,41,1410,4,0,4
14,41,1580,4,2,2
14,41,1389,4,2,2
14,41,2713,10,1,9
14,41,1140,6,3,3
14,41,1287,56,24,32
14,41,1168,5,3,2
14,41,2454,12,5,7
14,41,1644,14,11,3
14,41,4998,83,37,46
14,41,1206,6,3,3
14,41,1102,5,2,3
14,41,1007,2,1,1
14,41,1708,14,7,7
14,41,1312,16,10,6
14,41,1359,9,4,5
14,41,1015,6,3,3
14,41,1575,31,17,14
14,41,1189,211,116,95
14,41,1216,4,1,3
14,41,1795,10,5,5
14,41,1716,7,4,3
14,41,1375,472,244,228
14,41,1347,10,4,6
14,41,1842,15,4,11
14,41,1525,12,8,4
14,41,1300,15,10,5
14,41,2158,5,2,3
14,41,1663,21,9,12
14,41,965,21,11,10
14,41,825,12,5,7
14,41,1180,8,7,1
14,41,1021,2,1,1
14,41,1686,34,14,20
14,41,663,4,2,2
14,41,738,20,9,11
14,41,1098,99,49,50
14,41,957,5,3,2
14,41,1057,563,294,269
14,41,972,5,3,2
14,41,949,9,5,4
14,41,1223,52,20,32
14,41,1033,10,6,4
14,41,776,1,0,1
14,41,809,1,1,0
14,41,1920,25,8,17
14,41,1599,6,4,2
14,41,1765,596,292,304
14,41,1653,17,8,9
14,41,1292,109,65,44
14,41,921,0,0,0
14,41,801,24,11,13
14,41,1348,84,47,37
14,41,1709,32,20,12
14,41,725,2,1,1
14,41,911,1,0,1
14,41,1332,23,12,11
14,41,1231,21,14,7
14,41,1078,73,31,42
14,41,1047,3,2,1
14,41,665,19,7,12
14,41,698,18,10,8
14,41,550,16,8,8
14,41,1226,12,10,2
14,41,758,2,2,0
14,41,646,7,4,3
14,41,1237,54,26,28
14,41,1218,17,7,10
14,41,1519,44,24,20
14,41,850,1,1,0
14,41,1060,173,85,88
14,41,988,31,18,13
14,41,645,29,12,17
14,41,1015,51,25,26
14,41,1246,81,42,39
14,41,1201,25,9,16
14,41,1359,4,3,1
14,41,1150,7,1,6
14,41,830,14,8,6
14,41,912,2,2,0
14,41,1001,1,0,1
14,41,1747,39,21,18
14,41,783,19,9,10
14,41,653,1,0,1
14,41,1154,69,42,27
14,41,1400,152,82,70
14,41,1326,63,34,29
14,41,1337,34,15,19
14,41,2456,32,12,20
14,41,1475,42,21,21
14,41,1484,18,12,6
14,41,1456,29,17,12
14,41,977,1,1,0
14,41,938,40,22,18
14,41,1295,16,8,8
14,41,1468,10,5,5
14,41,1892,5,2,3
14,41,861,13,3,10
14,41,837,3,0,3
14,41,1375,48,23,25
14,41,1489,3,3,0
14,41,1431,29,17,12
14,41,1262,4,2,2
14,41,1325,19,10,9
14,41,2033,43,30,13
14,41,1685,13,5,8
14,41,1516,11,5,6
14,41,1639,30,13,17
14,41,1152,3,2,1
14,41,952,6,4,2
14,41,1688,7,5,2
14,41,1107,20,8,12
14,41,887,7,2,5
14,41,1450,7,2,5
14,41,979,3,1,2
14,41,838,13,5,8
14,41,921,2,2,0
14,41,711,13,7,6
14,41,1495,18,9,9
14,41,1037,33,18,15
14,41,801,23,13,10
14,41,1310,15,5,10
14,41,1438,65,32,33
14,41,1693,32,12,20
14,41,1747,23,11,12
14,41,2033,14,5,9
14,41,1897,31,16,15
14,41,1791,19,8,11
14,41,1692,21,14,7
14,41,1782,17,6,11
14,41,1579,14,9,5
14,41,1546,12,8,4
14,41,1826,119,58,61
14,41,1175,2,0,2
14,41,1545,15,6,9
14,41,1912,30,19,11
14,41,1594,15,5,10
14,41,1558,55,28,27
14,41,1436,18,12,6
14,41,1704,10,6,4
14,41,1445,27,17,10
14,41,1861,6,6,0
14,41,1571,7,5,2
14,41,1270,4,3,1
14,41,1408,17,7,10
14,41,1279,15,7,8
14,41,1662,25,11,14
14,41,1232,4,2,2
14,41,2470,21,10,11
14,41,2200,147,83,64
14,41,2111,30,14,16
14,41,2567,7,3,4
14,41,2150,46,18,28
14,41,2810,15,5,10
14,41,1870,20,10,10
14,41,637,0,0,0
14,41,1207,1,0,1
14,41,762,3,3,0
14,41,1071,4,1,3
14,41,1603,10,6,4
14,41,1558,8,3,5
14,41,894,4,2,2
14,41,824,5,4,1
14,41,970,3,1,2
14,41,545,0,0,0
14,41,1788,12,5,7
14,41,2027,21,7,14
14,41,1594,26,14,12
14,41,1608,15,11,4
14,41,1524,5,2,3
14,41,2494,371,190,181
14,41,3174,262,131,131
14,41,2686,4,2,2
14,41,3669,16,8,8
14,41,2473,11,7,4
14,41,1756,0,0,0
14,41,1562,163,87,76
14,41,2668,65,28,37
14,41,2044,21,11,10
14,41,1786,11,6,5
14,41,1827,10,3,7
14,41,1578,24,8,16
14,41,1883,15,10,5
14,41,3008,52,25,27
14,41,2800,25,14,11
14,41,1976,41,18,23
14,41,1346,17,9,8
14,41,1420,34,18,16
14,41,2098,9,3,6
14,41,1575,28,15,13
14,41,2449,26,8,18
14,41,2398,15,7,8
14,41,2469,29,15,14
14,41,1425,7,3,4
14,41,1094,22,10,12
14,41,1422,8,6,2
14,41,1966,28,13,15
14,41,2065,13,8,5
14,41,2353,59,26,33
14,41,3647,49,27,22
14,41,2214,12,5,7
14,41,2681,33,18,15
14,41,1441,8,2,6
14,41,1460,12,3,9
14,41,2388,25,12,13
14,41,1442,4,1,3
14,41,1109,2,0,2
14,41,2180,44,24,20
14,41,2401,27,17,10
14,41,1412,18,8,10
14,41,1522,13,10,3
14,41,1725,6,1,5
14,41,1398,2,0,2
14,41,4381,46,25,21
14,41,2061,5,2,3
14,41,2752,51,22,29
14,41,2242,10,4,6
14,41,3344,30,13,17
14,41,1909,6,3,3
14,41,3150,28,9,19
14,41,3318,23,13,10
14,41,965,7,2,5
14,41,3799,23,14,9
14,41,3335,48,17,31
14,41,2134,28,13,15
14,41,2750,4,0,4
14,41,530,28,14,14
14,41,316,1,0,1
14,41,602,14,11,3
14,41,1014,32,12,20
14,41,633,1,0,1
14,41,909,10,4,6
14,41,1012,6,3,3
14,41,1092,14,9,5
14,41,819,9,3,6
14,41,865,5,3,2
14,41,975,15,8,7
14,41,962,18,6,12
14,41,1164,7,2,5
14,41,713,1,0,1
14,41,686,4,1,3
14,41,1071,6,2,4
14,41,680,1,1,0
14,41,706,0,0,0
14,41,478,2,2,0
14,41,917,283,155,128
14,41,1106,19,9,10
14,41,639,5,1,4
14,41,688,4,1,3
14,41,757,7,3,4
14,41,783,16,11,5
14,41,841,16,6,10
14,41,887,33,19,14
14,41,724,0,0,0
14,41,1200,66,42,24
14,41,757,30,12,18
14,41,574,216,109,107
14,41,737,31,21,10
14,41,758,105,55,50
14,41,753,19,11,8
14,41,1283,1,0,1
14,41,1004,7,6,1
14,41,798,16,10,6
14,41,1244,6,4,2
14,41,945,6,3,3
14,41,680,4,0,4
14,41,616,13,8,5
14,41,639,19,8,11
14,41,645,0,0,0
14,41,829,1,0,1
14,41,626,14,7,7
14,41,1031,101,52,49
14,41,531,4,2,2
14,41,626,19,12,7
14,41,823,29,11,18
14,41,466,1,0,1
14,41,878,17,9,8
14,41,853,6,4,2
14,41,1704,9,5,4
14,41,482,1,1,0
14,41,920,1,0,1
14,41,455,7,4,3
14,41,754,3,2,1
14,41,775,9,4,5
14,41,2362,13,6,7
14,41,2028,14,9,5
14,41,1141,400,214,186
14,41,873,79,40,39
14,41,637,10,5,5
14,41,920,305,146,159
14,41,1170,48,26,22
14,41,681,9,4,5
14,41,1939,8,5,3
14,41,748,2,1,1
14,41,1010,2,1,1
14,41,1970,5,2,3
14,41,862,1,0,1
14,41,1099,31,15,16
14,41,1232,23,9,14
14,41,1140,12,7,5
14,41,2362,14,6,8
14,41,1301,1,0,1
14,41,809,28,18,10
14,41,1703,45,26,19
14,41,1946,14,7,7
14,41,834,16,9,7
14,41,821,17,10,7
14,41,1438,30,17,13
14,41,1158,8,4,4
14,41,883,1,0,1
14,41,1071,1,1,0
14,41,746,3,3,0
14,41,748,7,3,4
14,41,927,7,3,4
14,41,730,14,9,5
14,41,1200,14,3,11
14,41,1030,24,12,12
14,41,986,74,45,29
14,41,603,8,4,4
14,41,713,20,11,9
14,41,613,14,8,6
14,41,730,5,4,1
14,41,467,1,1,0
14,41,1003,6,2,4
14,41,730,6,4,2
14,41,349,16,6,10
14,41,605,5,3,2
14,41,541,5,4,1
14,41,744,4,1,3
14,41,1065,87,48,39
14,41,555,70,40,30
14,41,1005,38,25,13
14,41,594,2,0,2
14,41,820,14,6,8
14,41,802,57,26,31
14,41,623,23,14,9
14,41,913,18,9,9
14,41,828,2,2,0
14,41,891,18,11,7
14,41,714,44,23,21
14,41,580,14,7,7
14,41,216,5,3,2
14,41,376,5,2,3
14,41,501,3,1,2
14,41,76,0,0,0
14,41,140,3,3,0
14,41,480,6,5,1
14,41,384,18,11,7
14,41,463,18,9,9
14,41,672,2,1,1
14,41,702,12,3,9
14,41,361,27,17,10
14,41,656,22,9,13
14,41,355,4,2,2
14,41,829,13,7,6
14,41,418,21,9,12
14,41,1743,64,27,37
14,41,1049,13,6,7
14,41,769,27,12,15
14,41,463,8,4,4
14,41,872,12,9,3
14,41,1465,43,22,21
14,41,1108,21,11,10
14,41,739,24,16,8
14,41,978,12,5,7
14,41,753,32,14,18
14,41,901,24,9,15
14,41,610,10,5,5
14,41,528,100,53,47
14,41,469,2,1,1
14,41,683,13,6,7
14,41,594,143,73,70
14,41,733,38,21,17
14,41,1449,61,29,32
14,41,940,27,17,10
14,41,704,23,14,9
14,41,713,10,8,2
14,41,843,25,13,12
14,41,1099,106,55,51
14,41,919,76,40,36
14,41,785,9,5,4
14,41,693,4,1,3
14,41,1088,19,9,10
14,41,2366,54,26,28
14,41,3299,37,21,16
14,41,2132,2,1,1
14,41,832,4,2,2
14,41,1975,8,6,2
14,41,1259,3,1,2
14,41,1083,15,7,8
14,41,832,13,7,6
14,41,706,9,3,6
14,41,1036,4,0,4
14,41,973,4,3,1
14,41,1079,168,88,80
14,41,600,8,3,5
14,41,1401,5,2,3
14,41,1273,2,0,2
14,41,1329,25,12,13
14,41,1575,36,20,16
14,41,1522,9,3,6
14,41,904,14,9,5
14,41,1577,37,17,20
14,41,1193,47,21,26
14,41,1399,67,36,31
14,41,583,14,7,7
14,41,826,35,17,18
14,41,1113,3,0,3
14,41,1035,13,10,3
14,41,1471,18,9,9
14,41,903,28,14,14
14,41,1252,263,133,130
14,41,1443,7,3,4
14,41,919,6,4,2
14,41,912,16,10,6
14,41,1180,7,1,6
14,41,895,17,10,7
14,41,1048,3,1,2
14,41,922,39,16,23
14,41,1933,20,11,9
14,41,3549,67,34,33
14,41,1384,47,29,18
14,41,1450,19,13,6
14,41,1208,12,4,8
14,41,1684,37,15,22
14,41,1874,42,14,28
14,41,1116,17,6,11
14,41,1041,13,4,9
14,41,839,15,7,8
14,41,1102,10,7,3
14,41,408,5,3,2
14,41,848,15,8,7
14,41,1151,4,2,2
14,41,1368,14,5,9
14,41,471,4,2,2
14,41,1450,3,1,2
14,41,1184,2,2,0
14,41,1011,4,2,2
14,41,1077,3,3,0
14,41,1055,4,3,1
14,41,975,11,6,5
14,41,1329,9,7,2
14,41,819,9,2,7
14,41,1033,12,4,8
14,41,896,15,6,9
14,41,907,15,3,12
14,41,1416,1,1,0
14,41,1281,41,19,22
14,41,1169,15,10,5
14,41,1131,1,0,1
14,41,1239,6,3,3
14,41,946,86,47,39
14,41,1055,76,36,40
14,41,795,39,18,21
14,41,876,4,2,2
14,41,1672,37,19,18
14,41,741,55,27,28
14,41,1299,11,5,6
14,41,1295,15,7,8
14,41,1411,38,19,19
14,41,1408,30,18,12
14,41,1895,68,34,34
14,41,1147,19,12,7
14,41,619,5,2,3
14,41,527,6,3,3
14,41,941,7,2,5
14,41,817,3,2,1
14,41,1062,17,7,10
14,41,1021,8,6,2
14,41,838,6,3,3
14,41,1069,1,0,1
14,41,1258,23,11,12
14,41,1500,21,11,10
14,41,1207,9,3,6
14,41,1146,6,3,3
14,41,936,18,4,14
14,41,1258,9,4,5
14,41,534,0,0,0
14,41,532,9,5,4
14,41,592,1,0,1
14,41,528,3,2,1
14,41,807,141,71,70
14,41,658,10,6,4
14,41,3027,150,86,64
14,41,2376,14,6,8
14,41,2027,21,6,15
14,41,1421,51,26,25
14,41,1367,23,9,14
14,41,3322,30,15,15
14,41,9853,986,515,471
14,41,4467,485,244,241
14,41,2133,24,12,12
14,41,3879,208,90,118
14,41,4951,28,11,17
14,41,3041,5,2,3
14,41,1747,66,30,36
14,41,3525,28,11,17
14,41,2831,6,4,2
14,41,1586,12,7,5
14,41,1367,8,6,2
14,41,2482,15,7,8
14,41,2861,22,10,12
14,41,2428,24,13,11
14,41,3158,23,9,14
14,41,2801,25,14,11
14,41,2845,6,4,2
14,41,1658,4,3,1
14,41,1447,8,5,3
14,41,926,7,5,2
14,41,2662,17,12,5
14,41,2305,205,93,112
14,41,1522,49,18,31
14,41,3180,13,6,7
14,41,3007,35,18,17
14,41,2421,82,42,40
14,41,2015,11,4,7
14,41,2091,8,6,2
14,41,1590,6,4,2
14,41,1034,11,7,4
14,41,1558,29,16,13
14,41,6503,254,137,117
14,41,1084,10,5,5
14,41,923,5,3,2
14,41,2096,37,21,16
14,41,1381,6,3,3
14,41,1133,9,4,5
14,41,1218,23,14,9
14,41,1089,1,0,1
14,41,1051,2,0,2
14,41,3073,20,11,9
14,41,2190,44,24,20
14,41,2113,5,5,0
14,41,2047,2,1,1
14,41,1780,24,13,11
14,41,2530,26,10,16
14,41,1838,6,3,3
14,41,1358,0,0,0
14,41,1272,18,6,12
14,41,3382,145,79,66
14,41,2037,6,2,4
14,41,2135,10,5,5
14,41,1526,13,3,10
14,41,1115,9,5,4
14,41,3778,408,191,217
14,41,5309,135,76,59
14,41,2993,83,40,43
14,41,1295,2,1,1
14,41,1719,27,8,19
14,41,2230,112,60,52
14,41,1018,7,4,3
14,41,1051,41,21,20
14,41,2030,59,34,25
14,41,2279,23,15,8
14,41,1513,58,28,30
14,41,631,16,7,9
14,41,461,4,2,2
14,41,1536,59,25,34
14,41,3133,100,48,52
14,41,2034,45,22,23
14,41,1107,37,21,16
14,41,1057,9,6,3
14,41,1524,3,0,3
14,41,1319,0,0,0
14,41,2360,25,13,12
14,41,1664,93,51,42
14,41,1624,21,9,12
14,41,1904,35,18,17
14,41,2046,44,25,19
14,41,2070,11,5,6
14,41,1794,15,6,9
14,41,1768,10,4,6
14,41,1291,2,0,2
14,41,1218,11,4,7
14,41,1604,117,62,55
14,41,2329,127,62,65
14,41,1357,42,21,21
14,41,1637,5,3,2
14,41,1164,3,3,0
14,41,855,4,1,3
14,41,1794,11,5,6
14,41,1088,7,4,3
14,41,1064,1,0,1
14,41,1068,8,3,5
14,41,1154,15,10,5
14,41,1608,8,3,5
14,41,1469,14,9,5
14,41,1123,26,15,11
14,41,1226,4,3,1
14,41,1599,29,16,13
14,41,1731,23,12,11
14,41,1002,14,4,10
14,41,1069,11,4,7
14,41,1343,11,6,5
14,41,1411,0,0,0
14,41,1142,10,5,5
14,41,823,15,8,7
14,41,885,10,4,6
14,41,1004,2,1,1
14,41,1035,9,6,3
14,41,1425,13,5,8
14,41,1528,12,5,7
14,41,1156,2,1,1
14,41,1089,10,6,4
14,41,1826,190,110,80
14,41,1177,5,2,3
14,41,1816,30,12,18
14,41,1761,124,63,61
14,41,1066,0,0,0
14,41,1027,1,0,1
14,41,1036,0,0,0
14,41,844,14,7,7
14,41,1459,17,9,8
14,41,1051,32,10,22
14,41,1249,4,3,1
14,41,1563,8,5,3
14,41,1607,24,13,11
14,41,1557,22,11,11
14,41,1075,9,6,3
14,41,1019,47,25,22
14,41,1029,2,1,1
14,41,761,0,0,0
14,41,1612,6,3,3
14,41,1385,8,3,5
14,41,2750,4,2,2
14,41,3594,14,9,5
14,41,1701,24,10,14
14,41,2691,34,17,17
14,41,5113,16,3,13
14,41,3024,20,10,10
14,41,3156,10,3,7
14,41,1705,2,1,1
14,41,1578,8,5,3
14,41,2979,17,8,9
14,41,1503,2,1,1
14,41,1072,11,3,8
14,41,1576,12,4,8
14,41,1775,7,2,5
14,41,1454,10,4,6
14,41,1357,9,6,3
14,41,1623,12,3,9
14,41,1693,51,27,24
14,41,1949,17,8,9
14,41,1541,21,15,6
14,41,1778,8,5,3
14,41,1285,7,6,1
14,41,1289,11,6,5
14,41,1141,34,16,18
14,41,1277,30,16,14
14,41,1045,47,27,20
14,41,1348,38,14,24
14,41,1053,3,1,2
14,41,1337,30,14,16
14,41,1052,3,2,1
14,41,1433,12,6,6
14,41,1409,70,34,36
14,41,1200,22,10,12
14,41,1542,50,23,27
14,41,1506,20,9,11
14,41,1108,32,20,12
14,41,969,13,7,6
14,41,1497,5,3,2
14,41,1511,25,11,14
14,41,1062,5,2,3
14,41,743,9,5,4
14,41,1395,13,7,6
14,41,990,1,0,1
14,41,1060,4,2,2
14,41,2097,4,4,0
14,41,1307,13,7,6
14,41,1747,12,5,7
14,41,892,39,21,18
14,41,877,21,10,11
14,41,1062,625,334,291
14,41,1051,9,6,3
14,41,2843,82,39,43
14,41,1798,31,18,13
14,41,3738,27,11,16
14,41,1255,11,6,5
14,41,1367,15,10,5
14,41,1836,32,16,16
14,41,1377,19,8,11
14,41,2507,11,4,7
14,41,1256,5,1,4
14,41,2369,23,19,4
14,41,1125,1,1,0
14,41,2433,12,6,6
14,41,1072,17,8,9
14,41,1146,16,7,9
14,41,1331,20,10,10
14,41,1365,10,6,4
14,41,1327,9,6,3
14,41,1357,4,2,2
14,41,1272,6,3,3
14,41,2377,5,2,3
14,41,1045,0,0,0
14,41,1136,5,5,0
14,41,1384,536,292,244
14,41,1931,244,125,119
14,41,1615,17,5,12
14,41,2135,6,2,4
14,41,1045,1,0,1
14,41,1011,4,2,2
14,41,1156,19,9,10
14,41,1828,16,5,11
14,41,1658,36,17,19
14,41,1400,2,0,2
14,41,1158,1,1,0
14,41,1483,0,0,0
14,41,1660,6,0,6
14,41,1871,14,8,6
14,41,1226,3,2,1
14,41,1543,2,1,1
14,41,2022,15,3,12
14,41,1880,11,3,8
14,41,1098,3,2,1
14,41,1106,10,6,4
14,41,1117,17,11,6
14,41,1272,2,1,1
14,41,2753,31,18,13
14,41,1253,11,5,6
14,41,2012,24,5,19
14,41,1810,7,5,2
14,41,1214,13,6,7
14,41,1922,102,58,44
14,41,1800,3,0,3
14,41,1108,1,0,1
14,41,1324,2,1,1
14,41,2449,1,0,1
14,41,1237,6,2,4
14,41,1538,9,5,4
14,41,1333,20,7,13
14,41,3248,20,8,12
14,41,2785,6,5,1
14,41,1070,34,17,17
14,41,940,6,3,3
14,41,944,456,238,218
14,41,1105,37,17,20
14,41,1095,8,6,2
14,41,1050,3,1,2
14,41,768,10,3,7
14,41,825,6,3,3
14,41,622,3,3,0
14,41,1029,10,4,6
14,41,1118,5,3,2
14,41,2178,22,10,12
14,41,1229,7,4,3
14,41,1947,33,17,16
14,41,1420,14,3,11
14,41,1595,2,0,2
14,41,1828,4,3,1
14,41,2077,2,1,1
14,41,2092,18,7,11
14,41,2207,4,4,0
14,41,1315,9,5,4
14,41,1566,23,10,13
14,41,2348,8,6,2
14,41,1336,5,3,2
14,41,1381,6,2,4
14,41,1216,2,1,1
14,41,1068,3,2,1
14,41,1258,1,1,0
14,41,1855,18,8,10
14,41,1941,11,2,9
14,41,1696,22,10,12
14,41,1551,16,4,12
14,41,1547,8,6,2
14,41,1698,6,4,2
14,41,1855,8,4,4
14,41,1521,26,10,16
14,41,2886,15,6,9
14,41,2686,19,9,10
14,41,1793,23,11,12
14,41,2061,33,18,15
14,41,2329,75,43,32
14,41,1453,82,43,39
14,41,1667,4,1,3
14,41,1560,50,30,20
14,41,1914,1,0,1
14,41,1778,1,0,1
14,41,2002,12,4,8
14,41,8223,82,44,38
14,41,1025,2,0,2
14,41,2230,28,14,14
14,41,1413,3,3,0
14,41,1382,6,2,4
14,41,907,44,24,20
14,41,1573,33,18,15
14,41,834,5,3,2
14,41,1146,3,1,2
14,41,1320,19,6,13
14,41,1086,7,5,2
14,41,1241,75,36,39
14,41,863,5,2,3
14,41,1394,14,9,5
14,41,1988,32,18,14
14,41,1413,8,4,4
14,41,1121,6,2,4
14,41,1106,1,0,1
14,41,1177,5,1,4
14,41,3286,54,28,26
14,41,3808,40,20,20
14,41,1887,7,1,6
14,41,1236,4,4,0
14,41,1319,5,2,3
14,41,985,11,4,7
14,41,1198,5,1,4
14,41,911,1,0,1
14,41,1147,4,3,1
14,41,1090,6,4,2
14,41,1014,14,3,11
14,41,2138,38,19,19
14,41,1423,6,4,2
14,41,1043,0,0,0
14,41,1911,43,17,26
14,41,1451,17,8,9
14,41,1063,1,0,1
14,41,1178,6,3,3
14,41,1239,1,1,0
14,41,1061,2,1,1
14,41,1258,19,9,10
14,41,836,0,0,0
14,41,1083,7,3,4
14,41,1521,9,5,4
14,41,648,15,7,8
14,41,1706,11,8,3
14,41,909,0,0,0
14,41,1066,5,4,1
14,41,1114,21,10,11
14,41,833,7,6,1
14,41,688,1,1,0
14,41,1917,10,3,7
14,41,1586,22,12,10
14,41,1305,15,5,10
14,41,908,8,4,4
14,41,1198,15,7,8
14,41,1501,5,1,4
14,41,1006,9,4,5
14,41,1281,13,4,9
14,41,1087,8,5,3
14,41,1000,15,5,10
14,41,1129,22,12,10
14,41,1601,16,7,9
14,41,1083,15,11,4
14,41,997,2,0,2
14,41,1615,194,103,91
14,42,1137,7,3,4
14,42,585,13,7,6
14,42,632,5,2,3
14,42,1262,9,6,3
14,42,1594,7,5,2
14,42,526,5,3,2
14,42,380,4,4,0
14,42,263,0,0,0
14,42,1007,0,0,0
14,42,519,2,0,2
14,42,827,2,2,0
14,43,1471,1,1,0
14,43,1644,2,1,1
14,43,1089,0,0,0
14,43,886,0,0,0
14,43,830,2,1,1
14,44,2200,0,0,0
14,44,3371,4,3,1
14,44,2243,11,8,3
14,44,441,1,0,1
14,44,203,0,0,0
14,44,120,0,0,0
14,44,1437,22,12,10
14,45,2423,9,4,5
14,45,1637,12,3,9
14,45,1107,9,3,6
14,45,931,2,1,1
14,45,961,2,0,2
14,45,1357,0,0,0
14,45,410,1,0,1
14,45,482,3,1,2
14,45,478,0,0,0
14,45,1949,6,5,1
14,45,226,4,2,2
14,45,719,3,1,2
14,45,1935,22,12,10
14,45,1095,5,0,5
14,45,2272,19,10,9
14,45,1650,6,2,4
14,45,1968,5,2,3
14,45,1620,4,1,3
14,46,4435,71,39,32
14,46,2624,9,3,6
14,46,2125,36,22,14
14,46,2984,49,27,22
14,46,20085,347,156,191
14,46,3529,153,78,75
14,46,24727,227,107,120
14,46,1443,15,10,5
14,46,2044,45,26,19
14,46,628,19,11,8
14,46,3456,36,19,17
14,47,1690,9,6,3
14,47,2212,11,4,7
14,47,3655,49,25,24
14,47,2264,19,12,7
14,47,1324,14,6,8
14,47,1309,0,0,0
14,47,1692,0,0,0
14,47,2552,86,46,40
14,47,1602,108,68,40
14,47,914,1,1,0
14,47,969,11,4,7
14,48,3850,177,94,83
14,48,1404,14,7,7
14,48,3271,6,2,4
14,48,1656,5,2,3
14,48,612,0,0,0
14,48,528,6,4,2
14,48,1277,2,1,1
14,48,5006,20,13,7
14,48,1069,0,0,0
14,48,3825,15,6,9
14,48,1799,6,3,3
14,48,2190,2,2,0
14,48,373,0,0,0
14,48,1238,11,8,3
14,48,284,4,2,2
14,48,1041,4,1,3
14,48,412,2,0,2
14,48,116,0,0,0
14,48,1023,19,6,13
14,48,170,1,0,1
14,48,1384,3,1,2
14,48,140,0,0,0
14,49,3819,45,25,20
14,49,3278,100,45,55
14,49,1499,12,7,5
14,49,3174,43,18,25
14,49,2482,45,23,22
14,49,1015,4,3,1
14,49,2175,99,47,52
14,49,1183,10,4,6
14,49,3053,6,4,2
14,49,2169,39,18,21
14,49,606,130,28,102
14,49,643,0,0,0
14,50,1540,14,6,8
14,50,1767,10,6,4
14,50,3124,12,4,8
14,50,1812,31,17,14
14,50,2934,10,3,7
14,50,163,1,1,0
14,50,669,1,0,1
14,50,921,0,0,0
14,50,2270,4,1,3
14,50,627,0,0,0
14,50,433,2,1,1
14,50,1014,0,0,0
14,50,590,22,12,10
14,50,1064,6,4,2
14,51,1924,3,1,2
14,51,260,3,1,2
14,51,100,0,0,0
14,51,1341,2,1,1
14,51,861,0,0,0
14,51,3195,2,1,1
14,51,309,0,0,0
14,51,629,6,2,4
14,51,569,0,0,0
14,51,314,2,1,1
14,52,3683,231,126,105
14,52,2226,66,32,34
14,52,870,2,1,1
14,52,4063,120,63,57
14,52,2478,5,3,2
14,52,1405,2,0,2
14,52,4338,140,62,78
14,52,411,1,1,0
14,52,734,2,2,0
14,52,4796,205,106,99
14,52,3621,49,27,22
14,52,1832,7,2,5
14,52,2031,231,124,107
14,52,3685,11,3,8
14,52,2411,39,20,19
14,52,1278,0,0,0
14,52,2973,12,5,7
14,53,3203,14,6,8
14,53,1472,3,2,1
14,53,1571,12,4,8
14,53,3125,70,37,33
14,53,794,10,5,5
14,53,17820,191,89,102
14,53,2630,128,63,65
14,54,1613,4,1,3
14,54,748,1,1,0
14,54,1286,4,2,2
14,54,675,4,1,3
14,54,909,0,0,0
14,54,303,9,6,3
14,55,6079,52,30,22
14,55,3541,94,53,41
14,55,1921,8,3,5
14,55,845,19,11,8
14,55,4000,27,15,12
14,55,4155,26,13,13
14,55,1761,6,2,4
14,55,1743,7,3,4
14,55,1207,8,6,2
14,55,5825,40,27,13
14,55,1140,10,6,4
14,55,12273,304,154,150
14,55,2109,45,23,22
14,55,17738,127,65,62
14,55,328,2,0,2
14,55,625,0,0,0
14,55,381,1,1,0
14,55,1309,7,4,3
14,55,884,40,23,17
14,55,1285,27,12,15
14,55,855,6,3,3
14,55,905,0,0,0
14,55,511,3,1,2
14,55,137,1,1,0
14,55,527,0,0,0
14,55,370,10,5,5
14,55,1647,17,10,7
14,55,1517,14,10,4
14,55,5897,69,38,31
14,55,4119,21,9,12
14,55,1006,2,2,0
14,55,4182,20,10,10
14,55,5446,23,10,13
14,55,1911,98,43,55
14,55,7115,85,38,47
14,55,1339,5,3,2
14,55,1376,5,1,4
14,55,1135,5,2,3
14,55,978,0,0,0
14,55,797,0,0,0
14,55,856,5,3,2
14,55,91,0,0,0
14,55,702,1,1,0
14,55,320,0,0,0
14,55,2830,9,4,5
14,55,3754,269,152,117
14,55,406,0,0,0
14,55,367,0,0,0
14,55,244,0,0,0
14,55,3158,27,18,9
14,55,1363,2,0,2
14,55,277,2,1,1
14,55,1439,32,19,13
14,55,262,3,3,0
14,55,1234,12,8,4
14,55,2617,5,1,4
14,55,1316,3,2,1
14,55,1320,0,0,0
14,55,552,4,2,2
14,55,579,0,0,0
14,55,468,6,4,2
14,55,2026,4,2,2
14,55,1347,2,1,1
14,55,7293,33,15,18
14,55,374,1,1,0
14,55,6777,35,14,21
14,55,4470,25,14,11
14,55,1424,9,3,6
14,55,557,4,1,3
14,55,479,4,0,4
14,56,703,5,2,3
14,56,1042,5,2,3
14,56,1416,12,5,7
14,56,895,1,1,0
14,56,622,25,13,12
14,56,737,8,3,5
14,57,2082,8,5,3
14,57,2229,6,2,4
14,57,5671,17,9,8
14,57,3031,5,2,3
14,57,1351,1,1,0
14,57,1990,17,9,8
14,57,1625,1,0,1
14,57,1330,34,15,19
14,57,899,0,0,0
14,57,1573,10,5,5
14,58,931,9,5,4
14,58,240,0,0,0
14,58,262,0,0,0
14,58,201,0,0,0
14,58,199,0,0,0
14,59,1169,4,1,3
14,59,989,1,1,0
14,59,739,0,0,0
14,59,684,4,2,2
14,59,546,0,0,0
14,60,2754,2,0,2
14,60,1599,1,1,0
14,60,1983,10,4,6
14,60,2184,3,1,2
14,60,2064,10,5,5
14,60,390,0,0,0
14,60,489,1,0,1
14,60,710,2,1,1
14,60,444,1,1,0
14,60,184,0,0,0
14,60,367,0,0,0
14,60,416,4,2,2
14,60,862,7,3,4
14,61,3163,27,14,13
14,61,2783,7,2,5
14,61,1647,5,2,3
14,61,1560,0,0,0
14,61,1281,2,2,0
14,61,1411,10,4,6
14,61,962,2,2,0
14,61,236,0,0,0
14,61,1054,0,0,0
14,62,1563,4,4,0
14,62,1009,0,0,0
14,62,610,0,0,0
14,62,584,0,0,0
14,62,592,0,0,0
14,62,761,2,1,1
14,62,188,0,0,0
14,63,1542,32,12,20
14,63,1391,0,0,0
14,63,140,0,0,0
14,63,388,1,0,1
14,63,590,0,0,0
14,63,5654,8,4,4
14,63,3979,4,4,0
14,63,8515,822,427,395
14,64,740,5,5,0
14,64,1106,1,1,0
14,64,1559,10,5,5
14,64,233,1,0,1
14,65,5113,48,20,28
14,65,1346,10,5,5
14,65,1393,5,1,4
14,65,2788,23,7,16
14,65,3362,63,26,37
14,65,1375,14,9,5
14,65,1767,19,11,8
14,65,3067,13,6,7
14,65,6045,79,42,37
14,65,1546,33,20,13
14,65,1421,125,62,63
14,65,1267,25,10,15
14,65,1631,9,5,4
14,65,1965,16,11,5
14,65,3075,26,12,14
14,65,1821,6,3,3
14,65,807,4,2,2
14,65,757,15,6,9
14,65,825,23,11,12
14,65,693,6,3,3
14,65,1398,4,1,3
14,65,1059,7,3,4
14,65,5824,41,15,26
14,65,1023,0,0,0
14,65,5156,32,18,14
14,65,1165,17,9,8
14,65,835,9,4,5
14,65,762,9,3,6
14,65,1772,4,1,3
14,65,2021,29,14,15
14,65,1945,7,3,4
14,65,8764,48,28,20
14,65,9873,116,63,53
14,65,5139,6,2,4
14,65,3700,11,7,4
14,65,4896,13,6,7
14,65,667,5,2,3
14,65,1184,7,2,5
14,65,1272,0,0,0
14,65,1195,0,0,0
14,65,897,1,1,0
14,65,3379,4,3,1
14,66,3106,2,2,0
14,66,3586,1,0,1
14,66,2467,7,3,4
14,66,5280,37,16,21
14,66,1745,1,0,1
14,66,833,2,0,2
14,66,4807,35,14,21
14,66,1793,0,0,0
14,66,727,1,1,0
14,66,2077,1,1,0
14,66,2529,2,1,1
14,66,1332,1,0,1
14,66,529,1,0,1
14,66,1147,3,2,1
14,66,1630,0,0,0
14,67,1410,0,0,0
14,67,1085,9,3,6
14,67,1327,23,10,13
14,67,1128,1,0,1
14,67,1206,4,1,3
14,67,988,2,1,1
14,67,1352,0,0,0
14,67,1202,0,0,0
14,67,788,3,2,1
14,67,323,0,0,0
14,67,401,2,1,1
14,67,463,0,0,0
14,68,755,2,2,0
14,68,3674,7,4,3
14,68,1697,3,3,0
14,68,785,5,3,2
14,68,2089,82,35,47
14,68,2070,120,61,59
14,68,3549,7,3,4
14,68,1962,3,0,3
14,68,1202,16,10,6
14,68,3205,13,7,6
14,68,2650,76,38,38
14,68,4600,188,86,102
14,68,2670,87,43,44
14,68,2575,2,1,1
14,68,3030,9,2,7
14,68,3366,6,5,1
14,68,1210,0,0,0
14,68,7832,231,125,106
14,68,2121,7,2,5
14,68,2640,28,18,10
14,69,1752,17,5,12
14,69,21507,472,236,236
14,69,75,7,0,7
14,69,1644,27,12,15
14,69,2429,47,23,24
14,69,1190,62,23,39
14,69,527,2,1,1
14,69,24524,196,84,112
14,69,5874,144,70,74
14,69,8610,126,47,79
14,69,1771,7,4,3
14,69,3064,85,45,40
14,69,8466,160,71,89
14,69,2870,30,12,18
14,69,2209,38,17,21
14,69,8371,44,25,19
14,69,4620,33,17,16
14,69,2131,27,18,9
14,69,1341,13,8,5
14,69,2065,55,27,28
14,69,2541,83,34,49
14,69,6301,274,145,129
14,69,3604,86,40,46
14,69,7082,149,62,87
14,69,9071,279,146,133
14,69,2222,98,47,51
14,69,812,8,6,2
14,69,1706,41,15,26
14,69,1951,45,18,27
14,69,3824,40,18,22
14,69,1899,67,29,38
14,69,964,15,8,7
14,69,11041,69,36,33
14,69,3461,17,10,7
14,69,3994,24,11,13
14,69,1828,12,3,9
14,69,2313,110,54,56
14,69,1907,17,5,12
14,69,2084,46,28,18
14,69,819,14,7,7
14,69,1115,11,2,9
14,69,485,0,0,0
14,69,949,4,1,3
14,69,1287,30,13,17
14,69,591,57,30,27
14,69,1374,79,38,41
14,69,694,40,17,23
14,69,576,4,1,3
14,69,2490,23,9,14
14,69,1544,360,164,196
14,69,1362,7,5,2
14,69,843,21,14,7
14,69,436,2,2,0
14,69,2079,63,25,38
14,69,845,10,4,6
14,69,513,4,2,2
14,69,3768,89,42,47
14,69,1207,46,29,17
14,69,2343,75,40,35
14,69,1770,15,9,6
14,69,4007,73,38,35
14,69,11811,198,92,106
14,69,5362,97,50,47
14,69,24157,540,265,275
14,69,4277,67,35,32
14,69,10275,310,157,153
14,69,924,119,42,77
14,69,2521,32,13,19
14,70,1271,9,3,6
14,70,1283,0,0,0
14,70,1515,3,3,0
14,70,2181,12,6,6
14,70,1438,3,1,2
14,70,252,0,0,0
14,70,1008,7,4,3
14,70,1560,9,6,3
14,70,845,1,1,0
14,71,1072,13,5,8
14,71,1633,1,0,1
14,71,401,8,3,5
14,71,804,6,2,4
14,71,451,6,2,4
14,71,274,5,4,1
14,71,1341,3,1,2
14,71,640,0,0,0
14,71,193,4,3,1
14,71,251,0,0,0
14,71,301,0,0,0
14,71,468,3,3,0
14,72,27234,538,98,440
14,72,5472,63,27,36
14,72,1207,1,0,1
14,72,2908,51,26,25
14,72,1626,99,53,46
14,72,1071,53,31,22
14,72,31911,319,147,172
14,72,3507,24,14,10
14,72,1624,29,13,16
14,72,2038,8,4,4
14,72,3079,11,5,6
14,72,18617,146,72,74
14,72,10648,49,29,20
14,72,3154,39,24,15
14,72,8246,47,22,25
14,72,4717,25,9,16
14,72,5799,125,64,61
14,72,5877,87,38,49
14,72,3212,6,1,5
14,72,15485,198,97,101
14,72,24394,305,145,160
14,72,3038,2,1,1
14,72,3161,1042,528,514
14,72,2237,8,6,2
14,72,15586,108,54,54
14,72,26814,292,147,145
14,73,1204,0,0,0
14,73,337,0,0,0
14,73,959,2,1,1
14,73,168,0,0,0
14,73,279,0,0,0
14,74,4221,15,10,5
14,74,1610,2,1,1
14,74,644,0,0,0
14,74,504,0,0,0
14,74,160,0,0,0
14,74,201,0,0,0
14,74,256,1,1,0
14,75,1946,2,0,2
14,75,1028,11,6,5
14,75,6542,25,14,11
14,75,10778,61,27,34
14,75,4071,31,16,15
14,75,1150,0,0,0
14,75,586,3,0,3
14,75,1728,14,7,7
14,75,640,3,0,3
14,75,1543,11,6,5
14,75,2632,3,0,3
14,75,3360,44,23,21
14,75,4647,17,8,9
14,75,992,1,1,0
14,75,1595,26,14,12
14,75,4675,20,7,13
14,75,314,0,0,0
14,75,1021,5,4,1
14,75,509,0,0,0
14,75,1141,14,4,10
14,75,1315,0,0,0
14,75,574,2,1,1
14,75,597,3,1,2
14,75,1140,9,4,5
14,75,498,0,0,0
14,75,298,0,0,0
14,75,335,1,0,1
14,75,422,0,0,0
14,75,727,0,0,0
14,75,5448,15,6,9
14,75,3039,12,7,5
14,75,27,0,0,0
14,75,235,0,0,0
14,76,681,0,0,0
14,76,3335,18,9,9
14,76,2949,49,27,22
14,76,1588,3,3,0
14,76,3196,8,3,5
14,76,1821,12,3,9
14,76,2506,37,16,21
14,76,211,0,0,0
14,76,494,2,0,2
14,77,1809,35,15,20
14,77,1982,58,21,37
14,78,1015,0,0,0
14,78,1556,2,1,1
14,78,276,0,0,0
14,78,151,0,0,0
14,78,97,0,0,0
14,79,2166,4,1,3
14,79,1658,35,20,15
14,79,2524,31,10,21
14,79,2695,6,3,3
14,79,1124,0,0,0
14,79,1746,2,0,2
14,79,1182,0,0,0
14,79,1279,1,0,1
14,79,1367,2,0,2
14,79,3552,11,7,4
14,79,2459,2,2,0
14,79,1350,2,1,1
14,79,971,0,0,0
14,79,741,0,0,0
14,79,869,0,0,0
14,79,1744,7,3,4
14,79,525,20,7,13
14,80,2768,4,1,3
14,80,5063,31,17,14
14,80,1707,27,15,12
14,80,2058,50,24,26
14,80,1852,27,12,15
14,80,1769,4,1,3
14,80,3909,25,9,16
14,80,2624,15,6,9
14,80,4854,26,13,13
14,80,120,0,0,0
14,80,1292,13,5,8
14,80,995,4,3,1
14,80,565,3,3,0
14,80,361,1,0,1
14,80,1039,5,2,3
14,80,444,4,3,1
14,80,1815,12,7,5
14,81,822,0,0,0
14,81,682,0,0,0
14,81,233,0,0,0
14,81,1437,3,0,3
14,81,606,5,3,2
14,81,580,1,1,0
14,81,726,4,1,3
14,82,530,1,1,0
14,82,1089,7,0,7
14,82,541,2,0,2
14,82,865,0,0,0
14,82,490,1,0,1
14,83,2811,45,25,20
14,83,2988,25,12,13
14,83,1895,29,17,12
14,83,1583,8,4,4
14,83,1622,6,3,3
14,83,238,3,3,0
14,83,2799,7,2,5
14,83,1258,9,5,4
14,83,774,3,1,2
14,83,2755,23,12,11
14,83,779,10,2,8
14,83,3120,26,16,10
14,83,1470,13,5,8
14,83,4329,88,44,44
14,83,1647,33,16,17
14,83,1977,6,3,3
14,83,2346,0,0,0
14,83,2433,26,15,11
14,83,547,1,0,1
14,84,5255,101,56,45
14,84,6120,147,74,73
14,84,3577,45,22,23
14,84,1019,61,32,29
14,84,2850,43,21,22
14,84,1251,4,2,2
14,84,3748,10,2,8
14,84,1389,10,4,6
14,84,3056,7,5,2
14,84,1838,17,8,9
14,84,1046,35,20,15
14,84,1363,0,0,0
14,84,1190,36,22,14
14,84,2239,3,2,1
14,84,749,4,2,2
14,84,2608,2,0,2
14,84,1416,2,2,0
14,84,3123,245,125,120
14,84,1825,438,225,213
14,84,2196,33,21,12
14,84,1160,2,0,2
14,84,1227,3,1,2
14,84,18825,571,289,282
14,84,1945,1,0,1
14,84,2501,7,4,3
14,84,2204,4,3,1
14,84,2358,22,10,12
14,84,2379,37,12,25
14,84,1505,9,3,6
14,84,4772,16,4,12
14,84,857,0,0,0
14,85,3042,15,6,9
14,85,3269,15,8,7
14,85,4008,14,6,8
14,85,902,0,0,0
14,85,724,2,1,1
14,85,465,0,0,0
14,85,46,0,0,0
14,85,224,0,0,0
14,85,1234,2,1,1
14,85,315,0,0,0
14,85,768,8,5,3
14,86,2936,30,18,12
14,86,2031,10,3,7
14,86,688,1,0,1
14,86,1223,19,9,10
14,86,1153,15,7,8
14,86,1328,21,8,13
14,86,1056,0,0,0
14,86,2530,1,0,1
14,86,573,2,0,2
14,86,836,36,21,15
14,86,798,16,7,9
14,86,1528,70,36,34
14,86,537,0,0,0
14,86,734,3,1,2
14,86,1530,7,2,5
14,86,2154,4,1,3
14,86,1730,16,5,11
14,86,93,0,0,0
14,86,402,0,0,0
14,86,474,0,0,0
14,86,2377,7,6,1
14,86,90,0,0,0
14,86,725,9,6,3
14,86,1690,3,0,3
14,86,1027,6,3,3
14,86,225,7,2,5
14,86,241,0,0,0
14,86,525,18,8,10
14,86,337,256,129,127
14,86,1422,12,7,5
14,86,1692,19,11,8
14,86,1413,113,49,64
14,86,2316,5,2,3
14,86,307,6,4,2
14,86,444,33,17,16
14,87,3410,14,6,8
14,87,1235,15,5,10
14,87,2491,17,10,7
14,87,2020,0,0,0
14,87,5099,9,4,5
14,87,2287,3,2,1
14,87,406,0,0,0
14,87,3513,8,4,4
14,87,615,1,0,1
14,88,617,0,0,0
14,88,1523,1,1,0
14,88,3078,25,18,7
14,88,561,10,5,5
14,88,237,6,3,3
14,88,1877,40,0,40
14,88,1119,10,4,6
14,88,964,4,3,1
14,88,1325,6,1,5
14,88,179,2,1,1
14,88,3739,3,3,0
14,88,403,0,0,0
14,88,196,1,0,1
14,88,173,2,1,1
14,88,83,0,0,0
14,88,319,0,0,0
14,89,2660,6,1,5
14,89,1307,6,3,3
14,89,1238,8,2,6
14,89,3508,39,15,24
14,89,1249,4,2,2
14,89,656,2,1,1
14,89,422,1,0,1
14,89,1025,3,2,1
14,89,940,0,0,0
14,89,1199,1,0,1
14,89,257,0,0,0
14,89,1731,18,10,8
14,89,395,1,0,1
14,90,1276,7,2,5
14,90,1636,0,0,0
14,90,1117,1,0,1
14,91,1963,11,2,9
14,91,2224,14,4,10
14,91,1102,7,5,2
14,91,815,1,1,0
14,91,139,0,0,0
14,91,1017,3,1,2
14,92,3068,409,209,200
14,92,3879,37,18,19
14,92,1183,10,6,4
14,92,670,2,1,1
14,92,1010,243,136,107
14,92,421,3,1,2
14,92,1609,5,2,3
14,92,331,6,3,3
14,92,1680,7,3,4
14,92,3906,28,19,9
14,92,915,0,0,0
14,92,7021,74,36,38
14,92,2309,4,1,3
14,92,2796,1,1,0
14,92,732,5,3,2
14,92,1013,7,6,1
14,92,1723,3,2,1
14,92,1588,7,4,3
14,92,1138,1,0,1
14,92,1001,2,1,1
14,92,417,1,0,1
14,92,1254,1,0,1
14,92,153,0,0,0
14,93,1750,70,34,36
14,93,1187,4,1,3
14,93,992,6,5,1
14,93,696,5,4,1
14,93,1203,3,1,2
14,93,775,0,0,0
14,93,656,0,0,0
14,93,1069,1,0,1
14,93,1085,6,4,2
14,93,1626,3,1,2
14,94,3250,18,9,9
14,94,3718,125,76,49
14,94,3149,338,178,160
14,94,3545,73,41,32
14,94,8399,42,21,21
14,94,1557,4,4,0
14,94,2313,215,111,104
14,94,1719,1,1,0
14,94,2198,17,5,12
14,94,1178,0,0,0
14,94,1189,2,1,1
14,94,4066,80,43,37
14,94,7278,78,42,36
14,94,4667,12,5,7
14,94,3658,28,3,25
14,94,1634,27,15,12
14,94,2270,8,2,6
14,94,7624,526,261,265
14,94,1608,279,140,139
14,94,1586,6,4,2
14,94,4910,89,53,36
14,94,15549,189,90,99
14,94,5017,13,8,5
14,94,4722,72,40,32
14,94,8539,349,169,180
14,94,1712,3,1,2
14,94,2444,4,2,2
14,94,1405,1,0,1
14,94,473,0,0,0
14,94,3408,20,12,8
14,94,3552,2,2,0
14,94,5146,11,7,4
14,94,3144,22,14,8
14,94,1872,21,12,9
14,94,1119,19,14,5
14,94,2298,8,4,4
14,94,320,2,1,1
14,94,1642,1,0,1
14,94,231,0,0,0
14,94,500,4,3,1
14,94,1846,10,4,6
14,94,625,1,1,0
14,94,1374,1,0,1
14,94,784,8,4,4
14,94,1270,1,0,1
14,94,823,2,1,1
14,94,719,3,1,2
14,94,272,1,0,1
14,94,2879,8,3,5
14,94,628,1,0,1
14,94,1507,247,123,124
14,94,616,98,48,50
14,94,1095,189,99,90
14,94,1116,1,0,1
14,95,4784,48,23,25
14,95,390,1,0,1
14,95,897,3,0,3
14,95,1459,4,1,3
14,95,5196,16,6,10
14,95,1961,3,1,2
14,95,1134,5,2,3
14,95,1097,4,3,1
14,95,1624,18,8,10
14,95,1678,24,10,14
14,95,4677,14,6,8
14,95,5992,45,20,25
14,95,3343,75,42,33
14,95,383,0,0,0
14,95,613,0,0,0
14,95,372,3,1,2
14,95,2992,28,15,13
14,95,1970,9,3,6
14,95,639,0,0,0
14,95,1229,45,30,15
14,95,385,0,0,0
14,95,1532,14,8,6
14,96,2378,46,24,22
14,96,1562,18,9,9
14,96,827,0,0,0
14,96,653,0,0,0
14,96,1650,13,6,7
14,96,2457,8,3,5
14,97,3728,50,24,26
14,97,1801,4,2,2
14,97,1365,3,1,2
14,97,816,7,5,2
14,97,1097,3,1,2
14,97,2090,53,35,18
14,97,1153,4,0,4
14,97,1121,8,6,2
14,97,2588,5,2,3
14,97,1041,17,13,4
14,97,1775,2,2,0
14,97,3140,0,0,0
14,97,563,6,3,3
14,97,736,3,0,3
14,98,3229,10,7,3
14,98,4550,53,21,32
14,98,1487,14,3,11
14,98,1258,20,9,11
14,98,1905,32,18,14
14,98,1762,16,12,4
14,98,19681,243,123,120
14,98,11604,598,301,297
14,98,3033,71,35,36
14,98,5145,33,19,14
14,98,4655,26,12,14
14,98,8488,35,21,14
14,98,12887,33,21,12
14,98,4993,46,22,24
14,98,18606,88,47,41
14,98,3341,15,9,6
14,98,2720,16,10,6
14,98,4164,4,4,0
14,98,2938,13,7,6
14,98,4187,19,6,13
14,98,2322,17,8,9
14,98,4223,35,18,17
14,98,4292,21,9,12
14,98,2618,38,25,13
14,98,17085,1303,645,658
14,98,7657,29,14,15
14,98,2929,7,6,1
14,98,2633,13,9,4
14,99,2559,16,9,7
14,99,797,1,1,0
14,99,935,13,5,8
14,99,959,53,27,26
14,99,1430,32,14,18
14,99,1130,25,15,10
14,99,788,1,1,0
14,99,810,2,0,2
14,99,850,3,0,3
14,99,1695,7,2,5
14,99,1383,8,3,5
14,99,1423,4,0,4
14,99,1159,2,1,1
14,99,4065,44,26,18
14,99,2797,5,3,2
14,99,1809,13,5,8
14,99,836,16,7,9
14,99,1281,9,4,5
14,99,1575,5,3,2
14,99,802,10,5,5
14,99,405,32,18,14
14,99,705,10,6,4
14,99,955,3,1,2
14,99,872,1,0,1
14,99,2165,51,17,34
14,99,855,0,0,0
14,99,1087,4,1,3
14,99,1305,6,4,2
14,99,1502,20,10,10
14,99,1030,1,1,0
14,99,1374,19,7,12
14,99,1351,27,10,17
14,99,1231,27,11,16
14,99,1888,86,38,48
14,99,1922,21,11,10
14,99,1639,16,8,8
14,99,1612,3,0,3
14,99,2163,7,2,5
14,99,1345,12,3,9
14,99,1753,15,8,7
14,99,2059,7,4,3
14,99,675,0,0,0
14,99,928,16,6,10
14,99,1035,28,12,16
14,99,1448,7,3,4
14,99,1449,14,6,8
14,99,4180,37,22,15
14,99,1819,14,7,7
14,99,952,6,3,3
14,99,1047,3,1,2
14,99,5672,257,130,127
14,99,5287,57,29,28
14,99,2174,14,3,11
14,99,4445,28,15,13
14,99,1908,8,3,5
14,99,4949,68,33,35
14,99,3855,28,10,18
14,99,7346,22,8,14
14,99,1846,33,17,16
14,99,4394,67,30,37
14,99,2083,86,45,41
14,99,2056,39,23,16
14,99,1761,5,3,2
14,99,2754,8,6,2
14,99,4802,103,61,42
14,99,2780,9,4,5
14,99,4813,29,11,18
14,99,6473,25,11,14
14,99,2355,20,10,10
14,99,3001,34,17,17
14,99,3276,15,7,8
14,99,4073,16,10,6
14,99,3706,21,3,18
14,99,3420,12,8,4
14,99,2644,12,8,4
14,99,7618,1114,592,522
14,99,3066,28,15,13
14,99,2416,29,14,15
14,99,1661,26,11,15
14,99,2125,7,4,3
14,99,2684,54,23,31
14,99,3322,30,16,14
14,99,2382,83,43,40
14,99,12885,89,45,44
14,99,4509,13,5,8
14,99,3171,5,4,1
14,99,3906,7,3,4
14,99,2769,2,0,2
14,99,1516,2,1,1
14,99,16677,330,161,169
14,99,14094,250,123,127
14,99,27282,424,212,212
14,99,4794,108,53,55
14,99,4373,85,41,44
14,99,13122,68,37,31
14,99,7380,59,25,34
14,99,4687,39,21,18
14,99,2040,22,13,9
14,99,804,4,3,1
14,99,672,1,0,1
14,99,948,7,4,3
14,99,1249,1,1,0
14,99,1114,6,3,3
14,99,2682,31,21,10
14,99,2468,31,13,18
14,99,2412,9,6,3
14,99,1312,34,17,17
14,99,4967,65,38,27
14,99,1263,16,10,6
14,99,2381,25,13,12
14,99,4531,32,16,16
14,99,2685,17,7,10
14,99,3580,277,149,128
14,99,6430,50,23,27
14,99,12370,119,70,49
14,99,6137,415,207,208
14,99,3434,26,13,13
14,99,4785,33,20,13
14,99,3164,11,9,2
14,99,6282,65,39,26
14,99,3068,64,35,29
14,99,5720,28,20,8
14,99,5607,23,12,11
14,99,5758,63,39,24
14,99,4283,6,2,4
14,99,3365,2,1,1
14,41,1395,105,53,52
14,41,1448,3,1,2
14,99,2289,66,37,29
14,99,3873,93,44,49
14,99,3915,14,7,7
14,99,6343,37,12,25
14,99,8205,103,45,58
14,99,5210,197,94,103
14,99,1199,10,5,5
14,99,2082,34,16,18
14,99,1404,70,36,34
14,99,4908,54,24,30
14,99,1196,8,5,3
14,99,11820,136,62,74
14,99,10724,362,172,190
14,99,16201,198,100,98
14,99,12690,138,59,79
14,99,6025,46,22,24
14,99,21871,354,164,190
14,99,5260,192,89,103
14,99,7083,116,63,53
14,99,1361,14,6,8
14,99,2520,34,14,20
14,99,7250,58,29,29
14,100,1089,1,0,1
14,100,2201,34,16,18
14,100,907,1,1,0
14,100,1207,13,7,6
14,100,2428,13,7,6
14,100,2563,14,8,6
14,100,725,5,3,2
14,101,1931,29,11,18
14,101,2074,9,5,4
14,101,3910,17,7,10
14,101,2354,4,2,2
14,101,1656,0,0,0
14,101,1773,1,1,0
14,101,2091,6,1,5
14,101,1954,14,4,10
14,101,707,18,9,9
14,101,2267,39,22,17
14,101,4471,212,91,121
14,101,1731,4,4,0
14,101,217,1,0,1
14,101,1432,4,2,2
14,101,1133,0,0,0
14,101,3161,21,11,10
14,101,3397,89,46,43
14,102,7243,81,35,46
14,102,9018,45,23,22
14,102,2778,22,12,10
14,102,1981,11,6,5
14,102,2423,14,6,8
14,102,2598,19,11,8
14,102,3664,27,14,13
14,102,4671,25,13,12
14,102,1842,21,15,6
14,102,2209,17,9,8
14,102,15655,221,115,106
14,102,16523,171,78,93
14,102,11323,264,118,146
14,102,7260,67,32,35
14,102,6360,57,30,27
14,102,3795,209,94,115
14,102,2653,21,10,11
14,102,2725,7,4,3
14,102,5879,16,12,4
14,102,1982,4,1,3
14,102,3731,35,14,21
14,102,3489,141,70,71
14,102,2022,32,16,16
14,102,1939,6,4,2
14,102,2882,14,5,9
14,102,23995,139,62,77
14,102,26990,159,84,75
14,102,20990,203,95,108
14,102,3394,25,12,13
14,102,9794,138,68,70
14,102,4712,200,93,107
14,102,4459,37,18,19
14,102,4965,224,111,113
14,102,8661,84,39,45
14,102,13265,116,56,60
14,102,2880,13,0,13
14,102,6965,221,107,114
14,102,1901,4,1,3
14,102,1048,6,1,5
14,102,1346,2,0,2
14,102,1396,23,14,9
14,102,5216,31,14,17
14,102,1682,8,1,7
14,102,4886,32,16,16
14,102,1814,1,1,0
14,102,27909,276,130,146
14,102,1700,0,0,0
14,102,11488,343,174,169
14,102,2618,12,6,6
14,102,1789,28,13,15
14,102,1887,21,9,12
14,102,4547,14,8,6
14,102,4133,11,7,4
14,102,3965,46,26,20
14,102,2053,12,6,6
14,102,1186,15,9,6
14,102,1394,17,7,10
14,102,11021,181,79,102
14,102,2171,27,14,13
14,102,12890,600,308,292
14,102,9371,117,65,52
14,102,14537,137,63,74
14,102,4641,16,7,9
14,102,2232,13,8,5
14,102,2724,44,22,22
14,102,2147,17,6,11
14,102,4965,56,24,32
14,102,6935,96,41,55
14,102,3925,22,12,10
14,102,3551,28,14,14
14,102,4327,19,7,12
14,102,27933,133,70,63
14,102,20107,777,375,402
14,102,7305,689,332,357
14,102,12323,205,109,96
14,102,1966,157,78,79
14,102,7828,76,39,37
14,102,8224,50,33,17
14,102,38150,299,135,164
14,102,14263,150,78,72
14,103,1558,4,2,2
14,103,1463,4,3,1
14,103,1208,1,0,1
14,103,742,3,1,2
14,103,976,7,3,4
14,104,703,1,0,1
14,104,666,3,3,0
14,104,1002,5,3,2
14,104,1013,6,3,3
14,104,1063,3,2,1
14,104,2668,29,10,19
14,104,408,2,0,2
14,105,1165,6,3,3
14,105,810,1,0,1
14,105,267,1,0,1
14,105,111,0,0,0
14,105,296,0,0,0
14,105,1525,4,1,3
14,106,3048,13,9,4
14,106,5920,49,17,32
14,106,2689,33,18,15
14,106,1495,5,4,1
14,106,1133,12,7,5
14,106,940,3,1,2
14,106,584,35,14,21
14,106,647,3,0,3
14,106,1439,14,6,8
14,106,1039,6,3,3
14,106,665,0,0,0
14,106,1486,12,10,2
14,106,621,1,0,1
14,106,2014,0,0,0
14,107,1305,0,0,0
14,107,638,0,0,0
14,107,1870,15,10,5
14,107,389,0,0,0
14,107,1294,0,0,0
14,108,1600,20,9,11
14,108,2340,9,3,6
14,108,1603,6,4,2
14,108,894,8,4,4
14,109,2621,96,49,47
14,109,1072,3,1,2
14,109,2985,3,2,1
14,109,2929,30,16,14
14,109,890,1,0,1
14,109,301,1,0,1
14,109,2365,6,3,3
14,109,2552,216,105,111
14,109,1291,118,58,60
14,109,1158,4,1,3
14,109,496,0,0,0
14,109,5353,162,56,106
14,109,3097,17,11,6
14,109,687,1,0,1
14,109,964,6,3,3
14,109,2647,21,11,10
14,109,844,13,2,11
14,109,335,4,3,1
14,109,879,6,4,2
14,109,1642,3,1,2
14,109,1385,3,1,2
14,109,415,1,1,0
14,109,454,1,1,0
14,110,5299,17,8,9
14,110,819,10,7,3
14,110,2916,62,33,29
14,110,1353,7,5,2
14,110,688,25,14,11
14,110,717,6,4,2
14,110,2886,56,30,26
14,110,979,12,7,5
14,110,227,0,0,0
14,110,2855,34,15,19
14,111,2371,7,3,4
14,111,2535,3,2,1
14,111,658,0,0,0
14,111,1360,7,4,3
14,111,1055,9,4,5
14,111,945,2,0,2
14,111,1441,14,8,6
14,111,1061,20,13,7
14,111,805,5,2,3
14,111,525,1,1,0
14,111,570,0,0,0
14,111,484,3,2,1
14,112,3006,9,4,5
14,112,1255,0,0,0
14,112,1243,4,2,2
14,112,307,0,0,0
14,112,247,2,0,2
14,112,298,1,1,0
14,112,222,0,0,0
14,113,843,1,1,0
14,113,1250,3,1,2
14,113,3225,18,11,7
14,113,145,0,0,0
14,113,663,1,1,0
14,114,4039,37,13,24
14,114,2334,2,1,1
14,114,2544,3,2,1
14,114,1698,0,0,0
14,114,956,3,0,3
14,114,1400,1,0,1
14,114,1293,1,1,0
14,114,385,5,1,4
14,114,1479,1,1,0
14,114,2893,25,8,17
14,115,951,2,1,1
14,115,780,7,3,4
14,115,1419,0,0,0
14,115,1416,1,1,0
14,115,119,0,0,0
14,115,409,0,0,0
14,115,349,0,0,0
14,115,71,0,0,0
14,116,5686,32,18,14
14,116,2337,14,6,8
14,116,3098,25,11,14
14,116,4398,17,7,10
14,116,961,4,4,0
14,116,899,0,0,0
14,116,626,3,2,1
14,116,2083,1,0,1
14,117,868,3,1,2
14,117,1319,6,3,3
14,117,891,0,0,0
14,117,789,2,0,2
14,117,168,0,0,0
14,117,255,3,1,2
14,117,161,0,0,0
14,118,1606,5,4,1
14,118,1027,15,10,5
14,118,1083,2,0,2
14,118,1325,2,2,0
14,118,680,69,32,37
14,118,2208,26,15,11
14,118,1658,16,9,7
14,118,2499,9,4,5
14,118,1137,0,0,0
14,118,3756,33,15,18
14,118,361,0,0,0
14,118,304,0,0,0
14,118,1037,11,6,5
14,118,463,0,0,0
14,118,123,0,0,0
14,118,1477,5,3,2
14,118,583,0,0,0
14,118,507,2,1,1
14,118,197,1,1,0
14,118,363,3,1,2
14,119,2646,6,2,4
14,119,1483,20,10,10
14,119,1549,31,19,12
14,119,3105,18,7,11
14,119,1662,1,0,1
14,119,3524,18,9,9
14,119,3660,38,16,22
14,119,1864,38,22,16
14,119,2177,21,12,9
14,119,1582,5,2,3
14,119,1195,6,3,3
14,119,1442,3,2,1
14,119,721,7,6,1
14,119,659,2,2,0
14,119,1798,9,3,6
14,119,1424,1,0,1
14,120,1408,12,4,8
14,120,1294,4,1,3
14,120,2827,29,13,16
14,120,1560,3,2,1
14,120,1049,3,2,1
14,120,1575,13,8,5
14,120,1603,10,6,4
14,120,1340,2,1,1
14,120,1537,34,21,13
14,120,1630,2,2,0
14,120,1958,42,24,18
14,120,1424,10,4,6
14,120,866,7,4,3
14,120,1190,6,3,3
14,120,692,8,6,2
14,120,8650,154,84,70
14,120,1091,21,10,11
14,120,1797,124,69,55
14,120,2203,203,107,96
14,120,1216,24,15,9
14,120,1947,19,11,8
14,120,1599,15,5,10
14,120,1473,9,5,4
14,120,1549,26,14,12
14,120,1922,8,2,6
14,120,1510,2,0,2
14,120,1722,20,7,13
14,120,1260,40,18,22
14,120,1374,34,13,21
14,120,2416,30,11,19
14,120,2525,10,4,6
14,120,2263,18,9,9
14,120,2117,11,7,4
14,120,3693,32,14,18
14,120,1897,10,6,4
14,120,1623,23,6,17
14,120,1321,6,3,3
14,120,1244,3,3,0
14,120,1868,17,9,8
14,120,1343,5,3,2
14,120,1835,18,11,7
14,120,1678,6,5,1
14,120,1729,15,9,6
14,120,2026,28,16,12
14,120,956,39,25,14
14,120,2864,17,9,8
14,120,2485,95,55,40
14,120,1582,14,6,8
14,120,2365,93,40,53
14,120,4753,60,28,32
14,120,3068,9,4,5
14,120,1691,0,0,0
14,120,1647,7,4,3
14,120,1887,26,14,12
14,120,2333,14,8,6
14,120,1876,15,9,6
14,120,1757,25,12,13
14,120,1313,4,3,1
14,120,1090,2,1,1
14,120,917,41,22,19
14,120,2339,10,6,4
14,120,2661,51,29,22
14,120,2854,17,13,4
14,120,1200,21,14,7
14,120,13583,288,145,143
14,120,2276,7,3,4
14,120,3437,67,27,40
14,120,1743,29,12,17
14,120,2540,50,27,23
14,120,18539,228,109,119
14,120,2015,135,68,67
14,120,1393,28,11,17
14,120,2715,89,53,36
14,120,1618,20,11,9
14,120,1912,28,15,13
14,120,2785,34,16,18
14,120,1845,17,9,8
14,120,1918,28,15,13
14,120,4027,51,24,27
14,120,2500,21,9,12
14,120,2948,26,13,13
14,120,2094,19,12,7
14,120,3607,71,38,33
14,120,3992,30,10,20
14,120,5576,34,17,17
14,120,3795,66,33,33
14,120,3637,52,24,28
14,120,2016,20,10,10
14,120,6092,60,31,29
14,120,2020,38,17,21
14,120,2671,9,4,5
14,120,2376,9,6,3
14,120,11867,173,86,87
14,120,3122,68,33,35
14,120,2674,17,6,11
14,120,2795,55,20,35
14,120,1555,45,20,25
14,120,2114,21,11,10
14,120,3034,57,30,27
14,120,5318,286,140,146
14,120,10555,94,48,46
14,120,5206,28,18,10
14,120,4292,108,52,56
14,120,5580,31,18,13
14,120,6628,121,62,59
14,120,15910,250,140,110
14,120,13450,124,61,63
14,120,4710,373,182,191
14,120,7643,106,57,49
14,120,6579,65,34,31
14,120,4201,49,22,27
14,120,8781,111,50,61
14,120,13313,461,229,232
14,120,11241,117,54,63
14,120,16008,107,52,55
14,120,7054,28,10,18
14,120,8336,53,28,25
14,120,14051,137,59,78
14,120,19726,428,213,215
14,120,14364,111,58,53
14,120,4296,19,8,11
14,120,7048,70,30,40
14,120,17692,182,92,90
14,120,714,8,4,4
14,120,42256,786,406,380
14,120,700,7,1,6
14,120,4139,22,11,11
14,120,11654,182,90,92
14,120,2705,30,11,19
14,120,18566,1006,516,490
14,120,1441,18,8,10
14,120,1158,128,73,55
14,120,1965,1,0,1
14,120,1964,34,17,17
14,120,1925,32,17,15
14,120,1584,46,19,27
14,120,1319,7,2,5
14,120,925,14,6,8
14,120,1673,9,4,5
14,120,940,8,2,6
14,120,546,11,7,4
14,120,1257,10,5,5
14,120,4089,50,27,23
14,120,782,11,9,2
14,120,3999,66,30,36
14,120,2032,11,7,4
14,120,1380,44,20,24
14,120,1184,15,8,7
14,120,1767,5,3,2
14,120,2173,15,4,11
14,120,1360,2,1,1
14,120,1345,3,2,1
14,120,1416,3,1,2
14,120,997,3,2,1
14,120,1395,11,4,7
14,120,1329,150,84,66
14,120,918,31,14,17
14,120,2512,62,27,35
14,120,1468,45,27,18
14,120,1380,19,10,9
14,120,2080,42,19,23
14,120,2788,28,15,13
14,120,1264,19,9,10
14,120,3835,67,41,26
14,120,10704,92,47,45
14,120,2951,43,24,19
14,120,1336,24,10,14
14,120,2095,37,16,21
14,120,1249,26,13,13
14,120,1250,25,14,11
14,120,2987,56,26,30
14,120,2203,86,49,37
14,120,2922,153,75,78
14,120,3348,35,18,17
14,120,2548,34,19,15
14,120,3551,101,51,50
14,120,4123,43,29,14
14,120,2715,46,23,23
14,120,2258,36,17,19
14,120,2551,13,5,8
14,120,3091,23,14,9
14,120,2092,32,19,13
14,120,12017,101,49,52
14,120,14440,180,83,97
14,120,1877,25,15,10
14,120,1084,10,7,3
14,120,2509,39,22,17
14,120,1962,16,7,9
14,120,1677,272,145,127
14,120,1747,73,42,31
14,120,2324,32,15,17
14,120,2492,47,26,21
14,120,1494,191,80,111
14,120,5028,291,144,147
14,120,2644,129,62,67
14,120,4174,80,28,52
14,120,2111,91,40,51
14,120,1446,25,14,11
14,120,3214,51,30,21
14,120,2205,58,25,33
14,120,3202,51,26,25
14,120,2410,23,10,13
14,120,2002,46,25,21
14,120,1511,14,9,5
14,120,1159,28,15,13
14,120,2738,27,14,13
14,120,10436,489,238,251
14,120,3083,26,14,12
14,120,5694,95,55,40
14,120,8682,142,67,75
14,120,2536,75,34,41
14,120,3077,21,7,14
14,120,4354,19,11,8
14,120,7630,139,50,89
14,120,6564,65,30,35
14,120,6510,91,46,45
14,120,7199,66,32,34
14,120,2269,168,85,83
14,120,2429,68,33,35
14,120,2839,21,9,12
14,120,7753,112,58,54
14,120,3226,100,57,43
14,120,1500,53,26,27
14,120,3266,157,90,67
14,120,2161,12,6,6
14,120,1383,4,2,2
14,120,4910,310,149,161
14,120,2549,41,23,18
14,120,1361,20,8,12
14,120,1474,30,16,14
14,120,1226,5,2,3
14,120,1560,32,11,21
14,120,1346,14,7,7
14,120,1407,51,22,29
14,120,1441,40,21,19
14,120,1470,3,2,1
14,120,1198,48,20,28
14,120,1558,24,8,16
14,120,2328,27,9,18
14,120,3801,22,13,9
14,120,1688,13,8,5
14,120,6553,274,128,146
14,120,2907,76,36,40
14,120,2846,91,46,45
14,120,2691,16,10,6
14,120,4393,92,50,42
14,120,19840,369,166,203
14,120,7097,155,77,78
14,120,6231,25,11,14
14,120,4782,110,62,48
14,120,7218,45,28,17
14,120,6742,23,8,15
14,120,5393,44,24,20
14,120,4293,30,12,18
14,120,3561,141,83,58
14,120,2476,47,24,23
14,120,2051,37,18,19
14,120,1510,54,27,27
14,120,1085,20,11,9
14,120,1701,69,31,38
14,120,2029,45,23,22
14,120,4541,72,32,40
14,120,1809,22,5,17
14,120,2490,25,15,10
14,120,1445,8,5,3
14,99,2055,19,8,11
14,120,2828,22,12,10
14,120,1734,6,2,4
14,120,2018,95,45,50
14,120,1828,121,65,56
14,120,1710,98,48,50
14,120,1511,22,13,9
14,120,1577,86,47,39
14,120,1732,61,22,39
14,120,1558,22,11,11
14,120,1561,41,23,18
14,120,1392,24,12,12
14,120,1030,12,9,3
14,120,1310,16,9,7
14,120,1710,74,35,39
14,120,3628,76,38,38
14,120,2457,83,46,37
14,120,1913,61,38,23
14,120,1733,13,6,7
14,120,1758,32,14,18
14,120,1079,23,11,12
14,120,1156,8,4,4
14,120,1640,30,12,18
14,120,1804,13,8,5
14,120,1721,36,14,22
14,120,1812,30,13,17
14,120,2383,51,24,27
14,99,2966,19,10,9
14,120,945,4,2,2
14,99,5369,37,16,21
14,99,2015,20,11,9
14,99,1234,5,2,3
14,99,2899,105,47,58
14,120,1548,33,18,15
14,120,4551,34,19,15
14,120,1647,4,3,1
14,120,3427,70,33,37
14,120,2061,24,10,14
14,120,3772,45,23,22
14,120,3881,45,17,28
14,120,4236,52,31,21
14,120,7338,100,44,56
14,120,5406,204,93,111
14,120,4719,27,16,11
14,120,6378,195,97,98
14,120,2363,27,19,8
14,120,8519,98,49,49
14,120,1505,20,10,10
14,120,1190,10,7,3
14,120,2677,53,30,23
14,120,6356,42,16,26
14,120,2521,60,33,27
14,120,10343,442,219,223
14,120,29027,362,175,187
14,120,2176,19,10,9
14,120,1887,3,2,1
14,120,3375,14,6,8
14,120,4348,27,11,16
14,120,10348,203,100,103
14,120,1421,35,9,26
14,120,7101,87,23,64
14,120,4465,56,25,31
14,120,9575,99,49,50
14,120,3006,15,10,5
14,120,3655,32,16,16
14,121,2550,74,45,29
14,121,3420,55,29,26
14,121,2079,12,5,7
14,121,1922,9,5,4
14,121,857,4,2,2
14,121,1169,15,5,10
14,121,1486,6,3,3
14,121,3050,32,12,20
14,121,870,1,0,1
14,121,3387,33,17,16
14,121,2231,9,8,1
14,121,681,2,2,0
14,121,1338,0,0,0
14,121,2084,22,9,13
14,121,2570,110,56,54
14,121,2,-6,-6,-6
14,121,483,18,8,10
14,121,762,13,9,4
14,121,1694,318,151,167
14,121,567,275,149,126
14,121,359,1,0,1
14,122,2551,8,6,2
14,122,1807,27,12,15
14,122,1168,3,1,2
14,122,827,4,3,1
14,122,1010,3,1,2
14,122,202,4,2,2
14,123,1649,17,4,13
14,123,1896,5,2,3
14,123,1289,1,0,1
14,123,474,2,0,2
14,123,1215,1,1,0
14,123,1029,113,55,58
14,123,1391,0,0,0
14,123,1356,13,9,4
14,123,1619,15,7,8
14,123,610,0,0,0
14,123,2351,11,4,7
14,123,2538,6,1,5
14,123,1853,16,8,8
14,124,4295,113,56,57
14,124,1852,0,0,0
14,124,1919,18,10,8
14,124,1880,4,1,3
14,124,3150,10,4,6
14,124,5147,174,95,79
14,124,2096,95,54,41
14,124,2465,7,2,5
14,124,1357,25,14,11
14,124,953,3,3,0
14,124,1813,5,1,4
14,124,3617,39,19,20
14,124,800,5,4,1
14,124,1899,1,0,1
14,124,344,0,0,0
14,124,549,0,0,0
14,124,1208,4,2,2
14,124,1340,2,2,0
14,124,632,6,4,2
14,124,1710,12,6,6
14,124,1469,0,0,0
14,124,585,3,2,1
14,124,202,2,0,2
14,124,5684,77,37,40
14,124,5359,169,100,69
14,124,900,0,0,0
14,124,1166,4,1,3
14,124,1255,10,7,3
14,124,1998,2,1,1
14,124,2308,16,7,9
14,124,1842,2,1,1
14,124,3500,24,16,8
14,99,1098,31,11,20
14,102,2634,15,9,6
14,99,3034,27,13,14
14,99,3175,3,2,1
14,99,1248,5,1,4
14,41,2370,246,130,116
14,99,423,6,1,5
14,99,9825,142,75,67
14,99,1657,15,7,8
14,99,131,3,1,2
14,99,448,0,0,0
14,99,1804,9,6,3
14,99,3781,30,15,15
14,99,496,1,1,0
14,99,5264,104,56,48
14,99,1314,9,1,8
14,99,360,2,0,2
14,99,1951,18,5,13
14,99,1292,4,3,1
14,99,1287,7,7,0
14,99,1162,5,1,4
14,99,1317,16,9,7
14,99,1227,0,0,0
14,99,1078,9,5,4
14,99,1470,10,4,6
14,99,1469,21,9,12
14,99,1463,16,8,8
14,99,1524,11,3,8
14,99,1238,3,2,1
14,99,1668,60,24,36
14,99,1503,31,15,16
14,99,1472,6,2,4
14,99,1506,1,0,1
14,99,1094,25,13,12
14,99,1422,10,5,5
14,99,1380,6,4,2
14,99,1464,7,3,4
14,99,1521,19,11,8
14,99,1768,69,39,30
14,99,1615,14,6,8
14,99,1734,72,43,29
14,99,2161,15,5,10
14,99,1833,19,10,9
14,99,1011,1,0,1
14,99,1567,13,5,8
14,99,716,1,0,1
14,41,796,3,2,1
14,125,1082,5,1,4
14,36,846,2,1,1
14,36,1250,0,0,0
14,36,1224,1,1,0
14,36,426,0,0,0
14,36,646,0,0,0
14,120,1225,25,8,17
14,120,604,10,7,3
14,120,1336,28,13,15
14,120,1195,10,4,6
14,120,1028,7,6,1
14,120,992,10,5,5
14,120,1923,24,15,9
14,120,1246,9,5,4
14,120,1375,11,5,6
14,120,1231,31,16,15
14,120,1697,117,61,56
14,120,1402,10,4,6
14,120,1420,21,10,11
14,120,1188,49,26,23
14,120,968,5,2,3
14,120,1168,91,44,47
14,120,1020,10,7,3
14,120,985,41,18,23
14,120,610,7,3,4
14,120,1792,12,8,4
14,120,1826,53,23,30
14,120,1119,1,0,1
14,120,985,22,11,11
14,120,1005,2,1,1
14,120,886,10,3,7
14,98,1354,18,6,12
14,98,4771,25,12,13
14,98,1496,66,33,33
14,98,2445,14,8,6
14,98,5569,30,15,15
14,98,4260,70,36,34
14,98,3872,38,12,26
14,98,2480,166,83,83
14,98,2308,10,5,5
14,98,2368,13,6,7
14,98,3821,18,9,9
14,98,3081,16,7,9
14,98,2315,18,6,12
14,98,2157,41,19,22
14,98,2071,11,5,6
14,98,2828,9,3,6
14,98,2203,16,8,8
14,98,2229,25,8,17
14,98,3049,20,7,13
14,98,11607,76,39,37
14,98,3062,57,31,26
14,98,2130,8,5,3
14,98,3009,40,16,24
14,98,6488,33,14,19
14,98,5082,43,22,21
14,98,28430,208,98,110
14,98,5142,41,19,22
14,98,20463,978,499,479
14,98,17259,202,85,117
14,98,2595,36,20,16
14,98,3150,34,14,20
14,98,3961,39,23,16
14,98,6038,29,19,10
14,98,15613,407,219,188
14,98,3952,42,21,21
14,98,2355,23,12,11
14,98,5140,44,18,26
14,98,12141,450,221,229
14,98,485,239,122,117
14,98,909,113,51,62
14,98,3863,391,198,193
14,98,8927,339,173,166
14,98,1855,11,4,7
14,98,1286,19,12,7
14,98,873,10,7,3
14,98,1960,44,22,22
14,98,2298,28,9,19
14,98,3203,199,97,102
14,98,3415,31,17,14
14,98,10728,98,49,49
14,98,3461,34,13,21
14,98,5362,102,50,52
14,98,6894,78,43,35
14,98,4413,21,10,11
14,98,5542,37,13,24
14,98,1058,10,7,3
14,98,3023,3,2,1
14,98,2693,18,8,10
14,98,2039,10,4,6
14,98,2904,163,81,82
14,98,643,28,9,19
14,98,875,7,6,1
14,98,1293,23,15,8
14,98,11311,516,285,231
14,98,8074,39,17,22
14,98,42164,897,440,457
14,98,3287,6,2,4
14,98,5781,49,26,23
14,98,2016,4,1,3
14,98,1738,7,3,4
14,98,1479,17,8,9
14,98,2246,81,40,41
14,98,633,3,1,2
14,98,1211,11,8,3
14,98,1990,18,9,9
14,98,1681,2,0,2
14,98,1237,41,24,17
14,98,1661,74,34,40
14,98,1445,1,0,1
14,98,1239,40,14,26
14,98,18999,489,236,253
14,98,8653,87,42,45
14,98,8644,143,75,68
14,120,1383,54,27,27
14,120,656,9,3,6
14,120,1802,58,36,22
14,120,650,11,6,5
14,120,1779,89,38,51
14,120,1529,30,13,17
14,120,1702,42,29,13
14,120,1246,10,8,2
14,120,1199,46,22,24
14,120,1690,47,23,24
14,120,1659,87,44,43
14,120,1675,7,4,3
14,120,1359,12,7,5
14,120,773,28,13,15
14,120,992,14,6,8
14,120,1450,39,19,20
14,120,1627,31,17,14
14,120,2100,72,41,31
14,120,1081,11,5,6
14,120,882,57,23,34
14,120,1111,12,4,8
14,120,1541,11,5,6
14,120,1386,17,9,8
14,120,694,4,1,3
14,120,1233,9,4,5
14,120,722,54,27,27
14,120,1211,82,36,46
14,120,1540,27,11,16
14,120,1675,25,10,15
14,120,1396,4,0,4
14,120,794,37,19,18
14,120,1739,77,39,38
14,120,1907,43,21,22
14,120,2110,122,52,70
14,120,3559,102,56,46
14,120,1003,15,5,10
14,120,939,84,40,44
14,120,794,16,10,6
14,120,963,4,1,3
14,120,868,46,21,25
14,120,1583,34,18,16
14,120,858,57,28,29
14,120,821,220,107,113
14,120,1343,119,59,60
14,120,1240,38,23,15
14,120,545,6,4,2
14,120,730,13,4,9
14,120,723,68,41,27
14,120,1732,118,53,65
14,120,699,5,1,4
14,120,1045,231,119,112
14,120,706,6,2,4
14,120,1100,10,7,3
14,120,1614,8,4,4
14,120,1419,13,8,5
14,120,1483,21,11,10
14,120,5357,39,13,26
14,120,1457,25,14,11
14,120,1434,9,2,7
14,120,2213,49,27,22
14,120,1698,127,67,60
14,120,1216,8,3,5
14,120,1714,117,59,58
14,120,1904,28,16,12
14,120,1524,24,13,11
14,120,1559,70,37,33
14,120,1356,12,3,9
14,120,1222,6,3,3
14,120,1709,207,105,102
14,120,2442,126,64,62
14,120,1391,63,34,29
14,120,1508,1,0,1
14,120,1205,3,2,1
14,120,1008,13,5,8
14,120,3588,58,35,23
14,120,1029,9,7,2
14,120,1332,324,157,167
14,120,1143,130,71,59
14,69,2491,69,35,34
14,69,2819,18,7,11
14,69,3451,20,10,10
14,69,3752,83,42,41
14,69,2735,72,39,33
14,69,2030,24,10,14
14,69,2434,39,17,22
14,69,2527,4,3,1
14,69,2276,31,10,21
14,69,1781,12,3,9
14,69,1204,9,3,6
14,120,1602,35,14,21
14,120,3552,18,8,10
14,120,2446,11,6,5
14,120,4703,192,92,100
14,120,2198,18,10,8
14,120,2403,31,16,15
14,120,2814,58,30,28
14,120,407,11,5,6
14,120,1911,31,10,21
14,120,5625,54,28,26
14,120,3126,24,16,8
14,120,1721,14,8,6
14,120,3824,21,12,9
14,120,1684,16,2,14
14,120,1200,18,9,9
14,120,1361,33,17,16
14,120,1236,4,3,1
14,98,4594,72,36,36
14,98,4535,91,45,46
14,98,7574,209,101,108
14,98,3282,19,10,9
14,98,1797,9,3,6
14,98,4708,36,16,20
14,98,2021,67,32,35
14,98,2209,70,33,37
14,98,2565,25,12,13
14,98,5558,45,15,30
14,98,2410,453,221,232
14,98,2464,32,19,13
14,98,2510,39,18,21
14,98,2825,18,8,10
14,98,1431,127,58,69
14,98,6950,55,26,29
14,98,3202,5,3,2
14,98,3159,51,22,29
14,98,4642,1330,682,648
14,98,1661,39,19,20
14,98,3048,70,39,31
14,98,7437,1884,976,908
14,98,6982,2376,1187,1189
14,98,5629,261,126,135
14,98,6817,40,15,25
14,98,1967,12,6,6
14,98,2506,10,5,5
14,98,2691,9,2,7
14,98,2805,15,4,11
14,98,4008,50,26,24
14,98,2114,70,39,31
14,98,5100,89,41,48
14,98,3261,13,5,8
14,98,2570,13,7,6
14,98,4651,83,41,42
14,99,4292,188,100,88
14,99,1286,5,4,1
14,99,4245,36,13,23
14,99,1907,5,2,3
14,99,5448,135,58,77
14,99,3252,43,22,21
14,99,6401,76,33,43
14,99,4959,72,34,38
14,99,2737,38,21,17
14,99,5359,132,70,62
14,120,5991,129,58,71
14,120,628,1,0,1
14,120,1401,10,5,5
14,120,8437,131,64,67
14,120,4987,185,82,103
14,120,4612,66,39,27
14,120,5485,68,26,42
14,120,3836,76,24,52
14,120,6976,60,29,31
14,120,2843,170,94,76
14,120,3216,16,5,11
14,120,3720,131,50,81
14,120,5414,74,35,39
14,120,4515,123,62,61
14,120,6046,105,58,47
14,120,4672,619,316,303
14,120,2357,50,26,24
14,120,2423,26,17,9
14,120,3484,97,52,45
14,120,2686,155,81,74
14,120,3017,31,16,15
14,120,2647,14,6,8
14,120,1186,54,25,29
14,55,1725,9,8,1
14,55,1904,4,1,3
14,55,3523,11,7,4
14,55,3007,7,3,4
14,55,2889,7,2,5
14,75,3763,3,3,0
14,75,2875,275,131,144
14,120,3275,30,15,15
14,120,2262,552,263,289
14,98,656,1,1,0
14,98,2848,47,25,22
14,98,2065,2,1,1
14,98,1845,11,7,4
14,98,2982,61,34,27
14,98,2232,21,5,16
14,52,2038,97,48,49
14,52,3790,89,49,40
15,1,2994,2,0,2
15,1,2117,14,8,6
15,1,3565,46,17,29
15,1,3085,10,7,3
15,1,1027,7,3,4
15,1,965,11,8,3
15,1,1236,5,2,3
15,1,963,6,5,1
15,1,615,1,1,0
15,1,1916,8,2,6
15,1,2426,493,264,229
15,1,1625,321,149,172
15,1,2345,20,10,10
15,1,2640,8,4,4
15,1,1827,1,1,0
15,1,2089,5,4,1
15,1,1740,249,137,112
15,1,1446,1,0,1
15,1,2543,10,5,5
15,1,3960,470,263,207
15,1,2782,11,7,4
15,1,2295,8,4,4
15,1,1575,13,7,6
15,1,2440,2,2,0
15,1,1678,21,12,9
15,1,2222,93,48,45
15,1,1316,4,2,2
15,1,3462,3,3,0
15,1,1458,53,29,24
15,1,2323,9,5,4
15,1,2558,92,47,45
15,1,2057,14,10,4
15,2,3121,13,7,6
15,2,2994,21,10,11
15,2,6461,64,32,32
15,2,787,1,0,1
15,2,2701,9,2,7
15,2,3639,23,14,9
15,2,187,0,0,0
15,2,1397,16,7,9
15,2,3411,1,1,0
15,2,2700,9,3,6
15,2,3427,18,6,12
15,2,9588,87,45,42
15,2,3518,23,6,17
15,2,4050,20,10,10
15,2,4017,8,7,1
15,2,3608,90,43,47
15,2,5105,21,11,10
15,2,3221,5,3,2
15,2,4195,54,28,26
15,2,5183,134,61,73
15,2,2140,29,14,15
15,2,2824,69,46,23
15,2,3825,9,4,5
15,2,10555,28,10,18
15,2,18848,534,293,241
15,3,2133,20,11,9
15,3,2260,30,17,13
15,3,998,5,2,3
15,3,2392,2,0,2
15,3,2626,7,6,1
15,3,1426,1,1,0
15,3,1631,2,2,0
15,3,2391,11,7,4
15,3,3931,14,10,4
15,3,1951,0,0,0
15,3,4388,34,15,19
15,3,2107,4,3,1
15,3,2234,0,0,0
15,3,2183,0,0,0
15,3,2000,4,3,1
15,3,2640,0,0,0
15,3,2087,12,4,8
15,3,2197,5,2,3
15,3,806,2,1,1
15,3,206,11,7,4
15,3,525,0,0,0
15,3,1069,2,0,2
15,4,1186,411,215,196
15,4,1437,10,4,6
15,4,887,2,2,0
15,4,2361,374,201,173
15,4,3491,32,20,12
15,4,1093,4,3,1
15,4,927,0,0,0
15,4,936,4,2,2
15,4,250,0,0,0
15,4,265,2,1,1
15,4,1427,0,0,0
15,4,989,0,0,0
15,5,2080,8,3,5
15,5,857,17,9,8
15,5,1646,40,20,20
15,5,2884,27,12,15
15,5,789,1,0,1
15,5,1347,6,2,4
15,5,3455,69,33,36
15,5,1774,14,5,9
15,5,5599,11,4,7
15,5,6,0,0,0
15,5,1296,2,1,1
15,5,1490,28,15,13
15,5,2038,7,3,4
15,5,4731,1704,848,856
15,115,123,0,0,0
15,5,1707,4,4,0
15,5,2257,13,9,4
15,5,10810,66,35,31
15,5,3136,44,28,16
15,5,4768,11,5,6
15,5,117,0,0,0
15,5,1969,5,3,2
15,5,1019,0,0,0
15,5,2146,3,3,0
15,5,2389,0,0,0
15,5,2527,9,4,5
15,5,14027,216,99,117
15,5,5097,16,7,9
15,5,5446,36,19,17
15,5,4878,17,11,6
15,5,3441,18,8,10
15,5,4832,116,53,63
15,5,4500,5,3,2
15,5,1904,3,2,1
15,5,4445,13,3,10
15,5,428,0,0,0
15,5,3800,48,21,27
15,5,2763,9,6,3
15,5,7100,30,17,13
15,5,4420,31,19,12
15,5,1671,0,0,0
15,5,1399,3,1,2
15,5,2267,4,2,2
15,5,3771,21,10,11
15,5,10171,72,32,40
15,5,4241,18,13,5
15,5,3438,13,5,8
15,5,2595,25,12,13
15,5,686,8,3,5
15,5,1816,31,16,15
15,5,4125,144,74,70
15,5,1317,4,2,2
15,5,1734,4,2,2
15,5,1112,5,1,4
15,5,1011,6,0,6
15,5,1594,6,3,3
15,5,1654,9,2,7
15,6,2965,13,6,7
15,6,1460,22,7,15
15,6,4201,27,19,8
15,6,2484,14,4,10
15,6,2116,16,10,6
15,7,2718,16,4,12
15,7,1277,3,3,0
15,7,400,0,0,0
15,7,1370,1,1,0
15,7,2842,11,4,7
15,7,3108,33,19,14
15,7,1341,39,18,21
15,7,2982,11,5,6
15,7,3844,17,9,8
15,7,1913,16,6,10
15,8,1802,9,6,3
15,8,1855,27,14,13
15,8,540,1,0,1
15,8,450,0,0,0
15,8,1396,4,3,1
15,8,2925,19,8,11
15,8,368,0,0,0
15,8,687,1,0,1
15,8,445,1,1,0
15,8,2625,3,2,1
15,8,1884,1,1,0
15,8,138,1,0,1
15,8,436,0,0,0
15,8,435,1,1,0
15,8,1018,6,5,1
15,8,772,1,1,0
15,8,290,0,0,0
15,8,675,0,0,0
15,8,1609,9,4,5
15,8,19,0,0,0
15,8,831,3,1,2
15,8,1397,9,6,3
15,8,168,0,0,0
15,8,422,2,1,1
15,8,1179,3,3,0
15,8,464,0,0,0
15,8,341,0,0,0
15,9,1590,21,10,11
15,9,2194,5,3,2
15,9,2022,23,10,13
15,9,1608,6,5,1
15,9,1262,2,1,1
15,9,1162,0,0,0
15,9,977,3,2,1
15,9,715,17,10,7
15,9,1683,44,20,24
15,9,3125,45,22,23
15,9,1187,37,19,18
15,9,1274,3,2,1
15,9,1159,3,2,1
15,9,1556,41,20,21
15,9,3336,56,32,24
15,9,1924,21,8,13
15,9,2989,330,166,164
15,9,2895,70,33,37
15,9,2422,19,7,12
15,9,3910,30,16,14
15,9,2454,17,7,10
15,9,2010,8,4,4
15,9,3827,51,31,20
15,9,2221,17,10,7
15,9,2877,3,1,2
15,9,3603,42,24,18
15,10,2341,26,14,12
15,10,3699,46,27,19
15,10,3006,10,4,6
15,10,2702,74,38,36
15,10,3522,55,26,29
15,10,4196,32,13,19
15,10,1404,10,5,5
15,10,2380,21,10,11
15,10,2251,28,13,15
15,10,195,0,0,0
15,10,416,2,1,1
15,10,1502,21,8,13
15,10,2393,82,39,43
15,10,1908,32,17,15
15,11,4848,98,53,45
15,11,2807,12,8,4
15,11,5188,31,13,18
15,11,4229,6,3,3
15,11,4516,38,19,19
15,11,17225,164,86,78
15,11,5441,20,7,13
15,11,3392,6,2,4
15,11,4249,33,18,15
15,11,4689,9,5,4
15,11,4857,13,6,7
15,11,1755,77,47,30
15,11,6031,37,21,16
15,11,5989,82,45,37
15,12,3431,29,14,15
15,12,3126,14,7,7
15,13,1702,28,14,14
15,13,4347,375,183,192
15,13,3478,29,16,13
15,13,3633,23,8,15
15,13,4292,51,29,22
15,13,3921,94,41,53
15,13,4085,29,12,17
15,13,4655,88,41,47
15,13,8009,60,33,27
15,13,1818,6,2,4
15,13,1616,5,4,1
15,13,6513,35,16,19
15,13,10727,806,401,405
15,13,6380,96,47,49
15,13,2712,11,3,8
15,13,1349,6,3,3
15,13,890,9,5,4
15,13,1617,29,16,13
15,13,1503,21,17,4
15,13,1094,12,4,8
15,13,3421,27,11,16
15,13,5841,45,19,26
15,13,16522,76,34,42
15,13,4578,17,8,9
15,13,5221,38,15,23
15,13,4192,58,26,32
15,13,8434,83,44,39
15,13,2969,55,23,32
15,13,6280,61,28,33
15,13,1984,7,0,7
15,13,5803,43,17,26
15,13,9226,104,37,67
15,13,4953,45,22,23
15,13,4981,60,32,28
15,13,1347,8,3,5
15,13,1510,17,4,13
15,13,903,22,14,8
15,13,5456,35,23,12
15,13,7892,67,32,35
15,13,4316,31,17,14
15,13,3144,224,122,102
15,13,1482,22,15,7
15,13,1418,7,3,4
15,13,752,0,0,0
15,13,4847,39,22,17
15,13,5642,63,30,33
15,13,2827,58,28,30
15,13,2745,21,8,13
15,13,3413,101,53,48
15,13,3389,20,8,12
15,13,3096,5,2,3
15,13,4326,86,41,45
15,13,6323,215,108,107
15,13,1732,14,14,0
15,13,1317,19,8,11
15,13,1610,8,4,4
15,13,2059,5,0,5
15,13,1714,13,3,10
15,13,1391,10,6,4
15,13,3197,66,29,37
15,13,3929,85,42,43
15,13,8195,223,115,108
15,13,5523,110,60,50
15,13,3852,27,12,15
15,13,1781,35,15,20
15,13,4511,47,25,22
15,13,3844,14,10,4
15,13,3307,69,31,38
15,13,3561,29,15,14
15,13,3093,13,9,4
15,13,4127,52,27,25
15,13,2484,13,7,6
15,13,2439,50,28,22
15,13,5661,293,159,134
15,13,1397,5,3,2
15,13,1516,4,2,2
15,13,3172,51,23,28
15,13,1522,12,8,4
15,13,2724,13,5,8
15,13,4635,34,18,16
15,13,2397,14,3,11
15,13,3367,27,11,16
15,13,5306,58,31,27
15,13,1615,3,2,1
15,13,1468,23,12,11
15,13,2835,293,161,132
15,13,1816,31,16,15
15,13,1553,14,4,10
15,13,1727,51,25,26
15,13,2558,31,20,11
15,13,2240,8,4,4
15,13,2896,21,13,8
15,13,2770,14,9,5
15,13,1576,8,3,5
15,13,2608,100,48,52
15,13,2309,23,13,10
15,13,2107,16,8,8
15,13,2260,36,16,20
15,13,2636,26,15,11
15,13,2575,19,8,11
15,13,3040,25,11,14
15,13,3002,38,19,19
15,13,2909,25,10,15
15,13,2793,44,26,18
15,13,1532,4,2,2
15,13,1937,111,53,58
15,13,1572,75,44,31
15,13,1559,11,7,4
15,13,2972,31,15,16
15,13,2751,199,109,90
15,13,2258,180,98,82
15,13,2275,13,8,5
15,13,1535,23,11,12
15,13,1548,26,14,12
15,13,2701,18,10,8
15,13,2047,36,15,21
15,13,1025,22,9,13
15,13,1434,16,10,6
15,13,1638,10,5,5
15,13,2397,11,3,8
15,13,899,25,11,14
15,13,2596,56,25,31
15,13,1018,11,5,6
15,13,2183,6,3,3
15,13,2285,20,9,11
15,13,1468,17,12,5
15,13,1811,26,12,14
15,13,2838,69,36,33
15,13,3470,61,36,25
15,13,1377,7,3,4
15,13,2872,14,6,8
15,13,1537,10,8,2
15,13,1619,15,6,9
15,13,855,10,5,5
15,13,1050,21,12,9
15,13,1997,65,43,22
15,13,1498,9,1,8
15,13,1700,26,15,11
15,13,1966,17,6,11
15,13,1417,14,7,7
15,13,2003,5,1,4
15,13,2504,44,19,25
15,13,3218,166,91,75
15,13,2781,31,18,13
15,13,6388,62,30,32
15,13,2339,14,4,10
15,13,2058,26,15,11
15,13,2870,47,26,21
15,13,6664,127,58,69
15,13,5890,56,22,34
15,13,2786,47,28,19
15,13,4871,48,25,23
15,13,1436,42,25,17
15,13,1613,25,13,12
15,13,2242,60,39,21
15,13,2125,34,21,13
15,13,1003,12,8,4
15,13,3020,28,17,11
15,13,2709,19,11,8
15,13,3697,27,16,11
15,13,4339,72,49,23
15,13,1773,8,4,4
15,13,1844,33,18,15
15,13,398,2,1,1
15,13,1692,11,4,7
15,13,12013,127,69,58
15,14,6352,41,22,19
15,14,5781,44,14,30
15,14,1435,3,1,2
15,14,1463,2,0,2
15,14,3369,0,0,0
15,14,3321,10,5,5
15,14,3685,29,17,12
15,14,3613,35,17,18
15,14,1705,0,0,0
15,14,1428,0,0,0
15,14,2132,4,1,3
15,14,1709,12,6,6
15,14,4038,36,16,20
15,14,4092,8,5,3
15,14,5777,46,23,23
15,14,1881,2,0,2
15,14,3299,3,0,3
15,14,4274,12,4,8
15,14,2726,6,3,3
15,14,2027,3,1,2
15,14,5225,71,29,42
15,14,1749,29,15,14
15,14,448,7,4,3
15,14,3850,28,8,20
15,14,2908,19,10,9
15,14,3646,2,1,1
15,14,4324,14,6,8
15,14,1991,2,1,1
15,14,5092,104,50,54
15,14,2325,2,1,1
15,14,2167,7,1,6
15,14,2558,0,0,0
15,14,633,3,1,2
15,14,3817,10,3,7
15,14,413,1,0,1
15,14,729,2,2,0
15,14,2685,3,2,1
15,14,645,0,0,0
15,14,148,0,0,0
15,15,3535,30,17,13
15,15,2153,8,4,4
15,15,2564,9,5,4
15,15,1582,8,5,3
15,15,2645,18,7,11
15,15,554,3,2,1
15,15,1719,27,14,13
15,15,4002,29,16,13
15,15,3276,107,63,44
15,15,3339,50,22,28
15,15,1343,5,3,2
15,15,2420,11,5,6
15,15,2946,8,4,4
15,16,2485,54,30,24
15,16,3953,16,10,6
15,16,747,195,96,99
15,16,2244,50,26,24
15,16,1976,13,3,10
15,16,670,12,5,7
15,16,1010,27,13,14
15,16,323,0,0,0
15,16,454,0,0,0
15,16,3413,33,18,15
15,16,425,3,2,1
15,16,381,1,0,1
15,16,499,1,0,1
15,16,1209,1,0,1
15,16,156,18,11,7
15,16,757,0,0,0
15,16,1907,1,1,0
15,16,1014,33,18,15
15,16,2683,4,2,2
15,16,294,0,0,0
15,17,2580,9,5,4
15,17,2205,42,21,21
15,17,624,10,5,5
15,17,998,9,4,5
15,17,1680,3,1,2
15,18,8657,136,67,69
15,18,2379,13,7,6
15,18,2220,4,2,2
15,18,2405,67,26,41
15,18,2836,38,22,16
15,18,5518,98,52,46
15,18,3816,44,26,18
15,18,12774,272,128,144
15,18,2351,17,4,13
15,18,5185,191,90,101
15,18,4401,99,52,47
15,18,3382,14,10,4
15,18,3042,2,0,2
15,18,4400,16,6,10
15,18,2413,18,6,12
15,18,1315,12,6,6
15,19,3871,20,12,8
15,19,4127,78,42,36
15,19,3246,10,5,5
15,19,2903,26,14,12
15,19,3388,15,9,6
15,19,2888,34,15,19
15,19,2086,11,4,7
15,19,7622,90,37,53
15,19,3200,30,15,15
15,19,3285,63,31,32
15,19,808,12,3,9
15,19,2336,42,24,18
15,20,4739,158,79,79
15,20,8772,67,38,29
15,20,1396,15,8,7
15,20,1424,84,46,38
15,20,1447,7,4,3
15,20,1596,45,20,25
15,20,1468,35,19,16
15,20,1294,50,25,25
15,20,2809,10,6,4
15,20,1615,21,6,15
15,20,1624,97,59,38
15,20,1667,21,8,13
15,20,1611,14,5,9
15,20,11163,96,52,44
15,20,6286,73,38,35
15,20,1325,13,6,7
15,20,1406,11,6,5
15,20,1666,39,22,17
15,20,1416,19,10,9
15,20,807,8,4,4
15,20,2374,40,15,25
15,20,1716,21,13,8
15,20,1102,16,10,6
15,20,1249,40,23,17
15,20,1103,18,4,14
15,20,1573,8,6,2
15,20,2810,31,16,15
15,20,1552,12,3,9
15,20,1545,10,2,8
15,20,6069,164,89,75
15,20,4518,121,56,65
15,20,2918,61,29,32
15,20,2117,47,22,25
15,20,4337,60,34,26
15,20,8949,155,77,78
15,20,4605,91,47,44
15,20,1343,29,17,12
15,20,1298,25,9,16
15,20,1582,17,10,7
15,20,2548,29,11,18
15,20,1619,5,3,2
15,20,1063,2,1,1
15,20,920,5,3,2
15,20,5427,41,20,21
15,20,1046,21,8,13
15,20,849,20,9,11
15,20,13854,175,94,81
15,20,5794,262,130,132
15,20,1575,62,26,36
15,20,4725,144,67,77
15,20,5542,88,38,50
15,20,4687,78,37,41
15,20,14183,200,110,90
15,20,1347,28,12,16
15,20,1262,49,22,27
15,20,3199,6,5,1
15,20,664,0,0,0
15,20,678,15,6,9
15,20,972,6,1,5
15,20,850,20,10,10
15,20,853,0,0,0
15,20,2345,43,26,17
15,20,963,8,4,4
15,20,913,4,3,1
15,20,566,16,6,10
15,20,1319,7,4,3
15,20,1050,39,16,23
15,20,1371,116,67,49
15,20,1248,13,6,7
15,20,2891,34,11,23
15,20,1033,24,14,10
15,20,3980,47,21,26
15,20,3899,88,36,52
15,20,1094,20,10,10
15,20,1580,10,5,5
15,20,1168,10,4,6
15,20,1061,14,9,5
15,20,4070,109,61,48
15,20,3867,80,40,40
15,20,3514,22,11,11
15,20,833,10,6,4
15,20,7072,136,67,69
15,20,2582,14,6,8
15,20,2012,213,108,105
15,20,1441,23,11,12
15,20,1156,8,3,5
15,20,2126,20,5,15
15,20,6065,172,81,91
15,20,2783,10,3,7
15,20,7673,517,263,254
15,20,1954,32,19,13
15,20,6338,104,61,43
15,20,3341,15,8,7
15,20,2290,21,9,12
15,20,3016,40,23,17
15,20,2093,12,5,7
15,20,1320,16,7,9
15,20,1340,8,5,3
15,20,2112,20,7,13
15,20,9152,155,68,87
15,20,1098,53,29,24
15,20,1223,31,13,18
15,20,764,4,2,2
15,20,1354,20,15,5
15,20,1612,4,0,4
15,20,814,8,4,4
15,21,3819,13,3,10
15,21,3105,46,30,16
15,21,2160,17,7,10
15,21,1250,4,1,3
15,21,1282,20,11,9
15,21,3103,4,3,1
15,21,1717,9,4,5
15,21,4349,16,6,10
15,21,2010,3,1,2
15,21,1018,4,1,3
15,21,1191,22,9,13
15,21,1319,3,0,3
15,21,2082,9,4,5
15,21,2211,22,11,11
15,21,374,4,2,2
15,21,3785,23,10,13
15,21,1003,28,17,11
15,21,1847,2,2,0
15,21,1173,5,3,2
15,22,2884,4,3,1
15,22,2231,10,4,6
15,22,2871,19,4,15
15,22,1790,1,1,0
15,22,2571,21,11,10
15,22,2685,59,30,29
15,23,6984,63,35,28
15,23,4565,173,81,92
15,23,6443,86,43,43
15,23,2151,24,15,9
15,23,3928,34,18,16
15,23,5692,81,43,38
15,23,3976,38,21,17
15,23,1903,42,20,22
15,23,5725,52,25,27
15,23,5261,39,17,22
15,24,428,7,2,5
15,24,2715,42,14,28
15,24,1592,32,17,15
15,24,1746,5,3,2
15,24,4704,42,24,18
15,24,3549,42,22,20
15,24,21404,468,228,240
15,24,6875,153,82,71
15,24,1112,26,6,20
15,24,2351,121,68,53
15,24,1452,30,11,19
15,24,1288,75,39,36
15,24,1405,174,96,78
15,24,1094,3,1,2
15,24,890,14,8,6
15,24,1886,21,11,10
15,24,5072,183,85,98
15,24,1208,10,3,7
15,24,16590,645,324,321
15,24,4923,146,68,78
15,24,1905,144,80,64
15,24,602,4,2,2
15,24,1200,2,2,0
15,24,1141,5,2,3
15,24,10275,70,32,38
15,24,6322,245,118,127
15,24,20423,359,176,183
15,25,1478,2,0,2
15,25,3594,62,26,36
15,25,3383,52,18,34
15,25,2056,26,15,11
15,25,2556,205,101,104
15,25,2627,24,14,10
15,25,1373,15,10,5
15,25,1333,40,19,21
15,25,4243,116,62,54
15,25,3515,144,75,69
15,25,1111,9,5,4
15,25,7944,74,39,35
15,25,1408,23,10,13
15,25,2794,29,14,15
15,25,3746,115,49,66
15,25,960,3,1,2
15,25,1177,10,6,4
15,25,1186,2,0,2
15,25,1697,11,4,7
15,25,3940,111,49,62
15,25,1715,2,1,1
15,25,1741,11,5,6
15,25,1535,2,0,2
15,25,3526,16,9,7
15,25,1227,1,0,1
15,25,1718,14,7,7
15,25,2722,24,8,16
15,25,1549,4,2,2
15,25,2115,24,7,17
15,25,1552,7,4,3
15,25,1403,10,5,5
15,25,1409,9,5,4
15,25,1707,20,9,11
15,25,2106,12,5,7
15,25,1588,11,5,6
15,25,784,9,6,3
15,25,1231,1,0,1
15,25,5195,24,12,12
15,25,6049,57,29,28
15,25,1052,0,0,0
15,25,1016,5,2,3
15,25,1425,2,1,1
15,25,1521,9,5,4
15,25,2091,7,3,4
15,25,1268,19,11,8
15,25,1207,2,2,0
15,25,1079,2,1,1
15,25,905,5,4,1
15,25,1678,10,6,4
15,25,874,8,3,5
15,25,1175,13,3,10
15,25,1416,14,8,6
15,25,1166,8,4,4
15,25,1515,66,32,34
15,25,1427,121,64,57
15,25,875,31,20,11
15,25,913,4,3,1
15,25,937,10,4,6
15,25,1065,7,2,5
15,25,1326,31,16,15
15,25,1280,28,12,16
15,25,1350,50,29,21
15,25,1488,11,8,3
15,25,1249,19,11,8
15,25,1265,4,2,2
15,25,2503,100,49,51
15,25,11954,298,147,151
15,25,2670,31,17,14
15,25,7118,84,37,47
15,25,1847,55,25,30
15,25,1239,13,9,4
15,25,934,35,19,16
15,25,1278,36,19,17
15,25,1163,297,155,142
15,25,1393,82,42,40
15,25,1280,10,5,5
15,25,1372,8,5,3
15,25,1423,21,15,6
15,25,935,11,3,8
15,25,692,38,22,16
15,25,850,32,19,13
15,25,843,33,16,17
15,25,672,1,0,1
15,25,946,10,4,6
15,25,789,17,10,7
15,25,723,5,3,2
15,25,9241,495,245,250
15,25,1030,3,1,2
15,25,1256,67,40,27
15,25,998,54,26,28
15,25,1251,38,13,25
15,25,1418,69,36,33
15,25,1161,6,3,3
15,25,873,47,20,27
15,25,1592,4,2,2
15,25,745,40,19,21
15,25,5208,219,114,105
15,25,1952,119,63,56
15,25,1442,18,11,7
15,25,1692,10,3,7
15,25,1168,31,16,15
15,25,1038,8,4,4
15,25,1567,15,5,10
15,25,1772,21,11,10
15,25,1723,78,46,32
15,25,2883,29,15,14
15,25,1187,13,5,8
15,25,1390,18,7,11
15,25,1555,28,16,12
15,25,4445,137,63,74
15,25,1059,45,18,27
15,25,1266,41,22,19
15,25,955,2,1,1
15,25,4409,110,54,56
15,25,994,3,2,1
15,25,1392,39,12,27
15,25,1592,11,7,4
15,25,624,18,9,9
15,25,1019,8,3,5
15,25,992,3,1,2
15,25,1214,0,0,0
15,25,828,4,1,3
15,25,1497,28,16,12
15,25,1489,19,7,12
15,25,1357,17,8,9
15,25,1362,21,11,10
15,25,1184,26,14,12
15,25,983,10,4,6
15,25,1086,14,7,7
15,25,1749,28,12,16
15,25,1800,50,23,27
15,25,2062,27,16,11
15,25,6434,105,56,49
15,25,3924,99,55,44
15,25,2248,258,144,114
15,25,1933,57,25,32
15,25,1665,18,8,10
15,25,1707,13,8,5
15,25,2495,8,3,5
15,25,937,11,7,4
15,25,1204,8,5,3
15,25,877,7,5,2
15,25,881,29,17,12
15,25,5461,92,41,51
15,25,1185,19,8,11
15,25,586,9,6,3
15,25,1980,16,6,10
15,25,3043,100,60,40
15,25,1029,46,23,23
15,25,958,5,3,2
15,25,1371,7,2,5
15,25,2329,30,13,17
15,25,2113,58,27,31
15,25,2374,25,14,11
15,25,3497,2,1,1
15,25,2770,59,32,27
15,25,10179,186,98,88
15,25,4320,86,47,39
15,25,1134,14,7,7
15,25,3855,12,5,7
15,25,3632,5,3,2
15,25,2502,92,42,50
15,25,2602,5,4,1
15,25,3747,51,23,28
15,25,4417,292,152,140
15,25,2606,6,4,2
15,25,6962,24,12,12
15,25,2082,14,5,9
15,25,2592,36,15,21
15,25,2096,40,18,22
15,25,1853,63,24,39
15,25,1571,50,26,24
15,25,2095,20,10,10
15,25,2811,2,0,2
15,25,2448,7,3,4
15,25,3292,79,29,50
15,25,4710,73,40,33
15,25,2211,67,31,36
15,25,2881,22,10,12
15,25,2085,29,15,14
15,25,1614,40,19,21
15,25,2469,62,21,41
15,25,1531,28,14,14
15,25,3791,121,61,60
15,25,1721,64,33,31
15,25,2533,37,19,18
15,25,1798,11,6,5
15,25,4479,53,28,25
15,25,3495,33,23,10
15,25,1130,6,4,2
15,25,2189,101,59,42
15,25,3709,38,17,21
15,25,1587,15,8,7
15,25,3143,7,3,4
15,25,1601,14,8,6
15,25,2507,105,44,61
15,25,7167,341,167,174
15,25,885,18,9,9
15,25,764,34,14,20
15,25,1245,23,11,12
15,25,1161,11,5,6
15,25,1035,10,2,8
15,25,987,4,2,2
15,25,1055,8,3,5
15,25,1001,0,0,0
15,25,903,2,0,2
15,25,1371,6,2,4
15,25,2072,32,19,13
15,25,2219,33,20,13
15,25,1891,26,10,16
15,25,1907,26,17,9
15,25,2082,11,5,6
15,25,19433,655,313,342
15,25,3754,60,29,31
15,25,2438,26,16,10
15,25,3393,97,43,54
15,25,7516,145,58,87
15,122,2946,116,62,54
15,122,3225,294,145,149
15,122,2491,30,16,14
15,122,3151,36,15,21
15,122,2957,78,33,45
15,122,2281,76,44,32
15,122,1485,20,12,8
15,122,2969,22,13,9
15,122,2498,15,5,10
15,122,2126,0,0,0
15,122,2107,6,1,5
15,122,2717,4,3,1
15,122,3693,21,12,9
15,122,3653,17,5,12
15,122,5711,43,19,24
15,122,2153,6,3,3
15,122,2019,12,4,8
15,122,2652,26,14,12
15,122,2330,3,0,3
15,122,3291,47,28,19
15,122,3246,38,17,21
15,122,2822,28,16,12
15,122,3619,33,17,16
15,122,1646,2,1,1
15,122,3238,18,9,9
15,26,12575,379,198,181
15,26,1189,30,16,14
15,122,2982,17,8,9
15,122,3251,26,12,14
15,122,3108,44,22,22
15,122,3230,144,74,70
15,122,3017,19,11,8
15,122,2453,40,19,21
15,122,2052,19,8,11
15,122,2821,91,52,39
15,122,4913,15,9,6
15,122,4209,22,13,9
15,122,3404,5,0,5
15,122,2574,71,42,29
15,122,4060,386,201,185
15,122,3514,53,32,21
15,122,2759,50,28,22
15,122,2493,39,19,20
15,122,2846,26,14,12
15,122,2122,59,27,32
15,122,2955,30,14,16
15,122,3112,49,25,24
15,122,2905,40,15,25
15,122,3461,19,10,9
15,122,4053,42,23,19
15,122,3281,6,1,5
15,122,3418,21,12,9
15,122,3000,36,23,13
15,122,2303,29,19,10
15,26,2775,67,28,39
15,26,3025,31,19,12
15,122,3328,77,39,38
15,122,3741,76,40,36
15,122,2790,86,42,44
15,122,4570,54,27,27
15,122,4759,39,20,19
15,122,3223,38,21,17
15,122,12053,346,183,163
15,122,3170,15,9,6
15,122,3899,40,23,17
15,122,3892,32,19,13
15,122,3302,31,14,17
15,122,3039,13,9,4
15,122,2999,40,19,21
15,122,3778,30,18,12
15,122,3428,36,16,20
15,122,3226,22,13,9
15,122,4345,25,12,13
15,122,2611,41,22,19
15,26,3189,118,49,69
15,26,4151,62,29,33
15,26,10916,143,71,72
15,26,1388,24,15,9
15,26,3200,269,133,136
15,26,6813,88,49,39
15,26,7592,20,14,6
15,26,2242,12,6,6
15,26,4245,18,9,9
15,26,11938,113,51,62
15,26,10923,295,147,148
15,122,2074,24,14,10
15,122,1880,35,18,17
15,122,3964,16,3,13
15,122,3877,21,7,14
15,122,3786,8,5,3
15,122,4132,29,11,18
15,122,5015,60,24,36
15,122,3176,16,7,9
15,122,2567,20,11,9
15,122,2950,18,12,6
15,122,4418,94,43,51
15,122,3058,73,37,36
15,122,4222,226,118,108
15,122,3642,26,10,16
15,122,3356,34,12,22
15,122,2703,80,43,37
15,122,2906,111,54,57
15,122,2978,20,12,8
15,122,2858,20,8,12
15,122,2911,32,22,10
15,26,2838,59,28,31
15,26,3279,47,19,28
15,26,4130,7,4,3
15,26,2707,18,8,10
15,26,1683,22,15,7
15,26,1518,40,19,21
15,26,1541,22,14,8
15,26,2018,10,5,5
15,26,3982,51,30,21
15,26,1476,7,3,4
15,26,1967,11,4,7
15,122,3091,2,1,1
15,122,3955,10,2,8
15,122,3917,49,21,28
15,122,3692,61,30,31
15,122,3248,102,44,58
15,122,3790,77,41,36
15,122,4665,161,76,85
15,26,3415,29,14,15
15,26,5343,55,24,31
15,26,6177,64,28,36
15,26,2825,15,8,7
15,26,4796,25,17,8
15,26,11193,148,69,79
15,26,1470,10,7,3
15,26,2887,29,14,15
15,26,25202,556,281,275
15,26,9399,31,17,14
15,26,1665,2,0,2
15,26,4166,20,11,9
15,26,5086,33,16,17
15,26,2917,26,14,12
15,26,3740,21,8,13
15,26,5273,117,58,59
15,26,2481,15,5,10
15,26,25086,295,151,144
15,26,2654,78,36,42
15,26,36561,677,320,357
15,26,10461,330,162,168
15,26,2666,24,13,11
15,26,4017,15,9,6
15,26,3197,14,4,10
15,26,1722,6,2,4
15,26,4064,10,3,7
15,122,16925,324,145,179
15,26,3952,125,51,74
15,26,3487,54,24,30
15,26,4577,954,501,453
15,26,14107,167,91,76
15,26,2038,9,4,5
15,26,3601,39,21,18
15,26,2751,14,8,6
15,26,3101,7,6,1
15,26,3612,62,33,29
15,26,8515,523,273,250
15,26,8418,266,140,126
15,26,6066,29,10,19
15,26,1871,18,8,10
15,26,4379,197,108,89
15,26,6495,50,26,24
15,26,3970,40,21,19
15,26,3481,66,35,31
15,26,6232,138,76,62
15,26,6118,48,25,23
15,27,3057,24,9,15
15,27,2424,310,179,131
15,27,1229,163,77,86
15,27,3412,28,15,13
15,27,6449,1071,517,554
15,27,1237,75,32,43
15,27,3598,508,259,249
15,27,1823,91,47,44
15,27,2024,2,0,2
15,27,2186,30,13,17
15,27,1290,14,8,6
15,27,1185,5,1,4
15,27,1236,4,1,3
15,27,401,0,0,0
15,28,8874,165,84,81
15,28,3733,65,30,35
15,29,4804,84,40,44
15,29,5307,107,55,52
15,29,2802,83,45,38
15,29,1307,11,7,4
15,29,2789,88,37,51
15,29,1737,13,6,7
15,29,691,25,14,11
15,29,797,10,5,5
15,29,1124,4,1,3
15,29,1769,43,25,18
15,29,4284,35,18,17
15,29,4219,8,6,2
15,30,6585,70,42,28
15,30,4171,42,21,21
15,30,2083,11,3,8
15,30,2753,51,20,31
15,30,9199,168,86,82
15,30,2533,45,22,23
15,30,1959,31,17,14
15,30,2418,20,10,10
15,30,1920,27,17,10
15,30,2116,23,12,11
15,30,7181,49,28,21
15,30,3074,52,29,23
15,30,4687,69,33,36
15,30,3785,66,35,31
15,30,1741,8,4,4
15,30,1964,31,16,15
15,30,1684,13,9,4
15,30,1746,7,3,4
15,30,1719,18,8,10
15,30,2093,15,7,8
15,30,1426,15,8,7
15,30,1659,4,1,3
15,30,1864,8,6,2
15,30,1917,26,9,17
15,30,1515,26,14,12
15,30,1953,17,6,11
15,30,1853,10,6,4
15,30,1572,6,3,3
15,30,1288,7,3,4
15,30,1642,12,6,6
15,31,1766,26,12,14
15,31,3662,17,10,7
15,31,5217,56,28,28
15,31,3186,16,2,14
15,31,6760,127,71,56
15,31,3077,32,14,18
15,32,5115,383,190,193
15,32,6863,88,45,43
15,32,7487,51,24,27
15,32,2632,20,9,11
15,32,3121,30,15,15
15,32,3137,10,4,6
15,32,4221,15,13,2
15,32,2385,7,3,4
15,32,2918,11,7,4
15,32,3444,21,8,13
15,32,4083,23,10,13
15,32,4694,27,16,11
15,32,3537,17,11,6
15,32,3676,73,32,41
15,32,5433,54,29,25
15,32,13105,83,34,49
15,32,3245,9,3,6
15,32,3482,123,62,61
15,32,2783,34,17,17
15,32,3174,15,11,4
15,32,4607,50,24,26
15,32,5541,38,20,18
15,32,4626,29,18,11
15,32,5656,185,90,95
15,32,6683,184,88,96
15,32,4494,135,72,63
15,32,3574,14,6,8
15,32,3393,5,3,2
15,32,3513,227,126,101
15,32,3168,289,135,154
15,32,2385,60,32,28
15,32,3220,17,9,8
15,32,2762,18,5,13
15,32,3316,99,42,57
15,32,3788,33,15,18
15,32,3122,19,8,11
15,32,3291,27,17,10
15,32,2759,29,11,18
15,32,2889,93,46,47
15,32,2429,66,35,31
15,32,2881,317,164,153
15,32,3877,43,22,21
15,32,6578,69,29,40
15,32,16070,187,87,100
15,32,13937,127,64,63
15,32,8716,54,27,27
15,32,4826,248,123,125
15,32,2600,1,1,0
15,32,2838,5,4,1
15,32,2665,21,14,7
15,32,3054,14,10,4
15,32,3435,20,11,9
15,32,3726,32,12,20
15,32,6555,64,36,28
15,32,3634,36,19,17
15,32,4564,331,168,163
15,32,3812,3,2,1
15,32,2799,97,49,48
15,32,2687,250,132,118
15,32,4403,21,13,8
15,32,3701,21,12,9
15,32,11001,350,174,176
15,32,3881,83,45,38
15,32,3222,1059,520,539
15,32,1046,8,2,6
15,32,1337,7,3,4
15,32,2212,16,7,9
15,32,7859,120,57,63
15,32,7805,128,71,57
15,32,5953,120,65,55
15,32,4389,27,17,10
15,32,2170,21,13,8
15,32,2678,13,5,8
15,32,3082,16,10,6
15,32,3149,23,5,18
15,32,3524,6,3,3
15,32,4418,148,76,72
15,32,2832,57,28,29
15,32,4421,93,44,49
15,32,3073,31,18,13
15,32,2439,2,2,0
15,32,2647,17,7,10
15,32,2535,60,31,29
15,32,2457,72,33,39
15,32,2477,7,3,4
15,32,2597,11,4,7
15,32,3957,43,19,24
15,32,14436,232,124,108
15,32,4621,89,38,51
15,32,3838,27,19,8
15,32,2129,13,4,9
15,32,2275,14,7,7
15,32,2644,6,4,2
15,32,2970,64,31,33
15,32,2505,574,299,275
15,32,2602,25,11,14
15,32,3317,64,27,37
15,32,3974,48,19,29
15,32,1047,11,5,6
15,32,3186,254,133,121
15,32,5113,27,13,14
15,32,3607,45,22,23
15,32,4392,26,17,9
15,32,2764,25,11,14
15,60,2287,62,33,29
15,60,2690,5,1,4
15,32,7741,185,102,83
15,32,5207,98,46,52
15,32,7540,80,41,39
15,60,2702,38,20,18
15,60,2644,24,10,14
15,60,1976,9,6,3
15,60,1891,11,8,3
15,60,2249,9,5,4
15,60,2217,23,13,10
15,60,2751,8,3,5
15,60,10063,28,18,10
15,32,6748,54,22,32
15,32,11450,327,162,165
15,32,26705,1670,836,834
15,32,7713,123,62,61
15,32,4229,35,20,15
15,32,2643,24,11,13
15,32,3364,22,10,12
15,32,4822,11,8,3
15,32,16481,103,61,42
15,32,3185,27,13,14
15,32,1775,11,4,7
15,32,2938,24,13,11
15,32,3606,27,19,8
15,32,9440,46,27,19
15,32,1749,1,0,1
15,32,898,42,19,23
15,32,1632,41,22,19
15,32,2017,441,234,207
15,33,4544,33,17,16
15,33,3358,48,22,26
15,33,2029,2,0,2
15,33,916,1,0,1
15,33,4413,2,0,2
15,33,890,4,2,2
15,33,3558,2,0,2
15,33,2412,2,2,0
15,33,0,0,0,0
15,33,713,1,0,1
15,33,1043,5,1,4
15,33,2126,2,1,1
15,33,3001,1,1,0
15,33,2893,4,2,2
15,33,3762,6,4,2
15,33,1350,4,3,1
15,34,2414,4,2,2
15,34,4478,30,13,17
15,34,6244,43,16,27
15,34,4967,137,71,66
15,34,1835,38,16,22
15,34,1027,34,14,20
15,34,2066,154,83,71
15,34,3141,154,76,78
15,34,923,5,3,2
15,34,937,8,4,4
15,34,894,37,18,19
15,34,915,6,4,2
15,34,3564,51,23,28
15,34,4932,170,90,80
15,34,4998,71,35,36
15,34,2291,6,4,2
15,34,3417,36,17,19
15,34,16032,131,59,72
15,34,2205,5,2,3
15,34,2501,28,14,14
15,34,1982,34,17,17
15,34,1887,13,8,5
15,34,4461,8,2,6
15,34,3771,13,7,6
15,34,2657,23,12,11
15,34,1382,3,2,1
15,34,2604,28,14,14
15,34,870,9,5,4
15,34,988,9,5,4
15,34,2136,5,1,4
15,34,2979,32,20,12
15,34,2460,19,10,9
15,34,2390,5,1,4
15,34,2729,16,7,9
15,34,4334,7,3,4
15,34,2596,4,2,2
15,34,1958,1,0,1
15,34,1079,7,3,4
15,34,856,23,8,15
15,34,4394,51,26,25
15,34,1519,14,10,4
15,34,1899,4,3,1
15,34,3100,95,45,50
15,34,4282,13,2,11
15,34,3772,19,9,10
15,34,1301,11,6,5
15,34,2538,23,13,10
15,34,2578,8,3,5
15,34,2575,19,9,10
15,34,4539,184,85,99
15,34,4371,21,9,12
15,34,3140,76,35,41
15,34,7071,31,19,12
15,34,4215,43,21,22
15,34,1761,32,16,16
15,34,4350,60,35,25
15,34,5518,34,16,18
15,34,10804,479,243,236
15,34,7642,198,88,110
15,34,4474,80,48,32
15,34,4340,123,48,75
15,34,5423,50,23,27
15,34,3732,13,9,4
15,34,3196,9,6,3
15,34,2722,8,5,3
15,34,4920,29,11,18
15,34,3113,59,31,28
15,34,3969,22,14,8
15,34,3308,18,7,11
15,34,3910,31,12,19
15,34,4838,29,15,14
15,34,2760,7,3,4
15,34,2627,54,27,27
15,34,4282,650,301,349
15,34,3423,103,52,51
15,34,2314,190,87,103
15,34,2606,17,11,6
15,34,2938,88,45,43
15,34,9051,78,37,41
15,34,3674,16,9,7
15,34,4361,119,61,58
15,34,3219,160,84,76
15,34,2575,100,51,49
15,34,2569,87,42,45
15,34,2959,155,76,79
15,34,2436,96,54,42
15,34,2379,41,22,19
15,34,2535,40,21,19
15,34,6897,480,225,255
15,34,3115,24,10,14
15,34,3578,7,2,5
15,34,3460,28,17,11
15,34,2327,19,11,8
15,34,1849,21,9,12
15,34,2232,29,16,13
15,34,1670,8,5,3
15,34,2150,9,5,4
15,34,2471,68,32,36
15,34,1190,6,4,2
15,34,1147,7,4,3
15,34,2433,15,7,8
15,34,1332,16,7,9
15,34,2828,22,11,11
15,34,4048,13,7,6
15,34,1561,13,7,6
15,34,1870,11,7,4
15,34,2804,8,5,3
15,34,2660,5,2,3
15,34,1795,32,19,13
15,34,908,39,23,16
15,34,643,209,97,112
15,34,1862,292,145,147
15,34,1712,10,6,4
15,34,2501,38,21,17
15,34,2686,13,5,8
15,34,1107,15,8,7
15,34,2565,18,11,7
15,34,2115,18,10,8
15,34,2653,24,9,15
15,34,1741,54,22,32
15,34,1414,13,11,2
15,34,2021,16,8,8
15,34,2512,16,7,9
15,34,1529,3,1,2
15,34,2711,11,8,3
15,34,1118,6,3,3
15,34,1985,4,1,3
15,34,2026,28,12,16
15,34,1974,21,11,10
15,34,1526,4,2,2
15,34,1153,110,58,52
15,34,1069,45,22,23
15,34,1117,57,27,30
15,34,1822,7,5,2
15,34,2015,82,46,36
15,34,1796,10,6,4
15,34,1957,637,327,310
15,34,1449,913,488,425
15,34,2149,8,5,3
15,34,1944,52,25,27
15,34,2093,54,30,24
15,34,1566,21,9,12
15,34,2031,21,10,11
15,34,5319,46,23,23
15,34,4050,68,33,35
15,34,2051,28,17,11
15,34,1118,1,1,0
15,34,1487,10,4,6
15,34,1327,2,1,1
15,34,2327,31,14,17
15,34,2037,27,13,14
15,34,2159,51,26,25
15,34,1510,2,0,2
15,34,1496,13,5,8
15,34,825,25,13,12
15,34,893,10,6,4
15,34,2797,20,9,11
15,34,3063,8,6,2
15,34,1638,8,2,6
15,34,1635,9,5,4
15,34,1845,13,7,6
15,34,2130,17,6,11
15,34,1582,3,2,1
15,34,2154,9,5,4
15,34,1845,10,7,3
15,34,1350,18,8,10
15,34,1723,15,4,11
15,34,1890,13,7,6
15,34,1633,129,72,57
15,34,2272,31,14,17
15,34,2702,155,80,75
15,34,1725,4,2,2
15,34,1920,20,12,8
15,34,2208,25,12,13
15,34,2703,29,13,16
15,34,2353,8,3,5
15,34,2299,11,5,6
15,34,1509,8,5,3
15,34,1079,3,2,1
15,34,3564,16,6,10
15,34,1485,7,4,3
15,34,1627,18,10,8
15,34,1592,0,0,0
15,34,1702,161,96,65
15,34,1231,22,10,12
15,34,1108,20,8,12
15,34,1221,2,0,2
15,34,1347,35,17,18
15,34,1082,1,0,1
15,34,1344,33,16,17
15,34,1461,90,51,39
15,34,1573,30,14,16
15,34,1332,6,3,3
15,34,1894,11,6,5
15,34,1440,19,10,9
15,34,2918,12,7,5
15,34,4096,65,32,33
15,34,2300,59,29,30
15,34,4529,153,80,73
15,34,1781,7,2,5
15,34,1575,12,6,6
15,34,1495,5,3,2
15,34,3014,12,9,3
15,34,1886,138,72,66
15,34,1142,6,0,6
15,34,1314,34,16,18
15,34,1225,3,1,2
15,34,1617,7,4,3
15,34,3986,24,12,12
15,34,3063,35,16,19
15,34,3583,9,5,4
15,34,1219,8,2,6
15,34,2404,26,10,16
15,34,14598,375,206,169
15,34,1269,8,3,5
15,34,1403,12,6,6
15,34,984,4,0,4
15,34,8830,286,139,147
15,34,6334,70,36,34
15,34,1571,16,8,8
15,34,3960,35,18,17
15,34,3903,192,102,90
15,34,3454,24,9,15
15,34,2261,18,12,6
15,34,1033,0,0,0
15,34,1228,15,8,7
15,34,1586,4,3,1
15,34,1674,3,1,2
15,34,1372,6,3,3
15,34,2389,109,58,51
15,34,1212,65,36,29
15,34,3441,44,20,24
15,34,2700,18,8,10
15,34,2039,30,11,19
15,34,1667,12,7,5
15,34,1356,38,25,13
15,34,2285,40,24,16
15,34,1385,5,2,3
15,34,2250,23,13,10
15,34,502,1,0,1
15,34,2266,45,26,19
15,34,1878,167,79,88
15,34,2178,33,14,19
15,34,1963,35,12,23
15,34,1356,16,6,10
15,34,839,10,7,3
15,34,1355,16,6,10
15,34,1293,12,5,7
15,34,1374,51,25,26
15,34,2085,56,28,28
15,34,1518,68,37,31
15,34,3203,13,9,4
15,34,2870,60,29,31
15,34,3413,245,132,113
15,34,2556,27,13,14
15,34,1976,27,15,12
15,34,2845,14,3,11
15,34,680,16,6,10
15,34,1210,20,12,8
15,34,2213,36,16,20
15,34,2845,11,9,2
15,34,2728,7,3,4
15,34,2357,9,2,7
15,34,2426,7,4,3
15,34,2392,48,26,22
15,34,2504,29,15,14
15,34,1629,6,2,4
15,34,1471,2,1,1
15,34,1658,18,11,7
15,34,1865,12,7,5
15,34,1767,17,6,11
15,34,1332,11,6,5
15,34,1018,26,13,13
15,34,1739,108,53,55
15,34,1836,32,19,13
15,34,1888,14,7,7
15,34,1892,13,5,8
15,34,2153,6,2,4
15,34,2242,15,5,10
15,34,2847,6,2,4
15,34,2726,24,12,12
15,34,900,10,5,5
15,34,1984,17,9,8
15,34,3296,33,15,18
15,34,1785,19,7,12
15,34,1195,10,2,8
15,34,1638,8,5,3
15,34,1674,16,10,6
15,34,738,15,11,4
15,34,902,15,10,5
15,34,1907,8,4,4
15,34,1823,5,2,3
15,34,2198,22,13,9
15,34,1952,2,1,1
15,34,1014,4,1,3
15,34,789,12,5,7
15,34,743,11,5,6
15,34,1287,12,6,6
15,34,1133,518,269,249
15,34,1698,74,31,43
15,34,1805,8,8,0
15,34,2287,53,28,25
15,34,2285,109,56,53
15,34,863,8,4,4
15,34,1534,32,16,16
15,34,1176,36,15,21
15,34,788,21,12,9
15,34,1985,219,125,94
15,34,1887,163,85,78
15,34,1361,4,2,2
15,34,1241,15,8,7
15,34,1107,4,2,2
15,34,1011,2,1,1
15,34,1680,25,19,6
15,34,681,17,9,8
15,34,1136,35,18,17
15,34,1316,22,5,17
15,34,1171,33,17,16
15,34,995,37,18,19
15,34,1477,60,33,27
15,34,1842,8,3,5
15,34,1919,23,12,11
15,34,2309,170,92,78
15,34,1483,50,24,26
15,34,2632,24,11,13
15,34,1100,19,7,12
15,34,1793,9,4,5
15,34,1255,6,2,4
15,34,1626,25,16,9
15,34,1666,28,15,13
15,34,1044,14,9,5
15,34,959,24,15,9
15,34,1191,49,23,26
15,34,1275,36,19,17
15,34,1064,8,4,4
15,34,1140,12,5,7
15,34,688,15,7,8
15,34,1476,8,5,3
15,34,1398,23,11,12
15,34,1755,3,3,0
15,34,1841,12,8,4
15,34,1811,24,15,9
15,34,2360,34,20,14
15,34,1668,21,11,10
15,34,2247,48,21,27
15,34,1983,17,11,6
15,34,995,33,17,16
15,34,1038,106,56,50
15,34,1047,24,13,11
15,34,1192,2,0,2
15,34,1849,87,49,38
15,34,1220,37,14,23
15,34,1051,16,6,10
15,34,1944,24,11,13
15,34,1806,25,16,9
15,34,1616,2,0,2
15,34,1633,5,4,1
15,34,1659,23,12,11
15,34,1473,50,26,24
15,34,869,11,7,4
15,34,1096,10,6,4
15,34,1670,8,4,4
15,34,1375,21,11,10
15,34,1439,11,4,7
15,34,1179,2,0,2
15,34,1258,10,1,9
15,34,2154,30,16,14
15,34,1213,5,5,0
15,34,1664,2,1,1
15,34,1129,13,6,7
15,34,1228,17,11,6
15,34,1406,30,10,20
15,34,1260,9,4,5
15,34,1475,3,2,1
15,34,1650,4,2,2
15,34,2628,24,12,12
15,34,1648,20,10,10
15,34,2342,600,305,295
15,34,2718,470,244,226
15,34,1423,28,12,16
15,34,1179,20,9,11
15,34,1472,32,15,17
15,34,1878,44,18,26
15,34,2145,90,46,44
15,34,1281,5,1,4
15,34,1241,7,4,3
15,34,2525,127,66,61
15,34,2413,11,6,5
15,34,1954,8,2,6
15,34,2149,6,3,3
15,34,1457,498,271,227
15,34,2070,123,63,60
15,34,2120,243,111,132
15,34,1994,59,27,32
15,34,2044,6,3,3
15,34,5859,73,45,28
15,34,2431,65,29,36
15,34,2354,18,7,11
15,34,2733,20,11,9
15,34,1968,9,7,2
15,34,2344,11,6,5
15,34,2725,5,4,1
15,34,1803,3,2,1
15,34,2414,59,34,25
15,34,2111,21,10,11
15,34,1679,54,23,31
15,34,2309,5,1,4
15,34,4822,47,23,24
15,34,1109,4,2,2
15,34,2016,13,7,6
15,34,1982,3,2,1
15,34,1807,0,0,0
15,34,2513,6,3,3
15,34,2476,7,3,4
15,34,1565,43,21,22
15,34,3172,15,7,8
15,34,2333,15,8,7
15,34,3961,86,48,38
15,34,1825,38,19,19
15,34,2315,65,29,36
15,34,772,18,8,10
15,34,709,3,1,2
15,34,1058,0,0,0
15,34,1163,24,12,12
15,34,389,0,0,0
15,34,6553,106,57,49
15,34,2761,31,19,12
15,34,2250,24,13,11
15,34,4237,154,80,74
15,34,1703,48,33,15
15,34,1624,34,23,11
15,34,1884,53,28,25
15,34,2133,111,65,46
15,34,1842,8,2,6
15,34,2445,87,44,43
15,34,1687,140,69,71
15,34,1567,9,4,5
15,34,1616,442,217,225
15,34,1426,6,4,2
15,34,2229,1,1,0
15,34,1844,17,6,11
15,34,1907,54,34,20
15,34,1825,33,13,20
15,34,2362,36,18,18
15,34,2043,14,10,4
15,34,1840,42,19,23
15,34,1842,13,8,5
15,34,2543,2,2,0
15,34,1704,16,12,4
15,34,7398,157,70,87
15,34,5646,80,42,38
15,34,2664,20,10,10
15,34,5532,62,35,27
15,34,2840,13,5,8
15,34,2422,5,2,3
15,34,3040,22,12,10
15,34,2233,12,8,4
15,34,2945,21,11,10
15,34,3021,23,11,12
15,34,3520,13,8,5
15,34,3124,10,5,5
15,34,2296,41,20,21
15,34,3040,42,25,17
15,34,6084,40,21,19
15,34,3352,33,13,20
15,34,21806,475,248,227
15,34,3100,61,34,27
15,34,2534,53,28,25
15,34,1979,13,5,8
15,34,5612,67,32,35
15,34,10277,224,105,119
15,34,3483,236,117,119
15,34,4843,55,24,31
15,34,1154,13,5,8
15,34,999,21,13,8
15,34,3536,23,10,13
15,34,5008,95,41,54
15,34,7230,81,41,40
15,34,3229,20,9,11
15,34,2403,51,26,25
15,34,3424,45,23,22
15,34,2810,52,28,24
15,34,2961,48,17,31
15,34,3291,32,21,11
15,34,3730,52,19,33
15,34,921,5,3,2
15,34,2849,90,41,49
15,34,1587,14,6,8
15,34,1823,15,6,9
15,34,1461,8,3,5
15,34,2329,14,7,7
15,34,1150,8,2,6
15,34,3687,101,57,44
15,34,1156,5,4,1
15,34,2121,17,5,12
15,34,5766,222,104,118
15,34,7412,595,291,304
15,34,3192,16,9,7
15,34,2384,38,18,20
15,34,1239,46,26,20
15,34,277,1,1,0
15,34,816,7,5,2
15,34,1973,16,12,4
15,34,2439,33,20,13
15,34,2665,69,35,34
15,34,4338,143,64,79
15,34,1075,3,2,1
15,34,924,16,6,10
15,34,1290,26,14,12
15,34,1061,37,16,21
15,34,1909,37,16,21
15,34,1810,64,34,30
15,34,1296,21,10,11
15,34,1504,19,8,11
15,34,2350,4,2,2
15,34,1392,16,8,8
15,34,2425,39,23,16
15,34,2664,38,17,21
15,34,1870,13,6,7
15,34,2826,18,9,9
15,34,8016,92,40,52
15,34,6229,106,49,57
15,34,1646,9,4,5
15,34,1981,34,16,18
15,34,2324,34,22,12
15,34,4312,86,45,41
15,34,1063,90,49,41
15,34,1452,7,1,6
15,34,1122,38,23,15
15,34,1397,1,0,1
15,34,702,4,1,3
15,34,4095,19,11,8
15,34,1065,3,1,2
15,34,1628,22,11,11
15,34,1096,8,6,2
15,34,3285,38,20,18
15,34,1230,8,2,6
15,34,1288,13,5,8
15,34,5807,89,47,42
15,34,2278,28,17,11
15,34,2520,51,34,17
15,34,2393,9,1,8
15,34,4513,20,11,9
15,34,1522,19,14,5
15,34,1414,3,0,3
15,34,1926,41,17,24
15,34,836,27,11,16
15,34,1102,1,0,1
15,34,741,0,0,0
15,34,1494,9,3,6
15,34,1339,3,0,3
15,34,1138,3,1,2
15,34,3214,10,5,5
15,34,9558,31,15,16
15,34,2772,23,12,11
15,34,4068,22,7,15
15,34,2869,8,3,5
15,34,1684,27,12,15
15,34,1619,10,3,7
15,34,1053,4,1,3
15,34,2739,11,4,7
15,34,3603,38,16,22
15,34,3490,22,14,8
15,34,2204,22,12,10
15,34,2345,38,23,15
15,34,3729,43,21,22
15,34,2018,15,6,9
15,34,2430,17,7,10
15,34,2112,8,4,4
15,34,1370,27,13,14
15,34,1316,19,11,8
15,34,2007,6,2,4
15,34,1542,35,21,14
15,34,1751,24,9,15
15,34,1633,26,17,9
15,34,1150,12,8,4
15,34,1207,40,19,21
15,34,1622,68,40,28
15,34,1700,39,13,26
15,34,2010,17,9,8
15,34,1594,22,10,12
15,34,1231,28,14,14
15,34,981,10,3,7
15,34,1647,16,6,10
15,34,1845,119,55,64
15,34,2598,76,36,40
15,34,2474,13,8,5
15,34,1325,7,1,6
15,34,1259,7,3,4
15,34,1278,17,10,7
15,34,1275,8,6,2
15,34,1494,9,3,6
15,34,1156,71,36,35
15,34,1630,5,4,1
15,34,1372,11,6,5
15,34,2393,23,12,11
15,34,1968,13,4,9
15,34,1261,17,12,5
15,34,1407,11,4,7
15,34,2425,26,16,10
15,34,1548,22,13,9
15,34,1195,10,5,5
15,34,1159,2,0,2
15,34,1215,198,108,90
15,34,1202,15,8,7
15,34,1066,76,41,35
15,34,868,32,14,18
15,34,1069,8,3,5
15,34,1738,23,10,13
15,34,1088,18,6,12
15,34,887,18,6,12
15,34,1567,44,21,23
15,34,1124,5,1,4
15,34,1551,7,1,6
15,34,1388,7,4,3
15,34,2076,61,28,33
15,34,1659,7,4,3
15,34,1330,29,18,11
15,34,1234,18,12,6
15,34,1515,49,30,19
15,34,1226,46,21,25
15,34,1547,17,12,5
15,34,1585,25,12,13
15,34,1562,6,4,2
15,34,1753,8,5,3
15,34,1692,12,5,7
15,34,1851,21,11,10
15,34,1114,36,20,16
15,34,954,26,11,15
15,34,2015,42,19,23
15,34,1880,23,10,13
15,34,2289,18,8,10
15,34,1930,64,37,27
15,34,1886,23,11,12
15,34,1801,3,3,0
15,34,2289,15,9,6
15,34,2458,54,29,25
15,34,1863,47,26,21
15,34,1754,42,20,22
15,34,2018,26,16,10
15,34,1858,2,1,1
15,34,983,2,2,0
15,34,2227,252,133,119
15,35,3715,14,7,7
15,35,4609,15,8,7
15,35,1196,0,0,0
15,35,1308,1,1,0
15,36,16302,372,200,172
15,36,784,16,7,9
15,36,4101,31,18,13
15,36,1271,2,0,2
15,36,10513,147,80,67
15,36,15582,497,252,245
15,36,2366,29,15,14
15,36,0,0,0,0
15,36,55,0,0,0
15,36,5741,50,24,26
15,36,5755,62,32,30
15,36,5204,24,17,7
15,36,3339,35,15,20
15,36,1812,33,21,12
15,36,1506,91,51,40
15,36,2095,7,3,4
15,36,1643,3,2,1
15,36,1834,16,8,8
15,37,4767,37,16,21
15,37,1721,4,0,4
15,37,2517,0,0,0
15,37,2631,36,21,15
15,37,3551,15,6,9
15,37,4381,31,16,15
15,37,1024,6,4,2
15,37,4734,67,23,44
15,37,4295,27,16,11
15,37,2982,16,12,4
15,37,615,0,0,0
15,37,2663,19,12,7
15,37,1166,12,6,6
15,37,3238,19,8,11
15,37,3650,13,6,7
15,37,2896,3,1,2
15,38,2581,24,8,16
15,38,1312,28,11,17
15,38,1585,12,4,8
15,38,4618,89,42,47
15,38,5004,38,16,22
15,38,7333,73,30,43
15,38,3018,12,4,8
15,38,3270,119,59,60
15,38,4920,135,66,69
15,38,3151,35,13,22
15,38,2453,46,25,21
15,38,1866,25,13,12
15,38,1144,15,7,8
15,38,1151,11,9,2
15,38,3628,28,14,14
15,38,7925,1021,513,508
15,38,4588,61,37,24
15,38,1633,15,6,9
15,38,2149,52,32,20
15,38,1532,18,12,6
15,38,1730,14,7,7
15,38,2254,111,66,45
15,38,1984,44,31,13
15,38,4240,83,30,53
15,38,3756,45,26,19
15,38,1839,7,2,5
15,38,2283,16,10,6
15,38,7140,201,98,103
15,38,3354,22,13,9
15,38,2423,130,61,69
15,38,4767,145,74,71
15,38,2497,82,43,39
15,38,12637,246,114,132
15,38,17024,539,272,267
15,38,4088,51,23,28
15,38,10049,209,96,113
15,38,6666,113,59,54
15,38,2129,10,8,2
15,38,3526,48,26,22
15,38,3108,69,33,36
15,38,206,1,0,1
15,38,4533,17,8,9
15,38,8243,105,45,60
15,38,0,0,0,0
15,38,23607,416,242,174
15,38,1824,81,47,34
15,38,1973,58,26,32
15,38,4378,315,175,140
15,38,1953,54,29,25
15,38,2273,86,49,37
15,38,1266,108,67,41
15,38,1567,57,31,26
15,38,1337,21,9,12
15,38,1202,198,90,108
15,38,2302,33,12,21
15,38,2151,4,3,1
15,38,1107,32,14,18
15,38,1400,7,4,3
15,38,2065,34,18,16
15,38,2328,17,9,8
15,38,1348,20,15,5
15,38,3492,95,55,40
15,38,1863,12,8,4
15,38,1910,9,2,7
15,38,4439,31,16,15
15,38,3252,8,4,4
15,38,3706,20,10,10
15,38,2008,21,12,9
15,38,6077,19,10,9
15,38,2583,22,9,13
15,38,2783,84,34,50
15,38,3501,101,45,56
15,38,3340,97,45,52
15,38,6701,261,121,140
15,38,5000,67,33,34
15,38,4233,41,19,22
15,39,3642,27,15,12
15,39,3592,530,278,252
15,39,2572,222,118,104
15,39,2553,13,7,6
15,39,119,0,0,0
15,40,16821,401,232,169
15,40,5969,51,29,22
15,40,2265,79,43,36
15,40,6037,130,69,61
15,40,7507,187,92,95
15,40,6819,398,208,190
15,40,1811,5,1,4
15,40,2318,13,6,7
15,40,2843,45,19,26
15,122,8211,151,77,74
15,122,1414,8,4,4
15,122,1244,6,4,2
15,122,3334,9,2,7
15,40,1198,14,12,2
15,40,21640,170,92,78
15,40,14980,104,42,62
15,40,1815,40,19,21
15,40,2120,23,9,14
15,40,1635,1,0,1
15,40,3880,58,32,26
15,40,2324,19,9,10
15,40,5988,85,44,41
15,40,4469,93,47,46
15,40,1225,30,15,15
15,40,5809,191,105,86
15,40,1943,127,72,55
15,40,6145,338,166,172
15,40,6030,322,165,157
15,40,1800,16,7,9
15,40,1249,5,0,5
15,40,775,2,2,0
15,40,2033,21,13,8
15,40,2536,32,18,14
15,40,2057,9,5,4
15,40,1667,20,8,12
15,40,1517,3,0,3
15,40,2775,10,3,7
15,40,2224,52,26,26
15,40,1299,26,14,12
15,122,2634,36,16,20
15,122,2160,8,3,5
15,122,2632,27,12,15
15,122,3274,34,18,16
15,122,3917,117,66,51
15,122,2756,24,10,14
15,122,2942,73,36,37
15,122,2454,43,24,19
15,40,2923,58,35,23
15,40,2750,17,6,11
15,40,2047,25,13,12
15,40,2417,33,18,15
15,40,798,3,0,3
15,40,1019,1,1,0
15,40,3711,105,57,48
15,40,2166,24,11,13
15,40,2568,117,59,58
15,40,2816,39,19,20
15,40,5974,58,25,33
15,40,2839,80,38,42
15,40,2510,20,8,12
15,40,2659,22,11,11
15,40,2529,26,13,13
15,40,1715,10,4,6
15,40,2763,28,13,15
15,40,2610,109,57,52
15,40,2200,49,31,18
15,40,1678,31,12,19
15,40,3943,3,3,0
15,40,3007,51,25,26
15,40,1931,68,30,38
15,40,1855,45,23,22
15,40,1960,50,20,30
15,40,2324,33,16,17
15,40,5749,37,17,20
15,40,7705,102,59,43
15,40,3959,22,13,9
15,40,3042,31,16,15
15,40,3511,13,5,8
15,40,5629,95,52,43
15,40,9836,167,79,88
15,40,5613,117,66,51
15,40,1610,7,2,5
15,40,3574,16,9,7
15,40,7694,37,25,12
15,40,3594,24,12,12
15,40,4276,11,5,6
15,40,8607,153,85,68
15,40,11700,208,114,94
15,41,2029,28,16,12
15,41,1837,10,5,5
15,41,1461,21,9,12
15,41,1973,30,16,14
15,41,976,20,9,11
15,41,1925,35,19,16
15,41,2522,44,18,26
15,41,228,2,0,2
15,41,7152,137,73,64
15,41,1675,5,4,1
15,41,2649,8,3,5
15,41,1474,5,2,3
15,41,2216,7,6,1
15,41,816,0,0,0
15,41,1824,19,11,8
15,41,2381,31,18,13
15,41,923,9,5,4
15,41,1479,3,1,2
15,41,1216,10,5,5
15,42,1325,0,0,0
15,42,1443,20,9,11
15,42,593,2,2,0
15,42,582,3,1,2
15,42,1493,8,4,4
15,43,1728,8,5,3
15,43,2475,62,22,40
15,43,4148,48,31,17
15,43,2203,14,5,9
15,43,962,3,3,0
15,43,3978,11,5,6
15,43,648,4,1,3
15,43,5252,13,6,7
15,43,2383,1,1,0
15,43,6775,44,20,24
15,43,3863,12,7,5
15,43,5940,19,8,11
15,43,5075,15,11,4
15,43,238,0,0,0
15,43,3051,0,0,0
15,43,2797,40,18,22
15,43,3488,41,20,21
15,43,4406,21,8,13
15,43,3346,59,24,35
15,43,4134,25,14,11
15,43,3410,5,3,2
15,43,3723,26,13,13
15,43,4612,8,4,4
15,43,3086,6,2,4
15,43,4072,9,4,5
15,43,6029,16,5,11
15,43,5483,15,8,7
15,43,2282,5,3,2
15,43,2524,10,7,3
15,43,4483,12,6,6
15,43,1716,6,2,4
15,43,3363,5,4,1
15,43,5784,7,3,4
15,43,1718,1,1,0
15,43,1115,5,4,1
15,43,2467,7,5,2
15,43,1210,0,0,0
15,43,1341,22,11,11
15,43,3179,27,14,13
15,43,3832,61,24,37
15,43,5191,13,7,6
15,43,4382,41,19,22
15,43,878,4,2,2
15,43,4624,13,7,6
15,43,3759,40,22,18
15,43,675,1,1,0
15,44,4212,54,27,27
15,44,5819,37,12,25
15,44,4843,37,23,14
15,44,7454,48,28,20
15,44,4087,35,18,17
15,44,2371,20,10,10
15,44,297,9,4,5
15,45,3367,31,16,15
15,45,4422,14,12,2
15,45,4093,20,13,7
15,45,912,0,0,0
15,125,4579,135,65,70
15,125,3365,61,36,25
15,125,6939,123,60,63
15,45,3603,38,20,18
15,45,1390,4,1,3
15,45,1193,15,10,5
15,45,825,2,2,0
15,45,1035,19,11,8
15,45,1340,3,2,1
15,45,1420,43,20,23
15,45,1869,9,3,6
15,45,772,30,16,14
15,45,2084,17,8,9
15,46,3620,95,61,34
15,46,1410,7,4,3
15,46,1882,3,0,3
15,46,2136,1,1,0
15,46,1617,4,1,3
15,46,2021,24,14,10
15,46,266,6,1,5
15,46,2330,6,5,1
15,46,2597,26,13,13
15,46,872,1,0,1
15,46,138,2,0,2
15,46,1439,15,8,7
15,46,965,5,3,2
15,46,2180,4,2,2
15,46,1411,2,1,1
15,46,2032,7,6,1
15,46,854,0,0,0
15,46,1854,1,1,0
15,46,332,0,0,0
15,46,507,0,0,0
15,46,1502,6,1,5
15,46,2700,38,23,15
15,46,2241,12,7,5
15,46,2118,143,79,64
15,46,1155,18,6,12
15,46,1345,7,3,4
15,46,2614,11,6,5
15,46,10149,381,191,190
15,46,2612,30,14,16
15,46,2983,21,14,7
15,46,1056,4,3,1
15,46,4685,14,11,3
15,46,1789,3,2,1
15,46,2085,21,11,10
15,46,905,4,3,1
15,46,2749,29,17,12
15,46,3648,0,0,0
15,46,3094,7,5,2
15,46,1198,91,48,43
15,46,751,0,0,0
15,46,636,25,11,14
15,46,1503,10,4,6
15,46,622,2,1,1
15,46,219,8,4,4
15,47,798,6,4,2
15,47,1184,2,2,0
15,47,1172,3,1,2
15,47,1063,2,1,1
15,47,4798,14,10,4
15,47,744,2,2,0
15,47,4204,19,13,6
15,47,2452,18,13,5
15,47,1110,0,0,0
15,47,1949,25,14,11
15,48,4370,11,7,4
15,48,2419,23,10,13
15,48,2305,1,1,0
15,48,1831,5,5,0
15,48,3640,3,2,1
15,48,3130,14,6,8
15,48,2400,10,7,3
15,48,3151,7,3,4
15,48,2087,111,47,64
15,48,2345,24,10,14
15,48,1133,14,8,6
15,48,2580,545,281,264
15,48,2785,217,114,103
15,48,1507,799,444,355
15,48,5100,5,1,4
15,48,5422,12,7,5
15,48,3295,91,53,38
15,48,2532,69,50,19
15,48,3120,10,7,3
15,48,1490,0,0,0
15,48,2213,14,10,4
15,48,785,47,23,24
15,48,1417,3,1,2
15,48,4071,4,1,3
15,48,2667,30,14,16
15,48,2883,14,8,6
15,48,1273,4,2,2
15,48,3029,47,28,19
15,48,246,0,0,0
15,48,1254,4,4,0
15,49,1950,22,11,11
15,49,954,5,2,3
15,49,1384,6,4,2
15,49,1338,6,3,3
15,49,2867,14,9,5
15,49,265,0,0,0
15,49,514,0,0,0
15,49,2553,23,10,13
15,49,5058,7,1,6
15,49,1458,28,12,16
15,49,3566,160,89,71
15,49,2383,39,19,20
15,49,8263,23,11,12
15,49,3359,4,2,2
15,49,3674,42,20,22
15,49,2127,25,12,13
15,49,1149,1,0,1
15,49,2142,2,2,0
15,49,1321,0,0,0
15,49,2291,1,0,1
15,49,1741,1,1,0
15,49,1014,0,0,0
15,49,2350,3,2,1
15,49,3378,15,7,8
15,49,2342,70,34,36
15,49,2600,5,1,4
15,49,1781,6,2,4
15,49,2401,20,7,13
15,49,3128,89,46,43
15,50,3022,20,7,13
15,50,3750,75,33,42
15,50,2722,409,200,209
15,50,3924,41,27,14
15,50,880,1,1,0
15,51,2487,25,7,18
15,51,2141,42,14,28
15,51,4524,69,35,34
15,51,4098,166,91,75
15,51,2164,9,4,5
15,51,3172,45,23,22
15,51,4655,69,38,31
15,51,3873,63,30,33
15,52,4105,24,11,13
15,52,9690,110,61,49
15,52,5826,76,34,42
15,52,2083,12,7,5
15,52,2669,24,13,11
15,52,1639,9,4,5
15,52,1142,0,0,0
15,52,829,0,0,0
15,52,1661,1,0,1
15,52,4091,17,8,9
15,52,837,1,0,1
15,52,1940,6,2,4
15,52,2992,3,1,2
15,52,2379,10,5,5
15,52,3903,14,7,7
15,52,1304,8,4,4
15,52,2321,2,1,1
15,52,1442,0,0,0
15,52,3088,2,2,0
15,52,21,0,0,0
15,52,4899,51,17,34
15,52,2959,6,2,4
15,52,2782,444,235,209
15,52,2515,76,42,34
15,52,1806,7,3,4
15,52,2986,2,1,1
15,52,2793,3,2,1
15,52,4195,3,1,2
15,52,3599,10,9,1
15,52,4364,20,12,8
15,52,4364,46,18,28
15,52,4199,5,2,3
15,52,4714,17,9,8
15,52,4221,9,4,5
15,52,2660,4,1,3
15,52,3032,11,4,7
15,52,1809,17,8,9
15,52,660,4,1,3
15,52,4014,39,13,26
15,52,3955,40,17,23
15,52,3385,19,13,6
15,52,4049,36,20,16
15,52,4215,33,14,19
15,52,2847,31,11,20
15,52,4334,33,19,14
15,53,1869,306,151,155
15,53,1908,24,16,8
15,53,2852,16,6,10
15,53,2448,8,5,3
15,53,3113,31,13,18
15,53,2644,967,476,491
15,53,2842,28,13,15
15,53,3987,22,12,10
15,53,800,7,5,2
15,53,360,3,1,2
15,53,709,12,7,5
15,53,1818,392,207,185
15,53,953,2,1,1
15,53,550,1,1,0
15,53,1624,27,17,10
15,53,805,3,1,2
15,54,1423,26,13,13
15,54,1324,29,14,15
15,54,5826,388,179,209
15,54,5323,76,32,44
15,54,4528,20,12,8
15,54,5768,99,45,54
15,54,3870,47,29,18
15,54,1894,47,27,20
15,54,2721,39,19,20
15,54,3665,43,20,23
15,54,2642,84,40,44
15,54,2622,65,37,28
15,54,4023,277,127,150
15,54,452,16,9,7
15,54,10179,246,123,123
15,54,4960,38,16,22
15,55,3063,71,35,36
15,55,1556,8,4,4
15,55,2162,36,20,16
15,55,1608,94,49,45
15,55,1962,25,12,13
15,55,2750,14,10,4
15,55,6404,60,34,26
15,55,2872,36,18,18
15,55,2136,10,5,5
15,55,2517,41,24,17
15,55,1630,3,0,3
15,55,1249,10,4,6
15,55,1636,38,19,19
15,55,1787,25,17,8
15,55,1848,6,4,2
15,55,2037,42,21,21
15,55,11031,319,173,146
15,55,1643,113,63,50
15,55,977,7,4,3
15,55,777,8,5,3
15,55,1758,7,5,2
15,55,1526,15,9,6
15,55,2450,76,37,39
15,55,1297,48,28,20
15,55,1906,26,12,14
15,55,1400,130,67,63
15,55,7197,254,136,118
15,55,2913,82,36,46
15,55,3635,36,20,16
15,55,983,8,2,6
15,55,670,11,6,5
15,55,946,0,0,0
15,55,904,7,4,3
15,55,1345,17,9,8
15,55,3538,84,44,40
15,55,2307,17,7,10
15,55,1272,14,7,7
15,55,2347,9,5,4
15,55,2259,30,14,16
15,55,1304,11,6,5
15,55,1863,25,13,12
15,55,702,57,33,24
15,55,2813,44,22,22
15,55,1809,210,115,95
15,55,2093,10,4,6
15,55,1225,31,20,11
15,55,1374,41,25,16
15,55,2314,2,1,1
15,55,10231,121,60,61
15,55,6889,76,31,45
15,55,6258,129,66,63
15,55,2291,10,4,6
15,55,1455,5,3,2
15,55,1385,6,2,4
15,55,1667,30,15,15
15,55,1352,20,7,13
15,55,3846,75,38,37
15,55,3439,55,28,27
15,55,555,10,4,6
15,55,667,7,3,4
15,55,1582,20,8,12
15,55,1827,20,11,9
15,55,1084,33,16,17
15,55,1599,17,8,9
15,55,3700,40,19,21
15,55,2369,87,51,36
15,55,1845,58,29,29
15,55,2091,10,5,5
15,55,4218,217,98,119
15,55,5235,125,60,65
15,55,2908,36,17,19
15,55,3752,105,58,47
15,55,1797,30,14,16
15,55,1835,127,65,62
15,55,5846,46,16,30
15,55,8838,405,208,197
15,55,776,1,1,0
15,55,3867,7,5,2
15,55,3831,11,3,8
15,55,7317,119,55,64
15,55,4214,215,107,108
15,55,3503,123,65,58
15,55,2572,50,23,27
15,55,8663,57,28,29
15,55,4180,47,22,25
15,55,5049,42,27,15
15,56,1921,26,11,15
15,56,6355,135,63,72
15,56,2678,8,3,5
15,56,2853,21,14,7
15,57,2442,6,2,4
15,57,1085,15,6,9
15,57,1031,7,2,5
15,57,2587,2,1,1
15,57,1333,7,4,3
15,57,816,1,1,0
15,57,2385,2,1,1
15,57,2578,17,7,10
15,57,1207,4,2,2
15,57,62,0,0,0
15,57,3080,18,10,8
15,57,1621,1,0,1
15,57,1421,7,4,3
15,57,1567,18,7,11
15,57,3744,15,6,9
15,57,1473,0,0,0
15,57,1102,17,9,8
15,57,3002,78,38,40
15,58,1850,44,23,21
15,58,911,5,4,1
15,58,1003,2,0,2
15,58,1218,23,15,8
15,58,1415,13,6,7
15,58,887,2,1,1
15,58,1054,1,1,0
15,58,946,0,0,0
15,58,1158,5,3,2
15,58,858,11,5,6
15,58,1285,31,15,16
15,58,1688,11,5,6
15,58,1707,10,3,7
15,58,941,7,4,3
15,58,703,1,1,0
15,58,1679,10,3,7
15,58,1777,24,14,10
15,58,1417,19,9,10
15,58,1268,33,18,15
15,58,1766,43,17,26
15,58,1287,21,8,13
15,58,1920,33,17,16
15,58,399,4,1,3
15,58,1372,18,11,7
15,58,1776,25,15,10
15,58,806,10,4,6
15,58,674,3,3,0
15,58,1008,2,2,0
15,58,745,1,1,0
15,58,1364,56,28,28
15,58,1624,7,4,3
15,58,1793,7,2,5
15,58,977,3,1,2
15,58,1243,4,2,2
15,58,1825,4,1,3
15,58,1311,13,6,7
15,58,1330,18,10,8
15,58,1422,7,3,4
15,58,1565,95,51,44
15,58,1365,8,4,4
15,58,932,5,2,3
15,58,1252,3,2,1
15,58,924,0,0,0
15,58,1687,3,2,1
15,58,1091,24,16,8
15,58,990,31,10,21
15,58,1775,53,32,21
15,58,1268,18,7,11
15,58,1285,19,12,7
15,58,1661,4,4,0
15,58,1322,37,15,22
15,58,1027,109,52,57
15,58,843,134,62,72
15,58,1804,164,80,84
15,58,1378,4,1,3
15,58,2507,12,5,7
15,58,1341,39,16,23
15,58,2069,18,9,9
15,58,1178,23,11,12
15,58,1413,13,5,8
15,58,1493,9,3,6
15,58,830,10,5,5
15,58,2064,117,53,64
15,58,2009,21,11,10
15,58,2468,144,72,72
15,58,2380,18,9,9
15,58,2465,28,19,9
15,58,2442,26,14,12
15,58,2792,20,11,9
15,58,2094,14,7,7
15,58,2246,10,6,4
15,58,1973,26,11,15
15,58,1966,11,5,6
15,58,2379,40,12,28
15,58,1853,7,5,2
15,58,2563,18,12,6
15,58,2682,49,18,31
15,58,3429,60,29,31
15,58,3742,68,37,31
15,58,2792,20,11,9
15,58,2078,38,19,19
15,58,2250,54,27,27
15,58,2768,62,32,30
15,58,2785,37,20,17
15,58,2909,165,83,82
15,58,3149,68,34,34
15,58,2855,8,4,4
15,58,1715,9,1,8
15,58,1352,21,9,12
15,58,2323,6,3,3
15,58,2299,32,21,11
15,58,2490,24,13,11
15,58,2474,32,17,15
15,58,1155,8,6,2
15,58,2257,94,51,43
15,58,2158,21,12,9
15,58,2646,24,9,15
15,58,1904,10,5,5
15,58,1783,68,35,33
15,58,1947,6,3,3
15,58,2035,3,1,2
15,58,1933,30,16,14
15,58,3022,47,23,24
15,58,2785,96,51,45
15,58,3030,265,128,137
15,58,4373,301,161,140
15,58,2490,67,38,29
15,58,3847,128,61,67
15,58,2624,19,11,8
15,58,2493,7,2,5
15,58,1907,9,3,6
15,58,712,4,0,4
15,58,1154,13,4,9
15,58,3578,63,31,32
15,58,1576,38,26,12
15,58,1230,25,12,13
15,58,1226,34,19,15
15,58,1755,27,13,14
15,58,1348,24,10,14
15,58,849,9,6,3
15,58,797,24,7,17
15,58,1002,47,27,20
15,58,1293,23,17,6
15,58,1219,54,29,25
15,58,1282,5,3,2
15,58,1476,16,7,9
15,58,1219,46,21,25
15,58,1910,17,11,6
15,58,1989,29,17,12
15,58,1417,8,4,4
15,58,1347,3,0,3
15,58,890,2,1,1
15,58,1805,15,5,10
15,58,1553,9,4,5
15,58,1652,53,27,26
15,58,2669,131,73,58
15,58,621,7,6,1
15,58,2001,58,25,33
15,58,0,0,0,0
15,58,0,0,0,0
15,58,0,0,0,0
15,58,0,0,0,0
15,58,824,20,7,13
15,58,4774,48,19,29
15,58,1335,2,1,1
15,58,1661,10,4,6
15,58,663,13,3,10
15,58,804,9,2,7
15,58,825,3,3,0
15,58,1736,27,12,15
15,58,1389,15,9,6
15,58,1282,7,4,3
15,58,835,12,8,4
15,58,862,1,1,0
15,58,1314,17,6,11
15,58,706,23,9,14
15,58,1194,4,3,1
15,58,1430,3,2,1
15,58,999,22,12,10
15,58,1238,16,11,5
15,58,1103,24,14,10
15,58,938,15,7,8
15,58,1764,19,9,10
15,58,1125,13,6,7
15,58,934,7,3,4
15,58,900,3,2,1
15,58,1299,1,0,1
15,58,2090,22,10,12
15,58,917,5,5,0
15,58,1371,35,20,15
15,58,695,12,9,3
15,58,943,15,8,7
15,58,3133,128,76,52
15,58,2557,27,11,16
15,58,611,8,4,4
15,58,1789,19,10,9
15,58,1033,29,17,12
15,58,670,9,5,4
15,58,1734,4,2,2
15,58,1255,16,9,7
15,58,1607,30,14,16
15,58,3410,37,18,19
15,58,2791,14,5,9
15,58,2442,33,16,17
15,58,3782,55,33,22
15,58,2190,27,16,11
15,58,1110,8,4,4
15,58,1697,10,3,7
15,58,5978,278,134,144
15,58,3447,50,27,23
15,58,3655,48,21,27
15,58,3333,82,34,48
15,58,6147,103,42,61
15,58,5134,27,11,16
15,58,4024,84,44,40
15,58,2692,23,9,14
15,58,3441,133,74,59
15,58,2504,45,21,24
15,58,2057,26,17,9
15,58,1770,10,9,1
15,58,2767,21,10,11
15,58,1272,21,11,10
15,58,1817,27,13,14
15,58,1596,17,10,7
15,58,1042,2,1,1
15,58,1074,1,1,0
15,58,871,29,11,18
15,58,900,2,1,1
15,58,1027,15,8,7
15,58,784,16,9,7
15,58,1101,4,3,1
15,58,643,3,1,2
15,58,886,4,1,3
15,58,1215,13,5,8
15,58,304,1,1,0
15,58,1007,2,0,2
15,58,1764,2,2,0
15,58,2280,21,7,14
15,58,1367,8,4,4
15,58,1011,8,4,4
15,58,946,6,2,4
15,58,5682,91,53,38
15,58,1951,30,21,9
15,58,2895,41,16,25
15,58,8881,292,154,138
15,58,3562,111,57,54
15,58,827,71,36,35
15,58,1325,11,6,5
15,58,1146,7,4,3
15,58,1670,13,5,8
15,58,1308,0,0,0
15,58,1526,7,2,5
15,58,971,9,4,5
15,58,1515,18,8,10
15,58,1542,23,10,13
15,58,1485,19,7,12
15,58,1431,43,23,20
15,58,1340,32,20,12
15,58,874,13,6,7
15,58,1053,9,4,5
15,58,1486,17,9,8
15,58,1084,5,3,2
15,58,988,3,2,1
15,58,1077,22,14,8
15,58,1076,21,10,11
15,58,1192,50,28,22
15,58,1396,26,13,13
15,58,1386,27,14,13
15,58,901,27,19,8
15,58,997,13,8,5
15,58,1209,3,3,0
15,58,1769,10,4,6
15,58,298,2,1,1
15,58,71,0,0,0
15,58,1291,3,2,1
15,58,2814,10,7,3
15,58,357,1,0,1
15,58,2322,45,23,22
15,58,2466,58,30,28
15,58,2063,288,133,155
15,58,1885,26,13,13
15,58,1258,25,12,13
15,58,773,13,6,7
15,58,542,2,2,0
15,58,823,29,12,17
15,58,691,6,0,6
15,58,1409,29,13,16
15,58,782,55,36,19
15,58,482,11,7,4
15,58,623,6,1,5
15,58,804,0,0,0
15,58,904,72,42,30
15,58,699,33,18,15
15,58,937,91,47,44
15,58,511,16,6,10
15,58,1279,109,58,51
15,58,1378,12,6,6
15,58,598,2,2,0
15,58,634,2,1,1
15,58,794,4,3,1
15,58,724,0,0,0
15,58,395,0,0,0
15,58,483,4,3,1
15,58,1205,8,2,6
15,58,952,2,2,0
15,58,1021,11,6,5
15,58,1377,8,3,5
15,58,1369,2,2,0
15,58,571,46,18,28
15,58,783,17,11,6
15,58,632,0,0,0
15,58,562,1,1,0
15,58,1046,5,0,5
15,58,924,1,0,1
15,58,1297,49,24,25
15,58,907,25,13,12
15,58,322,2,0,2
15,58,896,7,4,3
15,58,1204,15,8,7
15,58,705,6,4,2
15,58,2031,7,4,3
15,58,589,0,0,0
15,58,750,22,9,13
15,58,461,13,7,6
15,58,439,4,2,2
15,58,630,0,0,0
15,58,300,7,5,2
15,58,554,28,15,13
15,58,2184,11,5,6
15,58,2242,145,87,58
15,58,1489,87,47,40
15,58,866,7,5,2
15,58,1813,10,6,4
15,58,2181,28,18,10
15,58,1782,55,27,28
15,58,5451,52,22,30
15,58,2471,57,28,29
15,58,2961,24,13,11
15,58,4138,83,42,41
15,58,3056,33,16,17
15,58,1580,3,1,2
15,58,1396,13,6,7
15,58,2418,28,17,11
15,58,706,12,6,6
15,58,1080,1,0,1
15,58,2413,4,2,2
15,58,1796,17,9,8
15,58,2991,52,24,28
15,58,3221,77,41,36
15,58,2621,43,19,24
15,58,3566,10,5,5
15,58,3581,96,56,40
15,58,3139,68,36,32
15,58,2525,22,10,12
15,58,2146,98,50,48
15,58,3237,22,10,12
15,58,2352,17,11,6
15,58,1293,14,7,7
15,58,1279,13,4,9
15,58,2400,12,5,7
15,58,1368,53,29,24
15,58,3449,327,164,163
15,58,2479,47,23,24
15,58,3613,46,17,29
15,58,3174,53,33,20
15,58,7764,169,82,87
15,58,3669,48,25,23
15,58,3717,11,5,6
15,58,2648,326,166,160
15,58,2895,27,8,19
15,58,1113,6,2,4
15,58,776,4,3,1
15,58,1884,27,11,16
15,58,1928,73,39,34
15,58,3285,131,62,69
15,58,1830,28,18,10
15,58,1600,9,6,3
15,58,2217,29,18,11
15,58,1352,4,2,2
15,58,2235,69,39,30
15,58,1752,33,18,15
15,58,1834,24,11,13
15,58,1823,16,8,8
15,58,1119,12,8,4
15,58,1721,8,4,4
15,58,1686,4,2,2
15,58,1128,3,1,2
15,58,1132,7,4,3
15,58,1162,3,2,1
15,58,2560,18,9,9
15,58,1542,2,1,1
15,58,1842,8,3,5
15,58,1557,15,8,7
15,58,2264,45,25,20
15,58,1908,4,1,3
15,58,1351,25,8,17
15,58,1595,28,14,14
15,58,1725,27,14,13
15,58,2719,33,19,14
15,58,2099,8,6,2
15,58,1907,10,4,6
15,58,2863,14,8,6
15,58,3043,12,8,4
15,58,2460,18,11,7
15,58,2203,30,14,16
15,58,1463,26,14,12
15,58,2181,10,4,6
15,58,2093,28,14,14
15,58,2443,16,9,7
15,58,2672,24,14,10
15,58,2199,47,23,24
15,58,2448,13,7,6
15,58,1862,50,27,23
15,58,1854,28,14,14
15,58,1391,22,5,17
15,58,1490,25,11,14
15,58,2029,40,20,20
15,58,1638,25,12,13
15,58,3429,16,9,7
15,58,2073,12,6,6
15,58,1988,20,7,13
15,58,1591,3,0,3
15,58,1003,19,6,13
15,58,1290,24,17,7
15,58,1194,3,0,3
15,58,958,38,17,21
15,58,1549,38,21,17
15,58,1316,8,2,6
15,58,1526,16,7,9
15,58,2980,8,2,6
15,58,1633,26,12,14
15,58,1451,8,5,3
15,58,2418,109,52,57
15,58,1430,28,16,12
15,58,2537,16,5,11
15,58,2196,11,4,7
15,58,1637,16,10,6
15,58,1691,22,7,15
15,58,2113,15,8,7
15,58,3308,87,39,48
15,58,6491,31,12,19
15,58,1745,22,12,10
15,58,3841,59,32,27
15,58,3166,34,15,19
15,58,2874,190,99,91
15,58,2915,17,11,6
15,58,2531,13,8,5
15,58,1620,226,112,114
15,58,1525,11,6,5
15,58,1439,4,3,1
15,58,1084,27,15,12
15,58,2027,14,6,8
15,58,2075,11,7,4
15,58,956,35,20,15
15,58,2700,42,19,23
15,58,1276,6,1,5
15,58,2052,35,15,20
15,58,1641,18,10,8
15,58,1704,4,3,1
15,58,1376,20,6,14
15,58,996,70,37,33
15,58,847,109,49,60
15,58,1539,9,2,7
15,58,1154,26,12,14
15,58,753,53,31,22
15,58,1436,4,3,1
15,58,1067,29,16,13
15,58,1085,55,30,25
15,58,1487,10,6,4
15,58,2190,35,13,22
15,58,1736,24,10,14
15,58,1901,48,21,27
15,58,1768,40,18,22
15,58,6711,101,51,50
15,58,4907,290,155,135
15,58,21607,570,289,281
15,59,4762,45,27,18
15,59,3965,452,239,213
15,59,2497,111,56,55
15,59,1570,58,31,27
15,59,4221,119,60,59
15,59,2907,183,93,90
15,59,2778,54,22,32
15,59,1321,25,15,10
15,59,27493,1156,578,578
15,59,5400,258,128,130
15,60,6037,5,4,1
15,60,1531,1,1,0
15,60,1990,15,5,10
15,60,1445,33,22,11
15,60,1646,416,205,211
15,60,1200,15,7,8
15,60,1223,39,26,13
15,60,2431,3,2,1
15,60,1896,2,1,1
15,60,1419,19,9,10
15,60,2266,45,27,18
15,60,1358,3,0,3
15,60,1173,1,0,1
15,60,1974,3,0,3
15,60,1973,8,4,4
15,60,2231,410,216,194
15,60,2087,31,16,15
15,60,1933,47,23,24
15,60,2121,14,12,2
15,60,2105,61,34,27
15,60,1760,93,52,41
15,60,1584,53,29,24
15,60,1924,53,28,25
15,60,1446,6,2,4
15,60,1327,26,16,10
15,60,1829,30,17,13
15,60,1895,94,54,40
15,60,1806,101,51,50
15,60,1611,38,20,18
15,60,1565,15,5,10
15,60,1505,118,62,56
15,60,1566,134,65,69
15,60,1249,30,17,13
15,60,1054,18,10,8
15,60,1033,19,12,7
15,60,985,3,2,1
15,60,1845,66,32,34
15,60,1256,12,5,7
15,60,836,1,0,1
15,60,1838,89,40,49
15,60,1439,30,17,13
15,60,1643,284,144,140
15,60,1534,51,21,30
15,60,1684,10,4,6
15,60,1646,50,25,25
15,60,1058,87,48,39
15,60,1789,42,21,21
15,60,1248,7,2,5
15,60,1001,8,5,3
15,60,1640,25,11,14
15,60,2200,66,35,31
15,60,2983,42,22,20
15,60,2284,2,1,1
15,60,1151,17,9,8
15,60,1242,3,2,1
15,60,1044,0,0,0
15,60,1121,87,39,48
15,60,1102,20,12,8
15,60,1199,39,18,21
15,60,1220,1,1,0
15,60,1246,6,4,2
15,60,1580,14,10,4
15,60,1529,25,11,14
15,60,1333,93,52,41
15,60,1431,49,22,27
15,60,1661,34,19,15
15,60,1401,46,19,27
15,60,1280,31,15,16
15,60,1435,18,10,8
15,60,1237,4,2,2
15,60,1523,12,4,8
15,60,1534,24,12,12
15,60,1022,1,1,0
15,60,871,44,24,20
15,60,1204,38,21,17
15,60,3460,39,20,19
15,60,4112,68,29,39
15,60,2723,39,17,22
15,60,1361,17,6,11
15,60,1293,39,20,19
15,60,981,11,8,3
15,60,1007,10,3,7
15,60,998,13,6,7
15,60,1806,37,16,21
15,60,1723,45,23,22
15,60,1197,129,64,65
15,60,821,17,8,9
15,60,785,0,0,0
15,60,1303,11,4,7
15,60,1429,31,18,13
15,60,1582,83,47,36
15,60,1483,152,79,73
15,60,1756,36,15,21
15,60,2493,234,120,114
15,60,1274,29,17,12
15,60,1684,23,14,9
15,60,1050,19,13,6
15,60,1460,18,8,10
15,60,1684,250,111,139
15,60,1776,18,11,7
15,60,1646,8,4,4
15,60,1119,10,5,5
15,60,1559,122,55,67
15,60,2409,44,23,21
15,60,1424,62,30,32
15,60,2294,20,10,10
15,60,1610,36,16,20
15,60,1388,14,8,6
15,60,1335,54,27,27
15,60,1307,51,21,30
15,60,1182,17,9,8
15,60,1850,4,1,3
15,60,1214,134,73,61
15,60,1815,53,31,22
15,60,1318,16,9,7
15,60,1070,1,0,1
15,60,2184,13,6,7
15,60,1824,36,20,16
15,60,1479,11,5,6
15,60,930,14,4,10
15,60,1601,13,7,6
15,60,2293,15,9,6
15,60,1428,4,2,2
15,60,2186,34,12,22
15,60,1347,29,12,17
15,60,1784,12,8,4
15,60,1607,7,4,3
15,60,1303,11,6,5
15,60,1161,10,3,7
15,60,1805,31,15,16
15,60,1448,5,3,2
15,60,1959,13,3,10
15,60,1849,4,3,1
15,60,1696,30,16,14
15,60,1679,10,5,5
15,60,1109,7,3,4
15,60,1512,140,69,71
15,60,1618,3,0,3
15,60,1499,8,5,3
15,60,1496,89,42,47
15,60,2420,14,9,5
15,60,1403,8,5,3
15,60,2258,34,16,18
15,60,6895,66,38,28
15,60,1937,18,7,11
15,60,1181,2,0,2
15,60,1719,8,3,5
15,60,1554,6,4,2
15,60,1167,3,1,2
15,60,1780,7,2,5
15,60,1937,20,9,11
15,60,1895,40,22,18
15,60,1967,34,18,16
15,60,0,0,0,0
15,60,1222,11,7,4
15,60,1128,11,5,6
15,60,1837,2,1,1
15,60,3346,28,18,10
15,60,3705,41,20,21
15,60,1897,20,7,13
15,60,1669,6,3,3
15,60,1729,19,11,8
15,60,1804,8,7,1
15,60,1155,16,9,7
15,60,2029,15,9,6
15,60,1746,40,20,20
15,60,1849,13,6,7
15,60,4765,12,6,6
15,60,2765,2,1,1
15,60,3207,7,2,5
15,60,2200,7,3,4
15,60,2204,13,8,5
15,60,2193,48,27,21
15,60,2666,15,10,5
15,60,1936,5,3,2
15,60,1764,42,25,17
15,60,2324,39,20,19
15,60,1172,81,48,33
15,60,2072,26,13,13
15,60,3298,141,72,69
15,60,3211,21,9,12
15,60,2719,15,10,5
15,60,2090,15,9,6
15,60,1929,6,4,2
15,60,1917,8,4,4
15,60,1586,37,16,21
15,60,2001,5,1,4
15,60,2245,4,2,2
15,60,2075,6,2,4
15,60,2138,26,11,15
15,60,1851,71,33,38
15,60,2377,1,0,1
15,60,2120,8,2,6
15,60,1925,7,4,3
15,60,1836,15,8,7
15,60,1747,1,1,0
15,60,1601,4,2,2
15,60,1547,74,40,34
15,60,1771,18,8,10
15,60,1494,17,8,9
15,60,1764,5,3,2
15,60,1084,10,4,6
15,60,1612,24,10,14
15,60,1534,18,7,11
15,60,1083,13,5,8
15,60,1154,11,7,4
15,60,1763,70,29,41
15,60,1723,200,90,110
15,60,1499,64,28,36
15,60,1102,7,4,3
15,60,1450,54,26,28
15,60,1500,22,8,14
15,60,1442,12,6,6
15,60,1294,11,4,7
15,60,1521,8,5,3
15,60,1878,11,7,4
15,60,1711,1,1,0
15,60,1498,3,3,0
15,60,1680,21,13,8
15,60,1586,32,20,12
15,60,1224,119,69,50
15,60,1142,7,1,6
15,60,1087,4,1,3
15,60,2111,49,25,24
15,60,1551,114,62,52
15,60,1204,1,0,1
15,60,1155,1,1,0
15,60,909,16,9,7
15,60,1427,44,23,21
15,60,1265,2,1,1
15,60,897,6,5,1
15,60,2455,115,54,61
15,60,2747,88,46,42
15,60,2560,18,8,10
15,60,2306,9,6,3
15,60,2186,26,13,13
15,60,1691,3,2,1
15,60,1290,8,2,6
15,60,1520,32,20,12
15,60,1709,12,8,4
15,60,1260,29,16,13
15,60,1334,15,10,5
15,60,1397,18,12,6
15,60,1021,44,24,20
15,60,1175,35,16,19
15,60,1663,22,9,13
15,60,1229,10,4,6
15,60,840,5,3,2
15,60,1298,3,3,0
15,60,1354,15,8,7
15,60,1363,15,9,6
15,60,1565,22,13,9
15,60,1363,6,2,4
15,60,1430,24,9,15
15,60,1315,20,13,7
15,60,1206,10,6,4
15,60,2165,10,5,5
15,60,1192,1,1,0
15,60,1022,14,9,5
15,60,2046,15,8,7
15,60,2128,5,3,2
15,60,1948,10,5,5
15,60,1915,21,9,12
15,60,1623,16,7,9
15,60,1515,24,13,11
15,60,1963,131,56,75
15,60,1265,5,3,2
15,60,1138,29,17,12
15,60,1079,15,8,7
15,60,1043,39,18,21
15,60,1720,89,39,50
15,60,1397,27,16,11
15,60,1682,17,12,5
15,60,1195,36,14,22
15,60,1021,23,9,14
15,60,926,26,14,12
15,60,1208,8,2,6
15,60,1263,19,9,10
15,60,1029,7,4,3
15,60,1737,23,16,7
15,60,1840,17,9,8
15,60,859,11,3,8
15,60,1606,1,1,0
15,60,1444,2,0,2
15,60,1612,21,13,8
15,60,1934,16,7,9
15,60,1838,16,6,10
15,60,1216,1,0,1
15,60,1151,8,1,7
15,60,1293,3,2,1
15,60,1294,2,2,0
15,60,859,9,5,4
15,60,975,6,2,4
15,60,894,15,6,9
15,60,943,9,4,5
15,60,836,12,7,5
15,60,1136,6,1,5
15,60,1033,3,1,2
15,60,1652,6,2,4
15,60,2104,19,11,8
15,60,1635,5,2,3
15,60,1406,8,3,5
15,60,1696,15,7,8
15,60,1659,21,8,13
15,60,1721,7,5,2
15,60,710,7,2,5
15,60,1409,61,28,33
15,60,1240,9,4,5
15,60,1106,12,4,8
15,60,992,2,0,2
15,60,902,10,5,5
15,60,873,7,3,4
15,60,1793,9,6,3
15,60,1468,78,40,38
15,60,943,2,2,0
15,60,2017,8,5,3
15,60,1272,2,1,1
15,60,935,3,1,2
15,60,1496,35,25,10
15,60,1479,38,17,21
15,60,1093,5,1,4
15,60,1419,32,15,17
15,60,1396,27,14,13
15,60,1755,18,10,8
15,60,1163,2,0,2
15,60,1073,7,3,4
15,60,1021,6,5,1
15,60,1299,13,6,7
15,60,1300,12,7,5
15,60,1315,63,33,30
15,60,1602,4,3,1
15,60,1293,21,12,9
15,60,1794,28,11,17
15,60,776,18,10,8
15,60,1571,40,16,24
15,60,1139,12,4,8
15,60,1372,19,9,10
15,60,1308,14,7,7
15,60,635,6,4,2
15,60,1454,18,11,7
15,60,909,8,5,3
15,60,1651,8,3,5
15,60,1474,7,5,2
15,60,919,5,2,3
15,60,1187,28,13,15
15,60,1785,19,11,8
15,60,1373,17,10,7
15,60,1446,11,9,2
15,60,1215,3,2,1
15,60,1789,8,5,3
15,60,1992,5,3,2
15,60,1064,2,1,1
15,60,1370,18,9,9
15,60,1002,3,2,1
15,60,1098,2,2,0
15,60,1699,3,1,2
15,60,971,19,12,7
15,60,1860,21,11,10
15,60,1190,29,12,17
15,60,1621,26,12,14
15,60,2048,28,14,14
15,60,1160,54,22,32
15,60,1731,130,69,61
15,60,1253,6,3,3
15,60,1069,6,3,3
15,60,1913,19,7,12
15,60,1815,12,5,7
15,60,1455,10,3,7
15,60,1069,5,1,4
15,60,1732,178,104,74
15,60,1350,4,2,2
15,60,1153,3,3,0
15,60,1673,44,25,19
15,60,1157,10,5,5
15,60,1770,4,2,2
15,60,1084,11,7,4
15,60,1500,12,9,3
15,60,1418,4,2,2
15,60,831,3,2,1
15,60,1591,10,3,7
15,60,1379,1,0,1
15,60,1206,3,0,3
15,60,2016,21,10,11
15,60,1023,7,5,2
15,60,958,27,16,11
15,60,1082,13,7,6
15,60,1728,7,4,3
15,60,1462,3,2,1
15,60,881,29,14,15
15,60,1017,77,44,33
15,60,1514,7,3,4
15,60,1214,4,3,1
15,60,789,7,4,3
15,60,1371,30,12,18
15,60,1675,16,10,6
15,60,916,6,3,3
15,60,1819,54,27,27
15,60,1584,8,3,5
15,60,2022,16,5,11
15,60,2079,19,11,8
15,60,1869,5,4,1
15,60,1875,62,39,23
15,60,1988,52,31,21
15,60,2344,70,38,32
15,60,1826,9,5,4
15,60,974,5,3,2
15,60,967,28,16,12
15,60,1022,0,0,0
15,60,1267,0,0,0
15,60,1240,30,17,13
15,60,1595,51,31,20
15,60,2206,38,17,21
15,60,1564,1,0,1
15,60,1549,11,6,5
15,60,1413,69,36,33
15,60,1029,38,19,19
15,60,1130,3,2,1
15,60,989,2,1,1
15,60,1021,0,0,0
15,60,1010,2,1,1
15,60,1290,8,5,3
15,60,1626,13,7,6
15,60,1321,8,2,6
15,60,1273,3,1,2
15,60,1215,2,2,0
15,60,1242,2,1,1
15,60,1592,61,31,30
15,60,1634,51,24,27
15,60,1661,1228,632,596
15,60,1530,89,51,38
15,60,1657,27,13,14
15,60,1450,167,90,77
15,60,1734,214,109,105
15,60,1455,95,44,51
15,60,1146,3,1,2
15,60,1652,45,26,19
15,60,1614,23,13,10
15,60,1372,22,12,10
15,60,1563,14,5,9
15,60,1569,32,18,14
15,60,1765,102,55,47
15,60,1729,30,13,17
15,60,1508,2,1,1
15,60,1643,15,7,8
15,60,1912,13,8,5
15,60,1762,16,6,10
15,60,2242,25,11,14
15,60,1324,45,26,19
15,60,1279,7,3,4
15,60,1464,6,2,4
15,60,1529,1,0,1
15,60,1364,10,4,6
15,60,1410,28,18,10
15,60,1320,9,6,3
15,60,1281,22,12,10
15,60,1046,18,7,11
15,60,1016,5,1,4
15,60,1727,12,5,7
15,60,2056,2,2,0
15,60,1377,16,9,7
15,60,1287,18,8,10
15,60,1803,36,23,13
15,60,1375,25,12,13
15,60,1816,11,2,9
15,60,1703,10,8,2
15,60,1893,21,8,13
15,60,1384,4,3,1
15,60,1076,4,2,2
15,60,1120,2,2,0
15,60,1964,4,3,1
15,60,1397,10,7,3
15,60,825,4,2,2
15,60,1293,3,3,0
15,60,1735,10,7,3
15,60,1752,41,19,22
15,60,1437,23,15,8
15,60,1483,19,9,10
15,60,1156,5,2,3
15,60,913,32,15,17
15,60,1274,6,3,3
15,60,1486,21,9,12
15,60,1581,6,3,3
15,60,2345,213,108,105
15,60,1830,33,17,16
15,60,1260,17,8,9
15,60,1140,12,4,8
15,60,1247,11,7,4
15,60,826,3,1,2
15,60,1108,7,4,3
15,60,1546,14,5,9
15,60,1261,2,1,1
15,60,943,3,1,2
15,60,1113,4,3,1
15,60,1473,5,3,2
15,60,1272,27,13,14
15,60,2165,13,5,8
15,60,1589,2,1,1
15,60,1540,1,0,1
15,60,1170,3,1,2
15,60,1482,2,0,2
15,60,1255,1,1,0
15,60,1001,5,1,4
15,60,993,8,4,4
15,60,1502,5,4,1
15,60,1666,10,5,5
15,60,1766,12,7,5
15,60,2019,3,2,1
15,60,1203,5,4,1
15,60,1423,2,0,2
15,60,1282,6,2,4
15,60,1719,29,17,12
15,60,1234,63,33,30
15,60,1917,61,31,30
15,60,1253,3,2,1
15,60,1065,2,1,1
15,60,2200,59,32,27
15,60,1162,11,5,6
15,60,1387,1,0,1
15,60,1402,4,2,2
15,60,1079,7,3,4
15,60,1227,8,3,5
15,60,1736,13,6,7
15,60,1562,54,33,21
15,60,1572,11,7,4
15,60,1421,21,10,11
15,60,1066,9,3,6
15,60,2013,14,12,2
15,60,864,9,4,5
15,60,996,10,4,6
15,60,885,5,1,4
15,60,1240,26,15,11
15,60,1748,13,7,6
15,60,1047,9,5,4
15,60,1220,14,8,6
15,60,1811,18,8,10
15,60,1885,11,6,5
15,60,1509,1,0,1
15,60,1844,18,6,12
15,60,1741,24,9,15
15,60,2033,35,21,14
15,60,1248,21,11,10
15,60,1451,22,10,12
15,60,1360,19,13,6
15,60,1420,2,1,1
15,60,2051,14,7,7
15,60,1012,6,3,3
15,60,1517,23,9,14
15,60,1129,1,1,0
15,60,1079,4,3,1
15,60,2007,11,6,5
15,60,1487,17,6,11
15,60,1402,0,0,0
15,60,924,16,6,10
15,60,2323,19,7,12
15,60,1429,33,19,14
15,60,1037,3,2,1
15,60,931,22,9,13
15,60,1996,24,9,15
15,60,1820,10,3,7
15,60,1816,17,7,10
15,60,1900,51,23,28
15,60,1896,3,2,1
15,60,1165,2,0,2
15,60,974,2,2,0
15,60,1083,18,6,12
15,60,1371,6,2,4
15,60,1554,4,3,1
15,60,1357,2,1,1
15,60,1464,12,5,7
15,60,1507,2,1,1
15,60,2016,10,5,5
15,60,1205,4,2,2
15,60,1929,57,31,26
15,60,1175,4,2,2
15,60,1612,10,4,6
15,60,1348,14,7,7
15,60,1038,13,8,5
15,60,1228,7,5,2
15,60,1134,9,4,5
15,60,2230,29,14,15
15,60,1359,21,8,13
15,60,1648,65,34,31
15,60,2452,40,21,19
15,60,1213,28,16,12
15,60,1127,18,7,11
15,60,1294,3,1,2
15,60,1168,20,8,12
15,60,1465,6,2,4
15,60,1600,7,4,3
15,60,1632,11,8,3
15,60,1668,17,9,8
15,60,1601,16,7,9
15,60,1333,5,3,2
15,60,1436,7,2,5
15,60,1444,3,1,2
15,60,1112,2,2,0
15,60,644,2,1,1
15,60,1412,1,1,0
15,60,1501,7,3,4
15,60,1379,19,11,8
15,60,1365,3,1,2
15,60,791,10,7,3
15,60,1755,12,4,8
15,60,960,10,6,4
15,60,1098,10,4,6
15,60,1307,71,39,32
15,60,1422,13,4,9
15,60,1141,1,1,0
15,60,1405,4,2,2
15,60,1384,3,3,0
15,60,1006,3,1,2
15,60,1268,15,10,5
15,60,1226,27,12,15
15,60,1552,4,2,2
15,60,1302,9,4,5
15,60,2166,28,17,11
15,60,2302,87,47,40
15,60,2141,9,6,3
15,60,1641,12,7,5
15,60,1598,24,14,10
15,60,1453,16,8,8
15,60,1481,8,0,8
15,60,974,8,2,6
15,60,939,7,4,3
15,60,1810,4,2,2
15,60,1065,16,5,11
15,60,1933,7,4,3
15,60,2321,14,8,6
15,60,1446,11,6,5
15,60,1864,245,136,109
15,60,1319,13,8,5
15,60,1683,42,25,17
15,60,1133,10,5,5
15,60,1235,10,6,4
15,60,1461,50,25,25
15,60,1716,25,12,13
15,60,1461,7,5,2
15,60,1025,6,2,4
15,60,1095,24,13,11
15,60,1186,10,6,4
15,60,1243,14,6,8
15,60,1171,3,2,1
15,60,1095,1,0,1
15,60,1283,23,14,9
15,60,1299,9,4,5
15,60,1965,8,3,5
15,60,2170,18,8,10
15,60,1410,21,10,11
15,60,906,4,4,0
15,60,1256,37,22,15
15,60,1747,13,9,4
15,60,1694,53,27,26
15,60,1770,183,90,93
15,60,1415,11,6,5
15,60,1195,1,0,1
15,60,2078,14,8,6
15,60,1474,128,65,63
15,60,2304,52,24,28
15,60,1548,49,25,24
15,60,1944,67,29,38
15,60,2012,55,34,21
15,60,1780,15,8,7
15,60,1891,59,31,28
15,60,1519,8,4,4
15,60,2124,34,17,17
15,60,1133,24,11,13
15,60,1317,17,8,9
15,60,1889,13,6,7
15,60,1114,2,1,1
15,60,1225,9,5,4
15,61,7131,96,49,47
15,61,3686,18,8,10
15,61,2968,108,51,57
15,61,4699,21,11,10
15,61,4801,51,27,24
15,61,19193,199,100,99
15,61,5394,309,168,141
15,61,3951,71,36,35
15,61,5597,35,19,16
15,61,1918,53,30,23
15,61,4755,16,3,13
15,61,6858,111,58,53
15,61,2361,1,0,1
15,61,4669,23,11,12
15,61,966,14,11,3
15,61,1827,38,16,22
15,61,3184,69,39,30
15,61,7031,80,33,47
15,61,8752,254,125,129
15,61,4989,596,297,299
15,61,4412,77,41,36
15,61,2704,61,32,29
15,61,2405,154,80,74
15,61,1421,13,5,8
15,61,1484,15,7,8
15,61,3280,9,5,4
15,61,2986,103,60,43
15,61,2579,15,7,8
15,61,16486,354,187,167
15,61,2283,4,1,3
15,61,2085,17,9,8
15,61,2893,48,27,21
15,61,3000,98,48,50
15,61,3934,106,53,53
15,61,2430,10,8,2
15,61,4062,28,15,13
15,61,4548,113,59,54
15,61,9124,52,27,25
15,61,1757,56,31,25
15,61,2186,13,8,5
15,61,2446,9,2,7
15,61,2522,41,18,23
15,61,4723,42,17,25
15,61,2489,86,38,48
15,61,2362,58,31,27
15,61,1967,12,6,6
15,61,3141,19,4,15
15,61,4671,56,28,28
15,61,1821,14,6,8
15,61,2282,45,20,25
15,61,3604,165,78,87
15,61,5675,284,147,137
15,61,10369,306,162,144
15,61,1740,237,120,117
15,61,1466,163,82,81
15,61,2265,5,2,3
15,61,2353,21,11,10
15,61,8213,120,58,62
15,61,9491,161,85,76
15,61,2209,9,3,6
15,61,2283,10,4,6
15,61,2780,9,2,7
15,61,1715,15,5,10
15,61,5440,351,186,165
15,61,3604,10,5,5
15,61,1418,6,6,0
15,61,7134,52,19,33
15,61,4282,34,17,17
15,61,23111,655,330,325
15,61,8444,246,126,120
15,61,2170,21,11,10
15,61,5981,103,52,51
15,61,857,0,0,0
15,61,2470,16,9,7
15,61,3061,77,35,42
15,61,3664,21,15,6
15,61,3742,10,5,5
15,61,4267,130,66,64
15,61,2405,51,26,25
15,61,2619,75,42,33
15,61,11921,226,131,95
15,61,1052,26,7,19
15,61,1121,32,15,17
15,61,2245,43,25,18
15,61,6737,289,140,149
15,61,4555,12,5,7
15,61,3856,7,4,3
15,61,2616,5,3,2
15,61,1336,1,0,1
15,61,9788,62,27,35
15,61,2004,15,6,9
15,61,3439,16,9,7
15,61,6024,29,15,14
15,61,3172,14,6,8
15,61,975,7,4,3
15,61,2353,32,21,11
15,61,1732,28,14,14
15,61,3926,24,13,11
15,61,7806,171,79,92
15,62,2025,22,10,12
15,62,1729,1,1,0
15,62,147,10,4,6
15,62,5099,33,11,22
15,62,2187,9,4,5
15,63,2105,11,4,7
15,63,1954,11,5,6
15,63,2093,24,12,12
15,63,2205,47,22,25
15,63,3323,75,37,38
15,63,3081,29,13,16
15,63,3843,73,38,35
15,63,2763,58,28,30
15,63,669,15,13,2
15,63,2103,27,14,13
15,63,4368,55,27,28
15,63,3528,55,26,29
15,63,1608,57,30,27
15,63,1806,11,7,4
15,63,4716,15,10,5
15,63,2468,67,37,30
15,63,3779,56,27,29
15,63,12302,272,141,131
15,63,2864,15,9,6
15,63,2643,8,4,4
15,63,2169,80,43,37
15,63,2518,2,2,0
15,64,3656,198,104,94
15,64,328,0,0,0
15,64,4391,25,11,14
15,64,3877,64,37,27
15,64,3991,65,30,35
15,64,4263,25,16,9
15,64,3371,113,62,51
15,64,1213,2,1,1
15,64,1715,15,9,6
15,64,1837,111,52,59
15,64,954,2,0,2
15,64,1426,13,7,6
15,64,2512,65,40,25
15,65,1373,3,2,1
15,65,1782,0,0,0
15,65,1211,1,0,1
15,65,3465,8,3,5
15,65,4085,21,13,8
15,65,3408,15,10,5
15,65,3785,870,454,416
15,65,4211,19,9,10
15,65,826,4,4,0
15,65,634,4,2,2
15,65,1890,3,2,1
15,65,2495,7,1,6
15,65,2790,21,13,8
15,65,1369,3,2,1
15,65,3035,9,4,5
15,65,289,0,0,0
15,65,289,0,0,0
15,66,1714,212,112,100
15,66,2051,77,44,33
15,66,2130,12,6,6
15,66,2012,14,8,6
15,66,3752,142,64,78
15,66,4286,100,47,53
15,66,313,24,11,13
15,66,1856,51,21,30
15,66,1731,5,2,3
15,66,2256,16,9,7
15,66,2230,15,7,8
15,66,2498,2,1,1
15,66,262,0,0,0
15,66,472,1,1,0
15,66,2230,3,3,0
15,66,3584,25,13,12
15,66,2104,20,12,8
15,66,3055,4,1,3
15,67,2116,13,7,6
15,67,1128,0,0,0
15,67,729,2,1,1
15,67,918,0,0,0
15,68,4732,32,20,12
15,68,6781,97,47,50
15,68,4117,27,8,19
15,68,3454,39,24,15
15,68,2885,32,13,19
15,68,3516,4,1,3
15,68,6773,8,5,3
15,68,6788,14,5,9
15,68,1611,14,6,8
15,68,2816,17,9,8
15,68,5439,20,11,9
15,68,2049,5,3,2
15,68,2444,6,2,4
15,68,961,13,6,7
15,68,1882,6,3,3
15,68,5097,25,9,16
15,68,1849,16,5,11
15,68,5845,5,3,2
15,68,2319,11,6,5
15,68,1962,0,0,0
15,68,13104,59,30,29
15,68,1846,7,3,4
15,68,1370,2,0,2
15,69,2082,25,11,14
15,69,1110,30,17,13
15,69,3985,5,5,0
15,69,2549,47,23,24
15,69,2153,13,5,8
15,69,3327,82,37,45
15,69,2255,40,19,21
15,69,2925,27,12,15
15,69,1842,10,4,6
15,69,3007,63,33,30
15,69,1711,9,5,4
15,69,2356,5,4,1
15,69,500,0,0,0
15,70,2624,46,19,27
15,70,2238,16,9,7
15,71,2617,888,427,461
15,71,5922,1279,682,597
15,71,3112,221,120,101
15,71,12243,279,133,146
15,71,7428,183,96,87
15,71,35637,493,254,239
15,71,7876,99,51,48
15,71,11318,169,73,96
15,71,8818,123,58,65
15,71,5188,225,105,120
15,71,3581,373,202,171
15,71,3327,159,86,73
15,71,2516,41,24,17
15,71,3066,55,27,28
15,71,1920,31,18,13
15,71,2034,52,27,25
15,71,2232,32,21,11
15,71,2187,8,4,4
15,71,1924,11,4,7
15,71,1821,16,8,8
15,71,1805,41,20,21
15,71,2132,77,41,36
15,71,1915,57,35,22
15,71,2131,40,17,23
15,71,1838,30,16,14
15,71,7760,167,89,78
15,71,2284,48,30,18
15,71,1903,31,17,14
15,71,1894,16,7,9
15,71,1787,2,0,2
15,71,2192,31,11,20
15,71,2355,82,41,41
15,71,2087,7,3,4
15,71,1744,3,2,1
15,71,1802,1,1,0
15,71,2956,89,46,43
15,71,2435,22,10,12
15,71,3035,34,14,20
15,71,4170,187,91,96
15,71,3423,201,98,103
15,71,2507,143,74,69
15,71,8083,225,112,113
15,71,9078,673,332,341
15,71,1223,34,16,18
15,71,2044,12,3,9
15,71,2190,8,6,2
15,71,2493,50,20,30
15,71,1430,1,1,0
15,71,1634,12,8,4
15,71,1314,4,3,1
15,71,1359,10,6,4
15,71,1344,2,0,2
15,71,3262,22,11,11
15,71,1410,2,1,1
15,71,1118,0,0,0
15,71,1285,5,5,0
15,71,2752,68,36,32
15,71,1017,2,1,1
15,71,2950,35,19,16
15,71,2930,16,8,8
15,71,3196,34,21,13
15,71,4487,47,24,23
15,71,9847,185,99,86
15,71,7779,310,155,155
15,71,3265,62,31,31
15,72,2138,12,5,7
15,72,3953,76,41,35
15,72,1681,7,6,1
15,72,2260,17,7,10
15,72,1148,3,1,2
15,72,1084,52,27,25
15,72,532,1,1,0
15,72,2156,4,1,3
15,72,1032,47,25,22
15,72,391,0,0,0
15,73,4870,51,29,22
15,73,2710,101,50,51
15,73,3041,20,6,14
15,73,2003,14,6,8
15,74,17465,816,424,392
15,74,4155,121,61,60
15,74,5824,77,37,40
15,74,5510,172,89,83
15,75,4672,27,14,13
15,124,1540,55,30,25
15,124,2596,2,1,1
15,124,4283,206,98,108
15,124,1011,1,0,1
15,124,3996,7,3,4
15,75,605,0,0,0
15,124,791,0,0,0
15,75,2828,5,3,2
15,75,2518,4,2,2
15,75,2676,13,7,6
15,75,3425,11,4,7
15,75,2561,80,41,39
15,75,1938,7,3,4
15,75,4025,22,10,12
15,75,3681,14,10,4
15,75,3845,175,85,90
15,124,3555,14,8,6
15,124,3418,4,2,2
15,124,4621,287,145,142
15,124,2339,5,3,2
15,124,2535,4,2,2
15,124,2474,5,3,2
15,124,1311,0,0,0
15,75,3165,1172,613,559
15,75,1982,8,7,1
15,75,3092,8,6,2
15,75,2655,5,5,0
15,75,1684,3,2,1
15,75,1500,0,0,0
15,75,3815,7,4,3
15,75,831,5,2,3
15,75,4174,5,3,2
15,75,5524,25,15,10
15,124,3288,9,6,3
15,124,3153,9,4,5
15,124,1816,3,0,3
15,124,3630,5,2,3
15,124,4535,6,2,4
15,124,1938,4,4,0
15,75,1106,5,1,4
15,75,6976,4,2,2
15,75,5050,21,9,12
15,75,3366,1,1,0
15,75,4266,17,5,12
15,75,1373,12,7,5
15,75,4922,11,6,5
15,75,6406,2,0,2
15,75,2698,8,5,3
15,75,2970,4,1,3
15,75,9212,21,6,15
15,75,2311,4,3,1
15,124,6628,63,34,29
15,124,859,1,1,0
15,124,2388,11,6,5
15,124,2221,4,4,0
15,124,1672,0,0,0
15,124,2336,6,1,5
15,75,533,1,1,0
15,75,3323,2,0,2
15,75,1264,14,8,6
15,75,4320,6,3,3
15,75,3667,3,2,1
15,124,4702,13,5,8
15,124,1726,33,21,12
15,124,1146,1,0,1
15,124,4331,1097,575,522
15,124,2390,350,173,177
15,124,3505,8,5,3
15,75,1165,6,3,3
15,124,1704,2,2,0
15,124,594,0,0,0
15,75,579,2,1,1
15,124,581,1,1,0
15,124,2299,6,3,3
15,75,4422,18,12,6
15,124,1930,2,1,1
15,124,94,0,0,0
15,76,2808,19,8,11
15,76,2478,8,4,4
15,76,4058,18,10,8
15,76,2392,70,37,33
15,76,3662,45,25,20
15,76,537,0,0,0
15,76,813,0,0,0
15,76,2513,12,4,8
15,76,1591,2,0,2
15,76,791,3,1,2
15,76,2149,4,1,3
15,76,408,4,2,2
15,76,1920,132,71,61
15,76,1830,8,4,4
15,77,5291,32,18,14
15,77,3576,30,15,15
15,77,3486,38,16,22
15,77,2543,11,3,8
15,77,2085,7,1,6
15,77,6386,56,27,29
15,77,4345,60,30,30
15,77,3864,23,11,12
15,77,6344,43,22,21
15,77,6590,35,17,18
15,77,5153,63,32,31
15,77,3263,61,27,34
15,77,2159,20,7,13
15,77,5146,20,9,11
15,77,7426,61,31,30
15,77,3150,22,9,13
15,77,3170,35,18,17
15,77,7322,26,13,13
15,77,3046,14,8,6
15,77,8684,127,60,67
15,77,4093,22,9,13
15,52,6395,132,56,76
15,52,13414,175,84,91
15,78,2863,0,0,0
15,78,1084,0,0,0
15,78,1077,1,1,0
15,78,1774,4,3,1
15,79,850,0,0,0
15,79,633,0,0,0
15,79,304,0,0,0
15,79,3552,1,1,0
15,79,267,0,0,0
15,79,242,0,0,0
15,79,646,0,0,0
15,79,1311,0,0,0
15,79,269,0,0,0
15,79,473,0,0,0
15,80,6103,100,43,57
15,80,1497,5,2,3
15,80,793,5,2,3
15,80,1939,12,6,6
15,80,3763,15,7,8
15,80,1216,2,1,1
15,80,1763,3,2,1
15,81,1639,4,2,2
15,81,2536,10,5,5
15,81,2019,3,3,0
15,81,971,3,1,2
15,81,2813,383,208,175
15,81,2095,6,4,2
15,81,337,1,1,0
15,81,426,1,1,0
15,81,445,0,0,0
15,81,904,2,1,1
15,81,840,0,0,0
15,81,1279,7,5,2
15,81,709,8,6,2
15,81,1000,0,0,0
15,81,850,4,1,3
15,81,759,0,0,0
15,81,1006,3,0,3
15,81,389,0,0,0
15,81,824,1,1,0
15,81,733,1,1,0
15,81,403,1,0,1
15,81,656,7,3,4
15,81,514,0,0,0
15,82,1598,14,5,9
15,82,6484,90,47,43
15,82,3098,25,15,10
15,82,15002,183,96,87
15,82,1692,7,3,4
15,82,3202,45,16,29
15,82,2010,63,37,26
15,82,2891,17,10,7
15,82,1186,26,14,12
15,82,4213,83,43,40
15,82,2010,23,12,11
15,82,2171,14,7,7
15,82,1022,4,1,3
15,82,2385,20,11,9
15,82,2571,11,5,6
15,82,3865,11,8,3
15,82,4930,13,6,7
15,82,5193,54,25,29
15,82,4655,36,16,20
15,82,4320,60,28,32
15,82,18289,463,244,219
15,82,4155,28,17,11
15,82,90,0,0,0
15,82,2818,151,72,79
15,82,4024,17,8,9
15,82,20549,323,162,161
15,82,2114,22,10,12
15,82,2121,38,16,22
15,82,3834,36,16,20
15,82,1924,2,2,0
15,82,2103,18,10,8
15,82,1588,2,2,0
15,82,1959,18,11,7
15,82,1058,11,5,6
15,82,1342,7,4,3
15,82,5857,11,6,5
15,82,2071,28,18,10
15,82,3585,31,15,16
15,82,5975,51,25,26
15,82,7200,196,102,94
15,82,21273,213,117,96
15,82,3511,15,8,7
15,82,4381,23,12,11
15,82,9271,329,159,170
15,82,1740,17,12,5
15,82,4460,51,19,32
15,82,1694,32,10,22
15,82,1303,4,0,4
15,82,1313,38,18,20
15,82,1642,6,1,5
15,82,1423,18,9,9
15,82,1546,15,7,8
15,82,3824,33,13,20
15,82,1055,10,7,3
15,82,1509,24,8,16
15,82,1128,1,0,1
15,82,1599,2,0,2
15,82,2980,10,5,5
15,82,2991,29,12,17
15,82,3258,26,15,11
15,82,1995,10,4,6
15,82,2961,9,6,3
15,82,28332,304,154,150
15,82,2800,44,22,22
15,82,1038,3,2,1
15,82,1736,45,24,21
15,83,1702,3,0,3
15,83,1168,13,9,4
15,83,5249,26,15,11
15,83,3659,7,5,2
15,83,2086,6,5,1
15,83,1970,2,0,2
15,83,2807,10,5,5
15,83,1270,7,5,2
15,83,2220,4,2,2
15,83,4536,6,2,4
15,123,277,0,0,0
15,123,1171,2,2,0
15,123,1065,3,1,2
15,123,437,4,2,2
15,123,1422,15,8,7
15,123,1188,3,2,1
15,123,1428,3,1,2
15,123,126,0,0,0
15,83,929,5,3,2
15,83,1481,0,0,0
15,83,542,1,0,1
15,83,920,5,2,3
15,123,1501,6,2,4
15,83,1614,9,6,3
15,83,932,3,0,3
15,123,2175,3,3,0
15,123,265,16,8,8
15,83,5999,37,20,17
15,123,1892,3,1,2
15,123,1898,3,1,2
15,123,3065,34,18,16
15,123,3195,31,13,18
15,123,248,0,0,0
15,123,598,1,0,1
15,123,2227,13,5,8
15,83,2043,3,1,2
15,83,2145,0,0,0
15,83,1661,2,1,1
15,83,7700,40,22,18
15,83,1094,2,2,0
15,123,160,0,0,0
15,83,841,0,0,0
15,83,2107,1,1,0
15,83,948,1,0,1
15,83,3804,47,25,22
15,123,865,1,0,1
15,123,523,1,0,1
15,83,953,0,0,0
15,83,576,1,0,1
15,83,278,0,0,0
15,123,283,1,0,1
15,83,386,4,3,1
15,83,558,0,0,0
15,83,3204,1,0,1
15,83,284,0,0,0
15,83,352,0,0,0
15,83,458,11,7,4
15,83,1507,17,5,12
15,83,1740,6,2,4
15,83,2373,7,4,3
15,123,457,0,0,0
15,123,1568,0,0,0
15,83,619,1,1,0
15,123,188,1,1,0
15,83,531,0,0,0
15,83,84,0,0,0
15,83,2732,11,5,6
15,83,254,0,0,0
15,83,966,2,2,0
15,84,2719,14,8,6
15,84,5137,44,13,31
15,84,2998,32,18,14
15,84,2331,13,4,9
15,84,1468,32,14,18
15,85,4068,32,13,19
15,85,6046,94,54,40
15,85,1196,1,0,1
15,85,2130,7,3,4
15,85,1699,10,6,4
15,85,689,34,21,13
15,85,4991,787,400,387
15,85,2216,6,5,1
15,85,1373,0,0,0
15,85,3321,5,1,4
15,85,923,1,1,0
15,85,7213,99,48,51
15,85,3988,13,6,7
15,85,2891,15,10,5
15,85,849,0,0,0
15,86,2482,21,10,11
15,86,1410,10,6,4
15,86,2442,40,21,19
15,86,2375,14,9,5
15,86,1795,34,13,21
15,86,3233,9,3,6
15,86,1626,6,4,2
15,86,1611,1,0,1
15,86,1492,0,0,0
15,86,1215,1,0,1
15,86,3226,1,1,0
15,86,2101,0,0,0
15,86,2689,3,2,1
15,86,3006,6,3,3
15,86,3348,31,15,16
15,86,2017,1,1,0
15,86,2257,3,0,3
15,86,2155,19,10,9
15,86,1079,1,0,1
15,86,395,0,0,0
15,86,636,0,0,0
15,86,1730,21,8,13
15,86,975,0,0,0
15,86,2293,54,26,28
15,86,564,0,0,0
15,86,1446,16,9,7
15,86,2179,11,4,7
15,86,2900,7,4,3
15,86,646,0,0,0
15,86,2000,5,3,2
15,86,855,7,3,4
15,86,2288,8,3,5
15,86,814,0,0,0
15,87,2352,21,12,9
15,87,2344,15,7,8
15,87,1506,5,3,2
15,87,1773,11,5,6
15,87,2762,6,3,3
15,87,698,6,3,3
15,87,1238,5,4,1
15,87,2874,3,2,1
15,87,1736,7,1,6
15,87,3533,9,5,4
15,87,1280,14,9,5
15,87,1448,2,0,2
15,87,1002,0,0,0
15,87,1568,2,1,1
15,87,1679,1,0,1
15,87,2141,6,5,1
15,87,604,0,0,0
15,87,863,7,3,4
15,87,519,1,1,0
15,87,802,1,1,0
15,87,499,0,0,0
15,87,1248,2,2,0
15,87,851,0,0,0
15,88,2673,13,9,4
15,88,977,0,0,0
15,88,7281,72,31,41
15,88,3567,7,4,3
15,88,3737,23,10,13
15,88,3342,30,13,17
15,88,2773,24,12,12
15,88,1854,7,4,3
15,88,1927,2,1,1
15,88,2045,6,4,2
15,88,6246,64,24,40
15,88,2294,14,9,5
15,88,5001,13,7,6
15,88,4392,20,12,8
15,88,2342,27,15,12
15,88,2138,63,34,29
15,88,2905,4,2,2
15,88,4980,12,9,3
15,88,3321,19,8,11
15,88,7514,20,9,11
15,88,8402,90,45,45
15,88,2728,12,5,7
15,88,3584,2,1,1
15,88,8583,400,207,193
15,88,1588,4,2,2
15,88,1875,1,1,0
15,89,2289,1,0,1
15,89,3352,20,11,9
15,89,1696,1,0,1
15,89,7765,25,15,10
15,89,3292,46,22,24
15,89,4863,15,10,5
15,89,3708,10,5,5
15,89,1620,2,1,1
15,89,2258,16,7,9
15,89,2716,11,6,5
15,89,1998,3,1,2
15,89,3994,11,2,9
15,89,2774,15,11,4
15,89,3807,30,14,16
15,89,818,82,31,51
15,89,2196,2,2,0
15,89,3439,53,28,25
15,89,2710,38,18,20
15,89,4832,14,7,7
15,89,1891,28,15,13
15,89,2772,45,18,27
15,89,3650,154,89,65
15,89,1866,22,14,8
15,89,849,10,5,5
15,89,2446,9,5,4
15,89,1706,2,2,0
15,89,4050,41,23,18
15,89,2177,3,2,1
15,89,8517,25,11,14
15,89,1419,2,2,0
15,89,5077,4,4,0
15,89,3123,2,1,1
15,89,1616,2,2,0
15,89,1288,9,5,4
15,89,1013,0,0,0
15,89,1098,1,0,1
15,90,2303,6,4,2
15,90,2139,6,2,4
15,90,2256,17,10,7
15,90,3015,12,6,6
15,90,1648,1,1,0
15,91,5859,145,79,66
15,91,6257,103,50,53
15,91,2401,294,154,140
15,91,3416,46,24,22
15,91,1805,71,39,32
15,91,4233,166,79,87
15,91,1494,938,485,453
15,91,3552,36,18,18
15,91,2725,75,31,44
15,91,585,4,1,3
15,91,3097,92,48,44
15,91,5991,46,26,20
15,91,4133,6,2,4
15,91,2298,21,10,11
15,91,3512,33,14,19
15,91,1712,32,15,17
15,91,2033,11,7,4
15,91,6536,96,38,58
15,91,2504,24,13,11
15,91,3568,46,23,23
15,91,4716,10,8,2
15,91,1371,1,1,0
15,91,8322,74,36,38
15,91,4067,12,2,10
15,91,4234,18,8,10
15,91,1733,16,9,7
15,91,2253,25,15,10
15,92,3612,132,67,65
15,92,6076,109,50,59
15,92,4853,46,19,27
15,92,4396,146,76,70
15,92,2697,41,20,21
15,92,2666,61,24,37
15,92,4226,67,30,37
15,92,2927,8,3,5
15,92,3756,60,32,28
15,92,2312,28,10,18
15,92,1836,74,39,35
15,92,2646,34,15,19
15,92,3425,31,15,16
15,92,3681,65,30,35
15,92,3197,46,22,24
15,92,2155,85,42,43
15,92,3161,149,80,69
15,92,5089,28,12,16
15,92,2552,27,14,13
15,92,5378,91,37,54
15,92,3264,8,3,5
15,92,6770,73,40,33
15,92,1292,7,2,5
15,92,2183,7,5,2
15,92,3825,3,0,3
15,93,2938,16,6,10
15,93,4756,41,18,23
15,93,3241,13,6,7
15,93,3099,3,2,1
15,93,5576,42,16,26
15,93,3303,33,15,18
15,93,1288,11,8,3
15,93,2420,12,5,7
15,93,584,0,0,0
15,93,2913,10,5,5
15,93,1510,17,9,8
15,93,1880,23,13,10
15,93,1725,13,7,6
15,93,708,18,11,7
15,93,2926,15,6,9
15,93,3181,32,16,16
15,93,1946,21,15,6
15,93,1977,13,7,6
15,93,3405,6,3,3
15,93,3711,18,10,8
15,93,2886,28,16,12
15,93,401,0,0,0
15,93,2852,12,8,4
15,94,3152,491,244,247
15,94,3517,69,31,38
15,94,2149,66,26,40
15,94,3051,85,40,45
15,94,3639,699,347,352
15,94,3255,110,59,51
15,94,1990,18,12,6
15,94,4537,498,242,256
15,94,1733,28,14,14
15,95,3433,5,3,2
15,95,2127,60,37,23
15,95,2661,36,22,14
15,95,3794,102,52,50
15,95,1528,5,1,4
15,95,2106,13,8,5
15,95,2170,34,17,17
15,95,2754,60,33,27
15,96,3448,87,48,39
15,96,5579,122,55,67
15,96,4877,123,62,61
15,96,3231,27,13,14
15,96,4629,115,56,59
15,96,1307,19,9,10
15,96,3041,23,11,12
15,96,3080,128,69,59
15,96,2827,35,16,19
15,96,2452,52,30,22
15,96,1333,24,11,13
15,96,2599,37,16,21
15,96,1855,64,33,31
15,96,3486,38,17,21
15,96,742,0,0,0
15,96,1422,12,6,6
15,96,4428,40,14,26
15,96,2291,24,14,10
15,96,8612,38,17,21
15,96,2503,11,3,8
15,96,3143,45,23,22
15,96,3130,46,22,24
15,96,5374,79,40,39
15,97,2867,18,6,12
15,97,5745,48,20,28
15,97,3871,22,13,9
15,97,2887,34,15,19
15,97,5761,18,9,9
15,97,4790,18,9,9
15,97,2087,61,27,34
15,97,3303,76,40,36
15,97,1084,54,25,29
15,97,1488,65,31,34
15,97,277,2,1,1
15,97,3379,46,26,20
15,97,1358,26,14,12
15,98,3830,13,11,2
15,98,2084,1,1,0
15,98,2487,10,7,3
15,98,2852,4,3,1
15,98,1711,5,2,3
15,98,1663,4,2,2
15,98,1733,3,2,1
15,98,1781,15,9,6
15,99,2929,146,80,66
15,99,2906,44,20,24
15,100,2615,13,6,7
15,100,2859,4,3,1
15,100,3536,19,9,10
15,100,2065,21,12,9
15,100,2482,30,16,14
15,100,2864,26,13,13
15,100,4463,66,28,38
15,100,3831,60,37,23
15,100,805,13,8,5
15,100,3099,37,21,16
15,100,2616,9,3,6
15,100,1879,25,13,12
15,100,1433,3,1,2
15,100,1016,3,0,3
15,100,1604,35,23,12
15,100,793,8,5,3
15,100,2060,43,22,21
15,100,6374,294,153,141
15,100,2237,31,15,16
15,100,1475,8,4,4
15,100,1165,11,3,8
15,100,1129,6,4,2
15,100,1175,13,7,6
15,100,4476,22,10,12
15,100,5391,23,11,12
15,100,2640,20,8,12
15,100,780,1,1,0
15,100,687,40,22,18
15,100,3465,20,10,10
15,100,966,6,3,3
15,100,0,0,0,0
15,100,5411,83,34,49
15,100,1410,9,6,3
15,100,1485,47,30,17
15,100,1482,37,20,17
15,100,4006,107,60,47
15,100,9904,542,275,267
15,100,3966,128,66,62
15,100,4314,24,12,12
15,100,4366,34,18,16
15,100,3474,17,8,9
15,100,2408,16,6,10
15,100,1775,19,9,10
15,100,3011,5,1,4
15,100,2625,20,10,10
15,100,2884,8,4,4
15,100,4211,46,20,26
15,100,5152,56,24,32
15,100,5239,22,14,8
15,100,3702,25,11,14
15,100,2988,36,16,20
15,100,2725,37,22,15
15,100,3136,417,205,212
15,100,3463,201,106,95
15,100,2929,13,7,6
15,100,4517,387,197,190
15,100,4050,37,18,19
15,100,3017,21,12,9
15,100,3294,61,32,29
15,100,5516,79,44,35
15,100,4541,42,22,20
15,100,4157,18,9,9
15,100,10149,50,22,28
15,100,1571,19,10,9
15,100,8429,116,63,53
15,100,3707,27,13,14
15,100,4928,117,58,59
15,100,5946,10,5,5
15,100,1084,3,1,2
15,100,6825,119,51,68
15,100,2009,11,2,9
15,100,4016,860,428,432
15,100,10481,78,34,44
15,100,2784,530,277,253
15,100,3380,46,23,23
15,100,1674,16,10,6
15,101,2984,14,8,6
15,101,4223,19,12,7
15,101,1523,8,5,3
15,101,1539,5,2,3
15,101,9738,68,31,37
15,101,10752,217,106,111
15,101,7670,256,129,127
15,101,1283,23,14,9
15,101,2105,38,15,23
15,102,3833,46,23,23
15,102,1789,25,16,9
15,102,3041,45,26,19
15,102,7116,105,54,51
15,102,3586,31,15,16
15,102,2274,259,136,123
15,102,2063,7,6,1
15,102,2308,91,43,48
15,102,4199,123,56,67
15,102,3039,7,2,5
15,102,8042,223,119,104
15,102,4090,74,38,36
15,102,2506,10,3,7
15,102,3548,77,41,36
15,102,4549,35,16,19
15,102,3189,9,3,6
15,102,3341,4,1,3
15,102,2681,5,1,4
15,102,3737,9,5,4
15,102,3000,16,7,9
15,102,5449,14,7,7
15,102,3475,0,0,0
15,102,2711,5,1,4
15,103,1839,0,0,0
15,103,1628,9,4,5
15,103,2629,10,4,6
15,103,1071,1,1,0
15,103,2198,11,5,6
15,103,1087,0,0,0
15,103,2737,5,4,1
15,103,1707,19,9,10
15,103,2010,34,17,17
15,103,563,1,0,1
15,103,155,3,1,2
15,104,2085,7,4,3
15,104,2595,6,4,2
15,104,2386,21,9,12
15,104,1997,9,6,3
15,104,4030,20,11,9
15,104,3013,9,6,3
15,104,2853,71,34,37
15,104,3172,87,42,45
15,104,2601,84,41,43
15,104,3364,35,21,14
15,104,1899,2,2,0
15,104,1330,3,0,3
15,104,1976,21,13,8
15,104,1416,4,1,3
15,104,3151,7,3,4
15,104,809,0,0,0
15,104,2803,11,5,6
15,104,887,5,1,4
15,104,3542,22,8,14
15,104,2340,52,23,29
15,104,1426,11,5,6
15,105,12248,488,244,244
15,105,3287,21,11,10
15,105,2914,57,37,20
15,105,3597,82,43,39
15,105,1948,10,2,8
15,105,1804,17,8,9
15,105,1905,9,6,3
15,105,2980,21,10,11
15,105,3896,16,6,10
15,105,2437,14,4,10
15,105,2126,25,12,13
15,105,2946,13,10,3
15,105,3223,15,7,8
15,105,2528,24,10,14
15,105,1666,14,6,8
15,105,1832,3,2,1
15,105,2529,76,36,40
15,105,1761,21,12,9
15,105,2475,7,2,5
15,105,2805,55,25,30
15,105,2140,30,16,14
15,105,3145,10,5,5
15,105,3465,12,6,6
15,105,2342,5,2,3
15,105,1687,30,12,18
15,105,2150,36,19,17
15,105,1430,15,6,9
15,105,1337,18,10,8
15,105,3866,69,30,39
15,105,3168,44,21,23
15,105,5280,41,14,27
15,105,4582,12,7,5
15,105,2075,39,25,14
15,105,1871,14,6,8
15,105,3241,60,31,29
15,105,2181,4,2,2
15,105,2306,20,7,13
15,105,2022,9,7,2
15,105,1755,24,13,11
15,105,1845,17,7,10
15,105,3486,32,18,14
15,105,2623,71,40,31
15,105,2905,53,28,25
15,105,1996,6,3,3
15,105,2539,36,21,15
15,105,2008,11,7,4
15,105,2106,22,13,9
15,105,3794,17,10,7
15,105,3428,62,31,31
15,105,1802,8,3,5
15,105,1504,12,7,5
15,105,3535,101,43,58
15,105,1862,5,2,3
15,105,1582,8,4,4
15,105,891,1,0,1
15,105,1804,8,3,5
15,105,1285,9,5,4
15,105,2091,26,14,12
15,105,2107,5,3,2
15,105,2259,16,8,8
15,105,1388,46,24,22
15,105,1384,3,2,1
15,105,1235,37,22,15
15,105,1109,12,4,8
15,105,1395,39,19,20
15,105,1579,30,17,13
15,105,1957,5,4,1
15,105,2457,34,17,17
15,105,1762,277,132,145
15,105,2164,44,22,22
15,105,2356,921,445,476
15,105,1917,16,7,9
15,105,1493,18,11,7
15,105,3010,174,90,84
15,105,2983,52,27,25
15,105,2646,147,78,69
15,105,2591,44,22,22
15,105,3799,56,30,26
15,105,2147,20,8,12
15,105,1510,5,2,3
15,105,1067,10,6,4
15,105,1322,6,2,4
15,105,1730,9,4,5
15,105,1871,17,10,7
15,105,1655,12,6,6
15,105,1494,22,15,7
15,105,2401,2,1,1
15,105,3362,67,35,32
15,105,2491,6,2,4
15,105,1764,11,3,8
15,105,1394,23,15,8
15,105,1158,10,4,6
15,105,1979,16,9,7
15,105,1389,21,15,6
15,105,1609,16,7,9
15,105,1552,25,19,6
15,105,1568,13,7,6
15,105,2632,17,7,10
15,105,1624,23,12,11
15,105,1769,25,13,12
15,105,1254,10,4,6
15,105,1556,34,18,16
15,105,1004,92,59,33
15,105,999,297,157,140
15,105,1621,295,153,142
15,105,1476,39,14,25
15,105,947,10,3,7
15,105,856,18,13,5
15,105,1344,23,14,9
15,105,2679,9,6,3
15,105,1816,31,26,5
15,105,2222,3,0,3
15,105,898,26,13,13
15,105,2997,76,34,42
15,105,1578,94,49,45
15,105,1650,55,24,31
15,105,1339,71,34,37
15,105,1346,22,10,12
15,105,1689,19,12,7
15,105,1914,10,5,5
15,105,1833,11,7,4
15,105,2788,7,3,4
15,105,968,12,5,7
15,105,585,7,2,5
15,105,1000,10,6,4
15,105,1713,5,1,4
15,105,2586,21,14,7
15,105,1102,2,2,0
15,105,1702,19,6,13
15,105,1818,16,7,9
15,105,1412,7,3,4
15,105,2003,1,0,1
15,105,1280,6,3,3
15,105,2279,29,10,19
15,105,1216,3,1,2
15,105,1144,1,0,1
15,105,1593,11,7,4
15,105,2135,9,3,6
15,105,2001,13,5,8
15,105,1220,14,8,6
15,105,292,1,1,0
15,105,1962,5,3,2
15,105,1579,10,5,5
15,105,1153,22,10,12
15,105,1452,28,15,13
15,105,750,11,4,7
15,105,872,0,0,0
15,105,1063,5,3,2
15,105,2463,69,28,41
15,105,7629,69,30,39
15,105,1060,12,6,6
15,105,1861,15,6,9
15,105,2137,31,21,10
15,105,1723,18,10,8
15,105,1407,22,12,10
15,105,1794,5,1,4
15,105,700,15,13,2
15,105,1587,69,30,39
15,105,1851,93,44,49
15,105,1028,7,2,5
15,105,1338,67,35,32
15,105,1201,29,13,16
15,105,1480,22,12,10
15,105,1492,11,8,3
15,105,1182,10,7,3
15,105,610,20,9,11
15,105,1316,28,14,14
15,105,822,12,7,5
15,105,1708,16,8,8
15,105,1925,15,5,10
15,105,1180,18,11,7
15,105,1668,12,6,6
15,105,2432,29,17,12
15,105,2158,23,12,11
15,105,1485,4,2,2
15,105,927,10,4,6
15,105,1375,13,6,7
15,105,828,18,9,9
15,105,1285,4,1,3
15,105,3933,13,4,9
15,105,2683,16,7,9
15,105,2158,31,16,15
15,105,1309,0,0,0
15,105,1251,3,3,0
15,105,1727,66,39,27
15,105,2003,3,0,3
15,105,1806,26,11,15
15,105,1573,4,2,2
15,105,1770,5,1,4
15,105,2580,23,12,11
15,105,1975,52,26,26
15,105,1624,46,24,22
15,105,1795,46,22,24
15,105,846,47,22,25
15,105,589,10,6,4
15,105,798,2,2,0
15,105,1242,65,36,29
15,105,1376,26,12,14
15,105,1057,2,1,1
15,105,1491,2,0,2
15,105,1535,9,4,5
15,105,1825,22,11,11
15,105,2172,9,4,5
15,105,1414,9,5,4
15,105,1765,32,16,16
15,105,1365,12,5,7
15,105,2658,6,2,4
15,105,2061,7,2,5
15,105,1217,29,6,23
15,105,1510,22,11,11
15,105,1385,17,11,6
15,105,734,2,0,2
15,105,736,1,1,0
15,105,868,4,1,3
15,105,846,6,3,3
15,105,875,1,1,0
15,105,1447,9,6,3
15,105,1567,32,15,17
15,105,2537,24,9,15
15,105,1558,5,2,3
15,105,1851,15,10,5
15,105,2053,27,15,12
15,105,1255,6,4,2
15,105,1480,25,12,13
15,105,1054,4,0,4
15,105,1559,25,16,9
15,105,2858,21,10,11
15,105,1074,10,5,5
15,105,2046,69,44,25
15,105,2052,40,24,16
15,105,2087,15,7,8
15,105,2328,2,0,2
15,105,1952,4,2,2
15,105,1948,31,16,15
15,105,2081,128,60,68
15,105,1197,0,0,0
15,105,1024,13,5,8
15,105,1136,9,7,2
15,105,1212,11,7,4
15,105,1337,35,14,21
15,105,1607,18,8,10
15,105,1618,49,23,26
15,105,1499,42,21,21
15,105,1470,39,15,24
15,105,1403,20,11,9
15,105,869,8,6,2
15,105,1576,30,15,15
15,105,1259,9,4,5
15,105,1566,16,9,7
15,105,1499,9,5,4
15,105,764,3,2,1
15,105,1420,21,14,7
15,105,1451,8,6,2
15,105,884,7,3,4
15,105,1593,24,9,15
15,105,1495,17,9,8
15,105,1376,18,13,5
15,105,1900,84,45,39
15,105,1326,6,2,4
15,105,957,29,14,15
15,105,1156,33,15,18
15,105,897,15,12,3
15,105,1342,1,1,0
15,105,733,1,0,1
15,105,986,5,1,4
15,105,1638,6,3,3
15,105,966,10,6,4
15,105,868,4,0,4
15,105,1807,35,12,23
15,105,1005,11,5,6
15,105,1326,1,1,0
15,105,1240,7,3,4
15,105,665,10,3,7
15,105,632,11,5,6
15,105,759,19,9,10
15,105,804,7,2,5
15,105,563,2,1,1
15,105,1427,173,83,90
15,105,1758,18,13,5
15,105,1753,12,6,6
15,105,1232,8,5,3
15,105,1223,2,0,2
15,105,1201,27,18,9
15,105,1037,4,1,3
15,105,673,13,5,8
15,105,3596,68,29,39
15,105,1825,11,3,8
15,105,1608,27,9,18
15,105,1361,1,0,1
15,105,1091,6,2,4
15,105,879,25,8,17
15,105,1345,6,4,2
15,105,1417,39,20,19
15,105,848,25,7,18
15,105,1139,4,3,1
15,105,1241,18,6,12
15,105,1482,19,13,6
15,105,1802,10,5,5
15,105,1827,19,8,11
15,105,1705,7,2,5
15,105,1575,11,6,5
15,105,1190,11,6,5
15,105,1625,55,29,26
15,105,1524,68,37,31
15,105,1762,27,15,12
15,105,1046,17,5,12
15,105,1084,36,21,15
15,105,1293,2,2,0
15,105,1687,24,11,13
15,105,4439,30,13,17
15,105,1856,11,5,6
15,105,2078,15,9,6
15,105,971,10,7,3
15,105,1776,282,138,144
15,105,980,15,11,4
15,105,1509,8,5,3
15,105,1642,18,9,9
15,105,1309,67,36,31
15,105,128,1,0,1
15,105,2942,35,21,14
15,105,1536,6,6,0
15,105,1435,22,15,7
15,105,1643,29,18,11
15,105,1463,178,92,86
15,105,976,38,21,17
15,105,657,1,1,0
15,105,942,4,4,0
15,105,1064,13,7,6
15,105,960,1,1,0
15,105,793,1,1,0
15,105,1604,77,38,39
15,105,1518,10,3,7
15,105,1564,1,1,0
15,105,1937,1,0,1
15,105,1769,10,3,7
15,105,1615,29,14,15
15,105,8722,18,9,9
15,105,1053,2,1,1
15,105,1280,37,17,20
15,105,1530,131,68,63
15,105,1914,12,4,8
15,105,1052,4,2,2
15,105,796,12,3,9
15,105,947,26,16,10
15,105,1186,53,26,27
15,105,1165,53,25,28
15,105,1657,20,14,6
15,105,1829,24,13,11
15,105,387,21,11,10
15,105,1985,43,24,19
15,105,1748,31,17,14
15,105,1146,12,6,6
15,105,1785,6,2,4
15,105,2911,12,5,7
15,105,1289,10,6,4
15,105,1722,33,14,19
15,105,2035,55,28,27
15,105,1619,19,9,10
15,105,1521,25,11,14
15,105,1124,6,5,1
15,105,2395,98,51,47
15,105,1877,9,6,3
15,105,1906,23,13,10
15,105,2394,33,18,15
15,105,843,17,10,7
15,105,4469,57,20,37
15,105,1370,13,9,4
15,105,2247,18,7,11
15,105,1721,113,55,58
15,105,1568,31,15,16
15,105,1095,3,2,1
15,105,1415,8,2,6
15,105,2030,52,21,31
15,105,2250,10,5,5
15,105,2404,2,1,1
15,105,1743,7,3,4
15,105,1704,3,1,2
15,105,2048,3,1,2
15,105,1255,5,2,3
15,105,1483,7,4,3
15,106,1963,11,5,6
15,106,1840,2,1,1
15,106,1699,2,1,1
15,106,293,1,0,1
15,106,953,2,1,1
15,106,961,2,1,1
15,106,1698,3,3,0
15,106,384,2,1,1
15,106,1207,6,4,2
15,106,978,3,2,1
15,106,1210,2,2,0
15,106,2529,0,0,0
15,106,215,0,0,0
15,106,541,2,2,0
15,106,832,1,1,0
15,106,1126,1,0,1
15,106,1483,3,3,0
15,106,551,0,0,0
15,106,720,3,1,2
15,106,628,1,0,1
15,106,1150,2,1,1
15,106,920,1,1,0
15,106,748,1,0,1
15,106,712,0,0,0
15,106,1094,1,0,1
15,106,501,0,0,0
15,106,1591,3,0,3
15,106,1052,2,1,1
15,106,515,0,0,0
15,106,659,0,0,0
15,106,481,5,2,3
15,106,599,0,0,0
15,107,3188,51,30,21
15,107,2076,30,19,11
15,107,1508,12,7,5
15,107,1326,23,7,16
15,107,1452,10,5,5
15,107,2228,15,6,9
15,107,1787,18,8,10
15,107,1956,28,12,16
15,107,3065,28,13,15
15,107,3168,135,80,55
15,107,3080,151,74,77
15,107,1423,9,8,1
15,107,1047,17,12,5
15,107,392,2,0,2
15,107,1046,3,2,1
15,107,1109,16,6,10
15,107,1737,28,17,11
15,107,1827,291,156,135
15,107,1509,23,13,10
15,107,3389,28,13,15
15,107,1932,20,11,9
15,107,2886,330,168,162
15,107,2088,19,10,9
15,107,1497,9,4,5
15,107,1254,5,4,1
15,107,485,16,8,8
15,107,119,1,1,0
15,107,293,1,0,1
15,107,294,2,1,1
15,107,1183,31,18,13
15,107,667,14,7,7
15,107,857,12,9,3
15,107,1770,190,87,103
15,107,1756,36,15,21
15,107,3211,41,22,19
15,107,100,2,1,1
15,107,609,5,3,2
15,107,819,56,29,27
15,107,647,19,10,9
15,107,255,4,2,2
15,107,260,1,1,0
15,107,309,2,1,1
15,107,345,2,1,1
15,107,242,2,1,1
15,107,892,11,7,4
15,107,1043,15,10,5
15,107,670,5,4,1
15,107,733,17,8,9
15,107,1090,10,7,3
15,107,1200,6,4,2
15,107,920,1,1,0
15,107,1063,19,8,11
15,107,766,9,4,5
15,107,854,5,3,2
15,107,1062,3,1,2
15,107,751,10,4,6
15,107,655,10,5,5
15,107,952,27,16,11
15,107,1269,29,15,14
15,107,916,6,1,5
15,107,944,19,10,9
15,107,686,13,8,5
15,107,1265,36,21,15
15,107,1355,15,6,9
15,107,887,6,4,2
15,107,740,14,6,8
15,107,1052,15,5,10
15,107,1083,31,15,16
15,107,1575,10,5,5
15,107,698,5,3,2
15,107,762,7,2,5
15,107,1181,8,5,3
15,107,1305,36,20,16
15,107,1647,18,11,7
15,107,1072,31,18,13
15,107,1177,2,2,0
15,107,1299,20,10,10
15,107,1103,36,19,17
15,107,751,67,35,32
15,107,1990,61,37,24
15,107,1390,9,5,4
15,107,1279,1,0,1
15,107,1618,27,15,12
15,107,1232,52,25,27
15,107,1051,17,8,9
15,107,1580,27,13,14
15,107,2136,26,12,14
15,107,2083,26,17,9
15,107,1684,16,9,7
15,107,2129,29,14,15
15,107,1688,14,8,6
15,107,1462,6,2,4
15,107,3152,18,7,11
15,107,1994,16,10,6
15,107,2601,42,22,20
15,107,1870,6,2,4
15,107,2047,17,3,14
15,107,5933,19,10,9
15,107,4903,22,15,7
15,107,5015,46,25,21
15,107,7888,47,22,25
15,107,5749,243,128,115
15,107,12576,99,47,52
15,107,4566,88,46,42
15,107,2084,13,10,3
15,107,2814,18,10,8
15,107,1733,4,0,4
15,107,2216,8,5,3
15,107,2727,65,28,37
15,107,5604,94,48,46
15,107,1430,13,5,8
15,107,11038,339,171,168
15,107,5853,117,54,63
15,107,659,1,1,0
15,107,3547,27,12,15
15,107,2029,28,12,16
15,107,3475,13,5,8
15,107,4136,106,53,53
15,107,2252,15,11,4
15,107,1566,42,21,21
15,107,2421,38,21,17
15,107,1582,7,1,6
15,107,3921,31,18,13
15,107,4488,28,12,16
15,107,2795,20,8,12
15,107,2281,8,4,4
15,107,7722,481,236,245
15,107,10409,94,45,49
15,107,7352,73,39,34
15,107,8108,35,14,21
15,107,1546,7,6,1
15,107,1959,6,4,2
15,107,1568,36,16,20
15,107,1338,9,4,5
15,107,11389,75,31,44
15,107,3585,69,41,28
15,107,4898,55,35,20
15,107,2628,5,2,3
15,107,799,9,5,4
15,107,981,12,6,6
15,107,5459,14,8,6
15,107,2263,4,3,1
15,107,2084,94,47,47
15,107,1078,12,7,5
15,107,1542,13,10,3
15,107,1370,11,5,6
15,107,671,9,4,5
15,107,2832,111,69,42
15,107,7042,66,30,36
15,107,5714,75,34,41
15,107,2614,18,11,7
15,107,2726,64,37,27
15,107,1519,28,16,12
15,107,1753,256,142,114
15,107,5956,16,7,9
15,107,2995,5,1,4
15,107,2540,28,15,13
15,107,3195,11,6,5
15,107,1894,2,0,2
15,107,1010,40,17,23
15,107,2996,24,15,9
15,107,5759,54,27,27
15,107,1593,7,5,2
15,107,1667,13,6,7
15,107,1993,8,4,4
15,107,4814,44,21,23
15,107,8530,37,18,19
15,107,3178,49,24,25
15,107,4554,27,10,17
15,107,2536,7,3,4
15,107,2808,20,13,7
15,107,2128,53,26,27
15,107,2331,9,2,7
15,107,2532,48,24,24
15,107,3098,40,16,24
15,107,1429,11,5,6
15,107,7120,347,182,165
15,107,4900,113,59,54
15,107,2611,43,24,19
15,107,3508,53,19,34
15,107,8922,838,440,398
15,107,9794,76,38,38
15,107,4579,9,4,5
15,107,944,31,16,15
15,107,1704,9,5,4
15,107,5794,244,112,132
15,107,6961,30,14,16
15,107,4215,26,12,14
15,107,2659,8,6,2
15,107,3501,13,4,9
15,107,4375,62,29,33
15,107,2833,32,17,15
15,107,4222,31,21,10
15,107,12952,642,320,322
15,107,9488,162,91,71
15,107,5436,108,55,53
15,107,4192,48,18,30
15,107,3820,6,3,3
15,107,5399,317,160,157
15,107,3454,41,13,28
15,107,4800,60,25,35
15,107,2252,13,5,8
15,107,6663,14,4,10
15,107,3761,51,18,33
15,107,3105,7,2,5
15,107,3525,72,28,44
15,107,5872,47,23,24
15,107,2326,4,3,1
15,107,4929,67,35,32
15,107,3999,60,35,25
15,107,2719,7,5,2
15,107,6147,89,41,48
15,107,7926,212,115,97
15,107,3806,49,23,26
15,107,5464,736,356,380
15,107,2034,2,1,1
15,107,3577,44,19,25
15,107,2630,5,3,2
15,107,7215,62,24,38
15,107,6004,14,5,9
15,107,7982,42,27,15
15,107,4709,31,17,14
15,107,4500,19,10,9
15,107,4721,21,9,12
15,107,6106,61,29,32
15,107,2115,6,4,2
15,107,2094,14,6,8
15,107,6562,65,24,41
15,107,4003,4,0,4
15,107,4716,18,8,10
15,107,2134,7,4,3
15,107,4797,110,43,67
15,107,2322,13,8,5
15,107,4314,54,21,33
15,107,5951,863,451,412
15,107,3378,31,15,16
15,107,3962,42,20,22
15,107,4005,23,14,9
15,107,3450,17,9,8
15,107,3892,14,4,10
15,107,8202,59,19,40
15,107,4246,18,8,10
15,107,4872,37,17,20
15,107,1776,21,9,12
15,107,8141,327,166,161
15,107,4458,206,103,103
15,107,6815,100,47,53
15,107,10118,314,154,160
15,107,4436,188,100,88
15,107,2567,4,1,3
15,107,1844,2,1,1
15,107,2471,10,7,3
15,107,2630,26,14,12
15,107,3991,9,4,5
15,107,2468,16,7,9
15,107,6345,33,15,18
15,107,2772,10,6,4
15,107,3389,11,6,5
15,107,4330,15,7,8
15,107,937,1,0,1
15,107,2456,24,11,13
15,107,5433,15,4,11
15,107,2078,2,1,1
15,107,4493,11,6,5
15,107,4984,26,10,16
15,107,2343,36,21,15
15,107,5002,115,52,63
15,107,5934,39,24,15
15,107,5796,26,11,15
15,107,6615,124,58,66
15,107,12411,110,60,50
15,107,3158,21,14,7
15,107,3858,21,13,8
15,108,2269,48,19,29
15,108,1650,70,36,34
15,108,1402,36,15,21
15,108,990,29,15,14
15,108,1963,24,11,13
15,108,1129,31,15,16
15,108,1218,85,43,42
15,108,1774,56,22,34
15,108,517,1,0,1
15,109,2267,16,10,6
15,109,4624,16,5,11
15,109,4454,27,15,12
15,109,3715,10,3,7
15,109,8439,68,27,41
15,109,5299,32,14,18
15,109,5042,12,9,3
15,109,3240,26,17,9
15,109,1882,11,8,3
15,109,5405,44,23,21
15,109,3514,18,10,8
15,109,1794,16,8,8
15,109,2399,30,14,16
15,109,27244,844,416,428
15,109,3070,27,17,10
15,109,2513,11,5,6
15,109,6746,11,5,6
15,109,2603,45,23,22
15,109,833,3,1,2
15,109,4523,71,36,35
15,109,22828,506,260,246
15,109,11691,360,169,191
15,109,3989,104,56,48
15,109,16764,773,381,392
15,109,3802,45,20,25
15,109,6665,82,34,48
15,109,4120,62,30,32
15,109,3547,22,13,9
15,109,3599,15,6,9
15,109,2044,19,6,13
15,110,1839,54,25,29
15,110,3300,47,24,23
15,110,2360,64,28,36
15,110,1949,49,18,31
15,110,1945,26,15,11
15,110,1415,16,10,6
15,110,3098,36,21,15
15,110,1296,5,3,2
15,110,3069,26,13,13
15,110,3209,11,7,4
15,110,4337,27,14,13
15,110,4831,49,27,22
15,110,1621,7,2,5
15,110,2734,29,9,20
15,110,1471,27,14,13
15,110,299,5,3,2
15,110,1408,115,58,57
15,110,5603,22,7,15
15,110,4001,9,6,3
15,110,3433,15,7,8
15,110,1748,12,6,6
15,110,3962,57,26,31
15,110,1263,25,17,8
15,110,1987,17,6,11
15,110,1305,29,13,16
15,110,2925,226,109,117
15,110,1908,8,5,3
15,110,3643,66,32,34
15,110,2135,55,28,27
15,110,1553,53,25,28
15,110,2896,11,7,4
15,110,4166,24,8,16
15,110,2909,11,6,5
15,110,2400,29,12,17
15,110,1894,12,6,6
15,110,2109,26,10,16
15,110,2234,19,10,9
15,110,3101,20,7,13
15,110,5452,24,9,15
15,110,843,42,21,21
15,110,1909,75,34,41
15,110,12208,231,118,113
15,110,907,8,3,5
15,110,1465,8,6,2
15,110,2085,25,13,12
15,110,2061,13,7,6
15,110,2945,31,19,12
15,110,7378,139,63,76
15,110,2105,56,30,26
15,110,1768,24,13,11
15,110,1514,25,8,17
15,110,2650,21,11,10
15,110,1220,4,2,2
15,110,1295,1,0,1
15,110,1487,1,0,1
15,110,1721,18,9,9
15,110,2047,150,76,74
15,110,11001,415,194,221
15,110,2928,24,12,12
15,110,3443,125,61,64
15,110,1098,17,9,8
15,110,7835,360,189,171
15,110,2847,32,17,15
15,110,3613,21,12,9
15,110,3715,90,51,39
15,110,3194,35,12,23
15,110,7621,244,110,134
15,110,1430,11,5,6
15,110,7963,47,23,24
15,110,2262,10,6,4
15,110,1683,8,2,6
15,110,1539,32,19,13
15,110,1414,17,9,8
15,110,1787,27,15,12
15,110,2116,75,42,33
15,110,11028,420,207,213
15,110,4070,186,81,105
15,110,2685,32,15,17
15,110,2583,117,65,52
15,110,2883,44,21,23
15,110,1544,19,12,7
15,110,1381,15,6,9
15,110,1350,29,13,16
15,110,372,7,2,5
15,110,3862,114,57,57
15,110,2091,63,32,31
15,110,2748,42,18,24
15,110,1397,24,9,15
15,110,1369,8,3,5
15,110,1239,21,10,11
15,110,4008,43,25,18
15,110,1417,9,4,5
15,110,1169,11,5,6
15,110,1831,12,8,4
15,110,7529,89,37,52
15,110,1634,8,3,5
15,110,1772,27,12,15
15,110,3041,28,14,14
15,110,689,17,10,7
15,110,1289,59,30,29
15,110,1220,32,20,12
15,110,1987,52,25,27
15,110,1841,30,14,16
15,110,1810,9,5,4
15,110,672,4,3,1
15,110,1495,16,8,8
15,110,6214,109,54,55
15,110,1788,51,25,26
15,110,8570,206,106,100
15,110,1725,16,9,7
15,110,1128,5,1,4
15,110,1108,3,1,2
15,110,1346,2,0,2
15,110,7194,74,43,31
15,110,1399,3,2,1
15,110,4486,59,23,36
15,110,7708,458,238,220
15,110,17374,344,164,180
15,110,9306,87,42,45
15,110,1495,12,6,6
15,110,1862,35,21,14
15,110,1326,29,15,14
15,110,1135,10,2,8
15,110,1627,38,16,22
15,110,1965,24,10,14
15,110,2219,27,15,12
15,110,1250,2,1,1
15,110,3651,82,41,41
15,110,3488,28,11,17
15,110,1437,23,19,4
15,110,3519,65,32,33
15,110,2593,19,8,11
15,110,1232,13,7,6
15,110,961,6,3,3
15,110,2468,26,12,14
15,110,2018,10,6,4
15,110,1293,9,6,3
15,110,2065,19,8,11
15,110,1184,22,12,10
15,110,1403,2,2,0
15,110,2500,19,10,9
15,110,1733,2,1,1
15,110,2199,48,22,26
15,110,2830,20,14,6
15,110,1854,41,19,22
15,110,1103,6,3,3
15,110,7702,43,26,17
15,110,1030,29,13,16
15,110,987,5,2,3
15,110,1497,10,4,6
15,110,976,2,2,0
15,110,1052,8,5,3
15,110,615,26,13,13
15,110,520,4,2,2
15,110,1303,46,26,20
15,110,654,9,3,6
15,110,1338,30,15,15
15,110,1278,31,13,18
15,110,790,13,10,3
15,110,866,10,6,4
15,110,1145,5,1,4
15,110,1498,29,15,14
15,110,924,38,25,13
15,110,1283,36,20,16
15,110,573,12,6,6
15,110,678,0,0,0
15,110,7319,84,38,46
15,110,16058,225,100,125
15,110,5289,58,42,16
15,110,20506,249,125,124
15,110,2431,10,5,5
15,111,2046,35,16,19
15,111,3942,58,38,20
15,111,2817,3,0,3
15,111,2936,97,48,49
15,111,2899,24,10,14
15,111,2232,5,5,0
15,111,978,13,7,6
15,111,1003,9,4,5
15,111,1560,31,16,15
15,111,802,7,3,4
15,111,1683,18,9,9
15,111,652,2,1,1
15,111,1787,29,18,11
15,111,7808,46,26,20
15,111,2676,1,1,0
15,111,62,0,0,0
15,111,945,0,0,0
15,111,2014,8,4,4
15,111,3750,67,32,35
15,111,1654,13,5,8
15,111,2255,54,28,26
15,111,1781,0,0,0
15,111,3800,17,11,6
15,111,2124,10,3,7
15,111,1680,1,0,1
15,111,2416,9,3,6
15,111,2069,13,7,6
15,112,3899,11,9,2
15,112,2157,1,1,0
15,112,1908,2,1,1
15,112,3514,9,6,3
15,112,605,0,0,0
15,112,912,1,0,1
15,112,5457,67,35,32
15,112,2063,16,7,9
15,112,659,0,0,0
15,112,3245,4,1,3
15,112,4451,1,0,1
15,112,1248,0,0,0
15,112,2196,1,1,0
15,112,3645,10,3,7
15,112,2105,3,2,1
15,112,4534,4,1,3
15,112,772,0,0,0
15,112,2253,9,2,7
15,112,667,1,0,1
15,112,2359,16,7,9
15,112,417,2,1,1
15,112,4352,5,3,2
15,113,3273,32,14,18
15,113,3309,15,12,3
15,113,2931,14,6,8
15,113,5049,38,18,20
15,113,1796,1,0,1
15,113,1218,0,0,0
15,113,2492,41,21,20
15,113,1039,0,0,0
15,113,1681,5,3,2
15,113,2910,5,0,5
15,113,2334,5,3,2
15,113,934,7,3,4
15,113,4431,76,39,37
15,113,2506,17,8,9
15,113,2452,38,19,19
15,113,3564,1,0,1
15,113,3776,11,5,6
15,113,4349,12,7,5
15,113,972,1,0,1
15,114,3357,17,14,3
15,114,1727,24,12,12
15,114,2344,19,10,9
15,114,3989,33,17,16
15,114,5216,267,141,126
15,114,3387,4,2,2
15,114,1818,11,9,2
15,114,4515,38,17,21
15,114,1851,2,0,2
15,114,4075,4,1,3
15,114,3073,46,26,20
15,114,2963,3,1,2
15,114,4468,44,18,26
15,114,3191,33,13,20
15,114,1937,2,2,0
15,114,2803,20,11,9
15,114,1705,26,10,16
15,114,4854,32,14,18
15,114,1451,8,5,3
15,114,2172,5,2,3
15,114,1341,2,1,1
15,114,3628,16,5,11
15,114,1928,6,4,2
15,114,289,1,1,0
15,114,1004,1,0,1
15,115,2334,13,8,5
15,115,1895,4,1,3
15,115,3927,29,15,14
15,115,5468,13,8,5
15,115,2056,1,0,1
15,115,1600,0,0,0
15,115,1783,14,6,8
15,115,6283,13,7,6
15,115,268,1,1,0
15,115,833,0,0,0
15,115,2060,3,3,0
15,115,1140,3,1,2
15,115,1659,2,2,0
15,115,3999,7,4,3
15,115,1181,0,0,0
15,115,3130,4,0,4
15,115,2439,14,9,5
15,115,1545,1,0,1
15,115,1463,0,0,0
15,115,2652,3,2,1
15,115,844,2,0,2
15,115,5275,6,3,3
15,115,1973,1,1,0
15,115,3064,17,13,4
15,115,3145,6,2,4
15,115,3668,13,8,5
15,115,871,0,0,0
15,115,795,0,0,0
15,115,1452,0,0,0
15,115,2470,3,1,2
15,115,6004,6,2,4
15,115,1320,0,0,0
15,115,2944,6,3,3
15,115,3394,1,0,1
15,115,911,5,2,3
15,115,1200,1,0,1
15,115,1676,0,0,0
15,115,2527,13,6,7
15,115,1056,1,1,0
15,115,332,0,0,0
15,116,3202,35,18,17
15,116,2413,9,5,4
15,116,5353,51,25,26
15,116,4437,26,14,12
15,116,1771,6,3,3
15,116,2655,1,0,1
15,116,9557,35,14,21
15,116,5044,30,12,18
15,116,1854,3,2,1
15,116,5473,12,9,3
15,116,4857,20,11,9
15,116,5476,35,18,17
15,116,3908,10,6,4
15,116,7874,52,19,33
15,117,4042,14,9,5
15,117,1067,8,2,6
15,118,1512,36,15,21
15,118,2118,3,1,2
15,118,1490,5,1,4
15,118,1061,2,0,2
15,118,823,7,5,2
15,118,647,4,3,1
15,118,308,0,0,0
15,118,200,1,1,0
15,118,368,2,1,1
15,118,1213,18,11,7
15,118,894,0,0,0
15,118,1435,8,5,3
15,118,617,0,0,0
15,118,670,1,0,1
15,118,250,1,0,1
15,119,2991,177,93,84
15,119,1091,98,53,45
15,119,1479,10,6,4
15,119,3373,31,18,13
15,119,4577,33,17,16
15,119,6694,57,23,34
15,119,3107,81,42,39
15,119,5536,86,36,50
15,119,3408,147,72,75
15,119,2075,39,28,11
15,119,1546,8,3,5
15,119,1740,20,7,13
15,119,6427,54,31,23
15,119,7176,80,43,37
15,119,6361,55,27,28
15,119,19643,269,146,123
15,119,3570,24,12,12
15,119,2456,7,3,4
15,119,7072,11,5,6
15,119,1649,1,1,0
15,119,6892,66,36,30
15,119,8012,20,10,10
15,119,8019,130,62,68
15,119,4480,48,25,23
15,119,5947,524,276,248
15,119,3569,3,1,2
15,119,10834,132,74,58
15,119,1276,129,70,59
15,119,5389,9,5,4
15,119,277,0,0,0
15,119,3730,3,0,3
15,119,10261,75,37,38
15,119,4184,54,29,25
15,119,4968,14,5,9
15,119,4237,33,20,13
15,119,2719,29,13,16
15,119,2543,17,9,8
15,119,8180,410,197,213
15,119,4300,47,23,24
15,119,4160,58,27,31
15,119,2128,4,3,1
15,119,1861,233,109,124
15,119,1132,1,0,1
15,119,617,0,0,0
15,119,894,0,0,0
15,119,626,2,2,0
15,120,3655,19,11,8
15,120,1884,6,2,4
15,120,1485,5,3,2
15,120,2841,3,2,1
15,120,2050,2,1,1
15,120,2076,1,1,0
15,120,884,1,0,1
15,120,379,19,9,10
15,120,2199,1,0,1
15,120,896,1,1,0
15,120,500,1,1,0
15,121,2975,3,2,1
15,121,26444,747,374,373
15,121,22936,494,251,243
15,121,7079,98,47,51
15,121,5775,111,53,58
15,121,3185,17,9,8
15,121,2470,7,3,4
15,121,3011,27,12,15
15,121,2478,44,19,25
15,121,3713,22,11,11
15,121,3588,34,17,17
15,121,3848,7,3,4
15,121,5010,11,6,5
15,121,764,2,2,0
15,121,2047,20,12,8
15,121,2094,22,12,10
15,121,2476,6,5,1
15,121,1512,13,8,5
15,121,1717,10,6,4
15,121,3525,21,10,11
15,121,16399,314,157,157
15,121,4097,21,10,11
15,121,11172,103,49,54
15,121,2687,36,13,23
15,121,38363,707,350,357
15,121,2322,60,26,34
15,121,6265,57,28,29
15,121,5276,68,32,36
15,121,3572,298,141,157
15,121,3710,51,26,25
15,121,4509,38,17,21
15,121,5880,150,71,79
15,121,39780,693,349,344
15,121,7896,60,29,31
15,121,1763,30,18,12
15,121,3128,11,6,5
15,121,2719,66,33,33
15,121,2889,18,12,6
15,121,383,0,0,0
15,121,3972,60,31,29
15,121,1192,7,3,4
15,121,3584,22,11,11
15,121,1057,76,40,36
15,121,1754,19,8,11
15,122,1984,7,4,3
15,122,1137,20,13,7
15,122,12214,437,225,212
15,122,1808,11,5,6
15,122,238,13,6,7
15,123,428,0,0,0
15,123,172,0,0,0
15,124,2104,7,4,3
15,124,1248,71,40,31
15,124,987,0,0,0
15,124,560,1,1,0
15,124,474,0,0,0
15,124,773,0,0,0
15,71,1610,6,2,4
15,71,2724,36,19,17
15,71,1790,54,25,29
15,71,4151,117,62,55
15,71,1958,5,3,2
15,71,2324,6,3,3
15,71,6712,95,41,54
15,71,3417,58,29,29
15,71,2875,34,13,21
15,71,1690,30,15,15
15,71,1629,32,18,14
15,71,1844,35,15,20
15,71,2370,53,27,26
15,71,1404,23,9,14
15,71,1662,10,6,4
15,71,1407,5,3,2
15,32,1714,78,37,41
15,32,2147,192,97,95
15,32,321,9,4,5
15,32,3211,689,362,327
15,32,2863,111,50,61
15,32,1984,51,21,30
15,32,1697,14,11,3
15,32,3309,35,15,20
15,32,2069,12,6,6
15,32,2433,12,2,10
15,32,1719,20,6,14
15,32,2829,17,2,15
15,32,15067,138,71,67
15,32,14721,141,76,65
15,32,8413,152,75,77
15,32,7373,137,79,58
15,32,30322,532,259,273
15,32,3538,18,8,10
15,32,4665,93,51,42
15,32,9707,135,69,66
15,32,2120,17,7,10
15,32,2221,6,3,3
15,32,2011,47,28,19
15,32,2219,175,89,86
15,32,2741,63,30,33
15,32,3129,352,161,191
15,32,0,0,0,0
15,32,3557,109,62,47
15,32,1875,73,42,31
15,32,2917,111,60,51
15,32,2785,71,39,32
15,32,2025,21,14,7
15,32,2536,21,10,11
15,32,2042,5,5,0
15,32,1036,73,40,33
15,32,1746,8,6,2
15,32,1919,4,2,2
15,34,4380,38,15,23
15,34,1913,7,5,2
15,34,3113,14,6,8
15,34,2348,4,2,2
15,34,3320,18,6,12
15,34,2792,36,19,17
15,34,3240,13,5,8
15,34,3501,16,10,6
15,34,2332,5,3,2
15,34,2220,7,3,4
15,34,2436,3,1,2
15,34,1371,18,6,12
15,34,2232,14,8,6
15,34,2050,16,4,12
15,34,4040,63,29,34
15,34,2013,71,34,37
15,34,1114,12,3,9
15,34,372,1,0,1
15,34,1748,31,16,15
15,34,60,0,0,0
15,34,1120,1,0,1
15,34,3521,48,20,28
15,34,1966,24,12,12
15,34,3422,59,31,28
15,34,1455,123,66,57
15,34,1007,8,2,6
15,34,1832,50,23,27
15,34,1767,23,9,14
15,34,1333,12,4,8
15,34,1028,9,4,5
15,34,487,5,1,4
15,34,3522,46,25,21
15,34,896,8,3,5
15,34,1989,85,42,43
15,34,743,9,4,5
15,34,1542,60,25,35
15,34,4598,129,64,65
15,34,2031,6,2,4
15,34,1165,5,2,3
15,34,2203,23,9,14
15,34,426,12,3,9
15,34,2081,23,12,11
15,34,2046,37,20,17
15,34,1703,0,0,0
15,34,2247,24,11,13
15,34,1322,19,9,10
15,34,1675,17,5,12
15,34,1650,4,3,1
15,34,1801,13,4,9
15,34,1491,4,3,1
15,34,1443,17,9,8
15,34,1490,26,12,14
15,34,958,9,6,3
15,34,1261,4,4,0
15,34,2504,11,3,8
15,34,1387,15,6,9
15,34,1642,20,10,10
15,34,1616,4,1,3
15,34,1513,4,2,2
15,40,2629,18,6,12
15,40,5527,51,23,28
15,40,1904,2,1,1
15,40,526,0,0,0
15,40,1930,21,10,11
15,40,5475,126,64,62
15,40,2411,4,1,3
15,40,1359,9,5,4
15,40,1294,56,24,32
15,40,1747,18,10,8
15,40,1375,0,0,0
15,40,1682,41,21,20
15,40,1476,15,10,5
15,40,2229,7,4,3
15,40,1512,16,10,6
15,40,1372,16,15,1
15,40,1282,41,22,19
15,40,1234,7,4,3
15,40,669,7,1,6
15,40,1328,70,29,41
15,40,789,7,3,4
15,40,1320,1,1,0
15,40,990,8,1,7
15,40,1137,6,2,4
15,40,1288,2,2,0
15,40,1192,15,6,9
15,40,1420,26,15,11
15,40,1657,89,47,42
15,40,1470,27,14,13
15,40,1322,20,8,12
15,40,1369,9,7,2
15,40,1540,14,9,5
15,40,1439,14,6,8
15,40,1293,17,6,11
15,40,1171,51,26,25
15,40,659,9,6,3
15,40,1135,5,4,1
15,40,2270,82,50,32
15,40,2378,66,35,31
15,40,1967,108,50,58
15,40,1085,1,1,0
15,40,1538,7,3,4
15,40,1220,12,4,8
15,40,1952,8,5,3
15,40,1417,13,6,7
15,40,1763,17,10,7
15,40,1286,37,19,18
15,40,1729,1,0,1
15,40,1708,2,1,1
15,40,1415,38,17,21
15,40,434,19,10,9
15,40,1173,16,9,7
15,40,1255,12,3,9
15,40,1331,17,9,8
15,40,1199,53,27,26
15,40,488,4,2,2
15,40,1581,21,8,13
15,40,1642,26,13,13
15,40,4043,46,19,27
15,40,960,16,7,9
15,40,1316,34,15,19
15,40,1601,30,16,14
15,40,1716,31,18,13
15,40,2051,29,14,15
15,40,1004,2,1,1
15,40,1323,22,9,13
15,40,1428,8,4,4
15,40,1881,51,24,27
15,40,1238,31,16,15
15,40,916,26,14,12
15,40,1283,8,4,4
15,40,1409,54,29,25
15,40,642,22,14,8
15,40,968,62,36,26
15,40,895,45,23,22
15,40,1711,119,63,56
15,40,2692,60,29,31
15,40,2623,62,36,26
15,40,1806,43,14,29
15,40,2336,62,31,31
15,40,889,9,3,6
15,40,979,1,1,0
15,40,2354,55,25,30
15,40,1620,109,62,47
15,40,1193,26,9,17
15,40,3196,86,52,34
15,40,1532,47,19,28
15,40,2202,72,34,38
15,40,190,0,0,0
15,40,362,1,1,0
15,40,2943,14,8,6
15,40,1841,13,6,7
15,40,1895,27,14,13
15,40,698,0,0,0
15,40,1044,6,3,3
15,40,1770,6,3,3
15,40,2139,14,11,3
15,40,2207,10,3,7
15,40,3647,15,6,9
15,40,1533,3,2,1
15,40,1087,12,6,6
15,40,1160,13,5,8
15,40,945,8,5,3
15,40,1141,6,3,3
15,40,1140,17,9,8
15,40,1153,11,7,4
15,40,962,1,0,1
15,40,687,21,10,11
15,40,981,49,29,20
15,40,1069,22,11,11
15,40,1549,2,2,0
15,40,3593,62,30,32
15,40,1307,24,11,13
15,40,982,10,6,4
15,40,929,13,3,10
15,40,1569,13,6,7
15,40,1013,32,15,17
15,40,907,9,6,3
15,40,1030,1,1,0
15,40,1827,9,3,6
15,40,1023,50,25,25
15,110,2856,96,47,49
15,110,3545,100,56,44
15,110,1189,0,0,0
15,110,1966,18,10,8
15,110,2432,26,10,16
15,110,2393,58,27,31
15,110,1859,17,11,6
15,110,2192,10,5,5
15,110,2022,21,12,9
15,110,1869,19,8,11
15,110,624,2,2,0
15,110,1074,30,15,15
15,94,1511,61,33,28
15,25,446,1,0,1
15,25,886,7,1,6
15,25,1852,61,31,30
15,25,2693,44,20,24
15,25,614,3,2,1
15,25,1195,4,2,2
15,25,168,0,0,0
15,25,1845,67,33,34
15,25,1968,10,3,7
15,25,3217,31,12,19
15,25,624,8,3,5
15,25,3704,31,15,16
15,25,378,10,3,7
15,25,1383,5,3,2
15,25,1767,12,4,8
15,25,590,0,0,0
15,25,1753,12,3,9
15,25,1642,109,57,52
15,25,1227,6,2,4
15,25,1206,4,1,3
15,25,1959,17,8,9
15,25,2030,60,26,34
15,25,2654,38,19,19
15,25,1172,32,14,18
15,34,1674,2,0,2
15,34,1596,9,3,6
15,34,1328,99,50,49
15,34,966,28,17,11
15,34,2045,24,9,15
15,34,1181,3,0,3
15,34,1146,4,1,3
15,34,2019,16,8,8
15,34,1784,79,35,44
15,34,1625,97,46,51
15,34,1274,9,5,4
15,34,1252,36,21,15
15,34,1608,15,4,11
15,34,1868,7,3,4
15,34,1263,6,1,5
15,34,1211,6,2,4
15,34,1111,8,4,4
15,34,1278,23,11,12
15,34,1514,29,15,14
15,34,1015,10,3,7
15,34,1310,6,4,2
15,34,1435,14,7,7
15,34,2041,42,17,25
15,34,643,11,7,4
15,34,1128,15,7,8
15,40,920,7,4,3
15,40,1354,9,4,5
15,40,1311,24,10,14
15,40,1020,28,13,15
15,40,1098,42,17,25
15,40,1090,13,3,10
15,40,1316,28,17,11
15,40,547,0,0,0
15,40,726,6,2,4
15,40,1732,22,12,10
15,40,1608,27,16,11
15,40,2543,9,4,5
15,40,3087,101,51,50
15,40,1199,5,4,1
15,40,1708,145,82,63
15,40,1133,23,15,8
15,40,3759,47,25,22
15,40,1164,44,26,18
15,40,927,21,4,17
15,40,1796,3,1,2
15,40,1065,28,16,12
15,40,2086,42,22,20
15,40,2249,25,13,12
15,40,3338,177,97,80
15,40,2013,41,24,17
15,40,2903,69,41,28
15,40,3260,47,27,20
15,40,1623,81,41,40
15,40,2024,192,104,88
15,82,935,13,9,4
15,82,790,1,0,1
15,82,3393,26,11,15
15,82,1554,4,2,2
15,82,2964,14,4,10
15,82,2724,19,12,7
15,82,1732,16,11,5
15,82,1504,8,5,3
15,82,1712,16,9,7
15,82,2830,67,27,40
15,82,3896,134,68,66
15,82,4125,35,17,18
15,82,2369,37,14,23
15,82,2116,9,6,3
15,82,2067,20,9,11
15,82,727,65,35,30
15,82,893,1,0,1
15,82,949,18,9,9
15,82,1198,36,15,21
15,82,1205,25,12,13
15,82,942,6,4,2
15,82,746,3,1,2
15,82,693,3,2,1
15,82,769,3,1,2
15,82,885,12,5,7
15,82,1965,12,6,6
15,82,1698,11,9,2
15,82,6009,157,78,79
15,82,1760,63,32,31
15,82,769,60,28,32
15,82,657,294,147,147
15,82,1006,92,49,43
15,82,916,16,5,11
15,82,682,14,6,8
15,82,1111,96,48,48
15,82,1076,4,2,2
15,82,960,14,5,9
15,82,915,55,18,37
15,82,1158,82,43,39
15,82,1204,53,26,27
15,82,767,45,22,23
15,82,423,9,3,6
15,82,1584,144,69,75
15,82,5477,33,17,16
15,82,2416,12,6,6
15,82,1453,5,2,3
15,82,3028,31,15,16
15,82,6285,272,153,119
15,82,797,0,0,0
15,82,592,2,2,0
15,82,3451,121,58,63
15,82,0,0,0,0
15,82,671,16,6,10
15,82,1291,58,27,31
15,82,3713,97,46,51
15,82,1756,49,20,29
15,82,1034,18,8,10
15,82,506,45,23,22
15,82,1284,64,36,28
15,82,1104,100,50,50
15,82,771,96,52,44
15,82,932,15,8,7
15,82,708,14,8,6
15,82,629,2,0,2
15,82,709,0,0,0
15,82,1248,22,9,13
15,82,689,9,5,4
15,82,899,0,0,0
15,82,681,7,2,5
15,82,792,12,5,7
15,82,790,2,0,2
15,82,758,127,67,60
15,82,813,11,6,5
15,82,995,32,14,18
15,82,1191,40,19,21
15,82,965,44,22,22
15,82,1184,11,6,5
15,82,849,10,6,4
15,82,897,17,9,8
15,82,1822,15,10,5
15,82,1010,3,3,0
15,82,606,16,12,4
15,82,790,4,3,1
15,82,1085,9,6,3
15,82,949,4,2,2
15,82,979,15,6,9
15,82,182,2,0,2
15,82,1460,20,14,6
15,30,2576,62,30,32
15,30,3977,79,36,43
15,30,3301,102,53,49
15,30,2556,27,15,12
15,30,3176,45,21,24
15,30,2381,27,13,14
15,30,2362,8,5,3
15,30,2899,40,20,20
15,30,1941,17,8,9
15,30,1111,15,9,6
15,30,848,10,6,4
15,30,2941,88,44,44
15,30,4243,41,21,20
15,30,3041,29,17,12
15,30,5369,60,32,28
15,30,3446,18,7,11
15,30,3775,95,51,44
15,30,3797,97,44,53
15,30,3900,55,29,26
15,30,5403,105,50,55
15,30,1965,5,4,1
15,30,1279,9,5,4
15,30,1076,2,2,0
15,30,1292,1,1,0
15,30,1717,11,6,5
15,30,544,2,2,0
15,30,2700,11,4,7
15,30,2551,12,6,6
15,30,2324,11,5,6
15,30,2948,48,26,22
15,30,3103,66,33,33
15,30,3228,22,14,8
15,30,3896,16,7,9
15,30,6701,19,9,10
15,30,2183,43,31,12
15,30,2988,30,15,15
15,30,3118,8,2,6
15,30,3002,22,9,13
15,30,3965,61,32,29
15,30,2916,25,12,13
15,58,1471,47,23,24
15,58,315,5,4,1
15,36,1225,42,19,23
15,36,0,0,0,0
15,36,0,0,0,0
15,36,0,0,0,0
15,36,869,8,5,3
15,36,1284,107,48,59
15,36,4186,131,65,66
15,36,1336,59,28,31
15,36,1931,60,27,33
15,36,915,21,9,12
15,36,1349,13,4,9
15,36,1271,74,36,38
15,36,1199,17,10,7
15,36,711,12,6,6
15,36,1168,31,16,15
15,36,890,40,17,23
15,36,853,27,15,12
15,36,824,3,2,1
15,36,1127,12,6,6
15,36,1144,4,2,2
15,36,1080,30,21,9
15,36,735,22,12,10
15,36,826,30,14,16
15,36,1399,47,27,20
15,36,810,17,8,9
15,36,914,0,0,0
15,36,2002,85,46,39
15,36,1062,35,21,14
15,36,2110,16,9,7
15,36,988,40,17,23
15,36,1571,45,21,24
15,36,0,0,0,0
15,36,305,0,0,0
15,36,1113,20,10,10
15,36,0,0,0,0
15,36,0,0,0,0
15,36,0,0,0,0
15,36,0,0,0,0
15,36,0,0,0,0
15,107,730,2,0,2
15,107,1260,11,6,5
15,107,1047,7,3,4
15,107,1169,2,2,0
15,107,1339,45,20,25
15,107,1261,7,4,3
15,107,3524,43,17,26
15,107,789,22,11,11
15,107,1230,9,4,5
15,107,4938,167,90,77
15,107,1116,0,0,0
15,107,702,13,8,5
15,107,1487,63,31,32
15,107,1108,12,6,6
15,107,776,0,0,0
15,107,1606,107,58,49
15,107,901,52,28,24
15,107,1263,32,9,23
15,107,779,22,12,10
15,107,1044,10,7,3
15,107,968,2,2,0
15,107,804,36,18,18
15,107,1591,47,26,21
15,107,1461,104,47,57
15,107,760,4,2,2
15,107,815,13,8,5
15,107,1221,10,4,6
15,107,1384,1,0,1
15,107,782,15,10,5
15,107,785,10,5,5
15,25,1522,113,50,63
15,25,1872,50,12,38
15,25,1428,28,14,14
15,25,4034,154,79,75
15,25,3103,114,57,57
15,25,495,30,19,11
15,25,3270,384,189,195
15,25,2821,150,73,77
15,25,54,0,0,0
15,25,1360,200,105,95
15,25,1972,69,35,34
15,25,2133,49,27,22
15,25,2525,166,82,84
15,25,2064,42,23,19
15,25,1319,28,14,14
15,25,2524,76,38,38
15,34,1078,30,11,19
15,34,8024,170,75,95
15,34,1886,101,45,56
15,34,1980,75,32,43
15,34,2044,18,6,12
15,34,3234,57,29,28
15,34,1629,64,30,34
15,34,1924,13,8,5
15,34,1667,93,42,51
15,34,2191,43,26,17
15,34,1962,40,20,20
15,34,1174,5,5,0
15,34,3935,37,17,20
15,34,2268,112,50,62
15,34,4649,49,17,32
15,34,2406,10,2,8
15,34,1633,42,24,18
15,34,1555,34,16,18
15,101,5506,23,14,9
15,107,3090,29,12,17
15,68,2854,127,60,67
15,36,2610,62,30,32
15,36,5214,191,110,81
15,36,4479,190,93,97
15,36,5102,37,16,21
15,36,5307,152,69,83
15,36,707,11,4,7
15,36,5684,43,21,22
15,36,3141,57,32,25
15,36,2653,184,90,94
15,36,1910,17,10,7
15,36,4335,102,47,55
15,36,4451,84,40,44
15,36,551,8,4,4
15,24,5973,38,15,23
15,24,2658,74,38,36
15,24,3638,102,49,53
15,24,2782,33,16,17
15,24,2932,35,14,21
15,24,2672,61,31,30
15,24,2941,95,52,43
15,2,3337,14,7,7
15,2,5179,70,34,36
15,2,3422,103,59,44
15,2,3762,77,44,33
15,2,2323,117,54,63
15,2,5361,87,46,41
15,2,3413,43,16,27
15,2,4560,133,70,63
15,82,294,0,0,0
15,82,3076,51,23,28
15,82,2357,81,47,34
15,82,4352,38,22,16
15,82,3441,272,145,127
15,82,3992,91,50,41
15,82,4915,43,16,27
15,82,1505,188,101,87
15,82,5817,80,38,42
15,82,9742,121,59,62
15,82,4894,135,58,77
15,82,4226,78,43,35
15,82,2196,43,24,19
15,82,621,16,9,7
15,82,3503,55,23,32
15,82,3887,48,16,32
15,82,3779,146,71,75
15,82,4153,70,31,39
15,82,2564,86,39,47
15,82,3143,53,24,29
15,82,5644,150,78,72
15,82,4878,98,45,53
15,82,4153,65,30,35
15,82,3897,122,52,70
15,82,4484,75,48,27
15,82,5724,57,33,24
15,82,3457,38,17,21
15,82,5123,77,43,34
15,82,4565,66,31,35
15,82,5274,86,38,48
15,82,4280,31,16,15
15,82,3494,86,44,42
15,82,5185,61,27,34
15,82,6297,118,59,59
15,3,2127,18,8,10
15,3,2043,7,4,3
15,86,2602,10,3,7
15,86,2481,4,2,2
15,43,2153,5,5,0
15,43,809,2,1,1
15,43,4338,30,17,13
15,43,1444,0,0,0
15,61,1578,34,18,16
15,61,3205,44,20,24
15,94,2399,274,156,118
15,94,1554,112,63,49
15,25,2477,35,22,13
15,25,2474,9,5,4
15,75,2202,2,1,1
15,75,3025,3,1,2
15,75,900,7,4,3
15,75,2076,5,3,2
15,75,568,0,0,0
15,75,4941,4,2,2
15,115,3464,7,1,6
15,115,899,1,0,1
15,115,852,1,0,1
15,115,2312,8,6,2
15,115,1905,4,4,0
15,115,1637,0,0,0
15,115,4368,5,1,4
15,13,1559,8,4,4
15,13,2929,51,25,26
15,68,2652,15,8,7
15,68,3683,4,2,2
15,12,1393,15,5,10
15,12,2686,50,24,26
15,52,3369,21,12,9
15,52,0,0,0,0
15,102,4231,19,12,7
15,102,1304,2,1,1
15,111,2111,7,3,4
15,111,145,0,0,0
15,111,2176,4,2,2
15,111,1096,1,0,1
15,23,1867,16,9,7
15,23,2663,8,4,4
15,96,1196,5,2,3
15,96,2412,13,10,3
15,96,2835,12,4,8
15,31,3473,15,6,9
15,31,2677,12,6,6
15,100,2210,6,4,2
15,100,3940,14,9,5
15,100,2696,111,48,63
15,100,2766,36,15,21
15,100,2396,23,12,11
15,100,2039,40,17,23
15,100,3105,25,14,11
15,100,1967,25,10,15
15,71,5907,19,7,12
15,71,2619,81,33,48
16,1,1859,20,13,7
16,1,2158,24,10,14
16,1,1150,6,4,2
16,1,804,11,5,6
16,1,2317,27,14,13
16,1,351,3,2,1
16,1,844,10,5,5
16,1,740,5,4,1
16,1,340,0,0,0
16,1,630,5,3,2
16,2,2279,31,15,16
16,2,2176,62,22,40
16,2,1866,35,15,20
16,2,2235,2,1,1
16,2,459,9,5,4
16,2,3016,126,58,68
16,2,513,4,3,1
16,2,742,4,2,2
16,2,570,0,0,0
16,2,215,1,1,0
16,2,250,1,0,1
16,2,129,0,0,0
16,2,137,1,0,1
16,3,1975,8,4,4
16,3,2897,15,7,8
16,3,2649,3,1,2
16,3,1555,20,10,10
16,3,1192,3,1,2
16,3,1909,7,6,1
16,3,2934,6,3,3
16,3,1808,2,1,1
16,3,1555,12,7,5
16,3,1706,2,0,2
16,3,2003,2,0,2
16,3,977,4,2,2
16,4,997,13,5,8
16,4,820,2,1,1
16,4,2001,7,4,3
16,4,1494,1,0,1
16,4,730,4,3,1
16,4,1070,13,3,10
16,4,878,1,0,1
16,4,3112,9,4,5
16,4,1001,14,8,6
16,4,251,0,0,0
16,4,452,1,0,1
16,4,444,0,0,0
16,4,779,0,0,0
16,4,1013,10,4,6
16,5,2229,24,13,11
16,5,887,1,1,0
16,5,749,1,1,0
16,5,3123,1,1,0
16,5,1442,5,2,3
16,5,2622,2,2,0
16,6,2735,9,7,2
16,6,2254,87,41,46
16,6,2815,53,23,30
16,6,3651,112,62,50
16,6,2499,46,19,27
16,6,3088,284,145,139
16,6,2051,165,88,77
16,6,1901,5,2,3
16,6,1410,15,7,8
16,6,3555,11,6,5
16,6,3727,16,10,6
16,6,844,3,1,2
16,6,1957,35,12,23
16,6,1724,4,2,2
16,6,1584,11,6,5
16,6,3720,15,6,9
16,6,2301,6,3,3
16,6,1046,1,0,1
16,6,762,3,1,2
16,6,589,9,6,3
16,6,992,8,3,5
16,6,757,2,2,0
16,6,918,2,0,2
16,6,882,2,1,1
16,6,1616,4,2,2
16,6,1441,2,1,1
16,6,2094,0,0,0
16,6,1120,2,0,2
16,6,886,1,0,1
16,6,1244,4,1,3
16,6,600,3,1,2
16,6,1422,7,3,4
16,6,556,9,6,3
16,6,309,0,0,0
16,6,983,4,2,2
16,6,766,9,5,4
16,6,909,11,6,5
16,6,872,6,6,0
16,6,943,27,16,11
16,6,854,5,2,3
16,6,1302,9,5,4
16,6,1046,7,2,5
16,6,1023,5,4,1
16,6,2354,9,6,3
16,6,616,8,5,3
16,6,847,12,7,5
16,6,1509,16,10,6
16,6,4139,33,26,7
16,6,1615,14,7,7
16,6,1150,3,2,1
16,6,2626,7,3,4
16,6,2181,6,2,4
16,6,1476,16,10,6
16,6,4695,38,20,18
16,6,2996,31,12,19
16,6,9135,306,166,140
16,6,1599,2,1,1
16,6,1821,13,9,4
16,6,1900,16,8,8
16,6,1600,3,1,2
16,6,1124,2,2,0
16,6,2352,4,2,2
16,6,1958,1,1,0
16,6,1659,1,1,0
16,6,1192,30,16,14
16,6,297,0,0,0
16,6,818,9,7,2
16,6,1243,3,3,0
16,6,590,1,1,0
16,6,592,3,2,1
16,6,210,1,0,1
16,6,957,2,0,2
16,6,239,0,0,0
16,6,189,0,0,0
16,7,1656,121,69,52
16,7,1155,45,25,20
16,7,331,1,0,1
16,7,387,0,0,0
16,8,1437,31,9,22
16,8,2394,22,11,11
16,8,1496,0,0,0
16,8,2768,7,3,4
16,8,2155,2,1,1
16,8,2177,6,2,4
16,8,3751,6,4,2
16,8,936,0,0,0
16,8,779,2,1,1
16,8,1533,7,4,3
16,8,881,6,1,5
16,8,2715,8,3,5
16,8,1895,5,3,2
16,9,1560,3,1,2
16,9,914,6,1,5
16,9,2581,7,2,5
16,9,605,1,1,0
16,9,3109,4,3,1
16,9,3043,14,3,11
16,9,2344,5,4,1
16,9,4425,12,6,6
16,9,1538,0,0,0
16,9,1606,0,0,0
16,9,2574,14,5,9
16,9,2471,15,5,10
16,9,2573,23,5,18
16,9,529,31,15,16
16,9,1724,11,6,5
16,9,820,0,0,0
16,9,946,265,127,138
16,9,1835,35,15,20
16,9,521,6,3,3
16,9,520,0,0,0
16,9,352,2,0,2
16,10,3377,7,2,5
16,10,1658,9,5,4
16,10,2163,37,17,20
16,10,2181,38,17,21
16,10,1964,12,6,6
16,10,751,6,2,4
16,10,1874,11,1,10
16,10,884,6,3,3
16,10,791,3,2,1
16,10,776,5,1,4
16,10,787,1,1,0
16,10,2201,13,4,9
16,10,578,2,0,2
16,10,297,0,0,0
16,11,1349,4,3,1
16,11,3197,52,29,23
16,11,727,0,0,0
16,11,1062,0,0,0
16,11,4105,35,17,18
16,11,1241,7,2,5
16,12,4059,33,20,13
16,12,5753,73,28,45
16,12,1091,0,0,0
16,12,1706,4,1,3
16,12,749,0,0,0
16,12,860,3,1,2
16,12,187,0,0,0
16,12,714,12,7,5
16,12,1567,11,3,8
16,12,2429,12,5,7
16,12,2745,23,12,11
16,12,2702,11,6,5
16,12,2947,27,9,18
16,12,2484,10,6,4
16,12,2163,3,2,1
16,12,2618,3,1,2
16,12,965,9,5,4
16,12,1344,0,0,0
16,12,2371,9,6,3
16,12,3794,12,4,8
16,12,748,1,0,1
16,12,1236,5,0,5
16,12,639,4,2,2
16,13,3909,90,44,46
16,13,578,26,18,8
16,13,809,4,0,4
16,13,242,6,2,4
16,13,741,0,0,0
16,13,208,2,1,1
16,13,1356,0,0,0
16,13,365,0,0,0
16,13,506,0,0,0
16,13,273,0,0,0
16,13,376,1,1,0
16,13,344,0,0,0
16,14,2879,68,39,29
16,14,3275,46,19,27
16,14,315,112,57,55
16,14,1257,86,49,37
16,14,2681,207,93,114
16,14,224,0,0,0
16,14,1127,65,26,39
16,14,1878,20,11,9
16,14,1361,13,3,10
16,14,979,10,5,5
16,14,851,11,6,5
16,14,291,11,5,6
16,15,3958,14,7,7
16,15,1521,4,1,3
16,15,2339,273,148,125
16,15,1570,276,137,139
16,15,994,6,2,4
16,15,4364,41,22,19
16,15,151,0,0,0
16,15,894,15,8,7
16,15,639,0,0,0
16,15,148,0,0,0
16,15,363,1,0,1
16,15,443,2,1,1
16,15,423,2,1,1
16,15,492,0,0,0
16,15,207,0,0,0
16,15,227,1,0,1
16,15,323,1,0,1
16,15,545,1,1,0
16,16,812,18,9,9
16,16,902,3,1,2
16,16,1348,5,2,3
16,16,1157,7,3,4
16,16,552,61,37,24
16,16,1062,8,6,2
16,16,841,1,0,1
16,16,794,3,1,2
16,16,454,42,21,21
16,16,167,0,0,0
16,16,1181,11,7,4
16,16,419,8,4,4
16,16,416,9,5,4
16,16,752,2,1,1
16,16,598,2,0,2
16,16,325,0,0,0
16,16,452,2,2,0
16,16,365,1,1,0
16,16,739,2,1,1
16,16,237,1,1,0
16,16,890,0,0,0
16,16,1665,3,2,1
16,16,1152,6,2,4
16,16,934,6,3,3
16,16,565,1,1,0
16,16,696,2,0,2
16,16,255,0,0,0
16,16,738,9,7,2
16,16,497,0,0,0
16,17,2599,3,3,0
16,17,1179,8,4,4
16,17,5048,133,66,67
16,17,742,0,0,0
16,17,1334,2,0,2
16,17,1389,2,1,1
16,17,2617,18,10,8
16,17,5148,12,8,4
16,17,3781,5,3,2
16,17,3142,3,1,2
16,17,1789,7,3,4
16,17,5015,13,9,4
16,17,1652,5,1,4
16,18,820,2,2,0
16,18,1227,6,2,4
16,18,1765,2,1,1
16,18,2200,2,2,0
16,18,1890,3,1,2
16,18,1611,1,0,1
16,19,1507,4,2,2
16,19,703,22,14,8
16,19,2171,2,1,1
16,19,1024,36,17,19
16,19,721,34,23,11
16,19,1359,0,0,0
16,19,1047,3,2,1
16,19,2774,16,4,12
16,19,1600,6,5,1
16,19,1147,3,2,1
16,19,762,6,5,1
16,19,273,2,1,1
16,19,228,2,1,1
16,19,1656,13,7,6
16,19,608,4,2,2
16,19,437,0,0,0
16,19,1147,4,2,2
16,19,787,9,3,6
16,19,296,0,0,0
16,20,3657,69,34,35
16,20,1016,29,13,16
16,20,2225,18,8,10
16,20,1121,11,5,6
16,20,2224,9,3,6
16,20,930,0,0,0
16,20,901,5,3,2
16,20,1476,5,3,2
16,20,1026,60,35,25
16,20,1959,46,27,19
16,20,212,0,0,0
16,20,910,7,3,4
16,20,829,5,3,2
16,20,5533,23,12,11
16,20,3321,68,35,33
16,20,2697,1,0,1
16,21,1772,2,1,1
16,21,2680,3,1,2
16,21,2040,97,51,46
16,21,1812,40,16,24
16,21,2002,10,3,7
16,21,3213,2,0,2
16,22,3811,135,68,67
16,22,3571,36,18,18
16,22,2089,2,2,0
16,22,1871,1,1,0
16,22,751,5,1,4
16,22,5418,45,24,21
16,22,1985,0,0,0
16,22,1050,3,1,2
16,22,554,1,0,1
16,22,376,7,5,2
16,22,746,2,1,1
16,22,497,0,0,0
16,22,928,1,0,1
16,22,974,0,0,0
16,22,600,4,2,2
16,23,940,11,6,5
16,23,831,8,3,5
16,23,734,11,6,5
16,23,1440,50,24,26
16,23,920,76,34,42
16,23,694,4,1,3
16,23,630,7,3,4
16,23,761,22,10,12
16,23,1327,0,0,0
16,23,748,1,0,1
16,23,1392,63,30,33
16,24,3855,26,14,12
16,24,4122,5,3,2
16,24,2340,3,2,1
16,24,1524,1,1,0
16,24,2823,7,3,4
16,24,2867,10,6,4
16,24,1560,3,0,3
16,24,1568,12,8,4
16,25,1580,3,2,1
16,25,1470,11,4,7
16,25,1611,1,1,0
16,25,2219,5,0,5
16,25,2834,8,2,6
16,25,1406,2,2,0
16,25,3619,16,9,7
16,25,2549,9,3,6
16,25,3315,14,8,6
16,25,4175,18,8,10
16,25,2063,17,10,7
16,25,2225,9,3,6
16,25,1460,3,2,1
16,25,4307,2,2,0
16,25,3203,3,2,1
16,25,1598,9,4,5
16,25,723,0,0,0
16,26,1429,7,2,5
16,26,443,1,1,0
16,26,243,0,0,0
16,26,210,1,1,0
16,26,131,0,0,0
16,26,623,1,1,0
16,26,630,30,19,11
16,26,829,2,2,0
16,27,920,8,5,3
16,27,805,3,1,2
16,27,756,5,3,2
16,27,755,8,5,3
16,27,1238,13,4,9
16,27,474,0,0,0
16,28,1091,4,3,1
16,28,1039,23,13,10
16,28,833,1,1,0
16,28,781,1,0,1
16,28,439,0,0,0
16,28,522,0,0,0
16,28,317,5,4,1
16,28,211,1,1,0
16,29,1050,0,0,0
16,29,1660,1,1,0
16,29,2113,16,9,7
16,29,1154,1,1,0
16,29,700,1,1,0
16,29,545,0,0,0
16,29,1073,20,10,10
16,29,482,0,0,0
16,29,716,3,1,2
16,29,755,3,3,0
16,29,671,5,2,3
16,29,327,1,0,1
16,29,1243,7,3,4
16,30,825,8,3,5
16,30,1072,1,1,0
16,30,990,10,5,5
16,30,1471,21,11,10
16,30,676,0,0,0
16,30,1075,0,0,0
16,30,2001,5,3,2
16,30,1102,1,0,1
16,30,654,1,0,1
16,30,513,0,0,0
16,30,445,0,0,0
16,30,541,3,2,1
16,30,520,2,2,0
16,31,1742,4,2,2
16,31,1712,6,3,3
16,31,1418,1,0,1
16,31,1268,1,1,0
16,31,1597,0,0,0
16,31,1172,2,0,2
16,31,786,3,2,1
16,31,822,1,0,1
16,31,1980,14,9,5
16,31,2050,1,1,0
16,31,1569,6,3,3
16,32,2049,3,2,1
16,32,1536,3,2,1
16,32,570,0,0,0
16,32,499,0,0,0
16,32,2293,2,1,1
16,32,576,0,0,0
16,32,2075,1,1,0
16,32,3369,11,3,8
16,32,1413,2,0,2
16,32,944,10,7,3
16,33,1838,261,136,125
16,33,2096,29,16,13
16,33,1229,4,1,3
16,33,1248,4,3,1
16,33,2437,34,18,16
16,33,1637,99,56,43
16,33,2504,248,132,116
16,33,2433,6,3,3
16,33,1408,154,76,78
16,33,1157,21,9,12
16,33,1527,4,2,2
16,33,1612,201,95,106
16,33,340,108,58,50
16,34,6538,28,14,14
16,34,6282,70,34,36
16,34,5198,8,3,5
16,34,6629,15,10,5
16,34,1509,30,15,15
16,34,864,5,1,4
16,34,2961,19,8,11
16,34,2001,10,4,6
16,34,2039,7,5,2
16,34,3003,5,2,3
16,34,3295,32,19,13
16,34,1861,5,2,3
16,34,1021,7,3,4
16,34,667,26,10,16
16,34,2976,63,30,33
16,34,8561,54,24,30
16,34,1283,8,4,4
16,34,1134,26,16,10
16,34,977,3,1,2
16,34,1242,4,1,3
16,34,3148,3,1,2
16,34,1458,8,4,4
16,34,2108,41,21,20
16,34,4071,30,15,15
16,34,374,37,15,22
16,34,266,0,0,0
16,34,213,0,0,0
16,34,2386,37,15,22
16,34,397,3,1,2
16,34,4223,17,10,7
16,34,2883,11,7,4
16,34,979,15,8,7
16,34,3500,41,22,19
16,34,1599,641,319,322
16,34,623,2,1,1
16,34,1211,2,1,1
16,34,3975,9,4,5
16,34,377,0,0,0
16,34,181,2,2,0
16,34,575,1,0,1
16,34,2106,7,3,4
16,34,463,1,0,1
16,34,568,1,0,1
16,34,996,6,4,2
16,34,884,4,2,2
16,34,3044,24,12,12
16,34,3299,7,5,2
16,34,707,2,2,0
16,34,764,0,0,0
16,34,356,1,0,1
16,34,756,0,0,0
16,34,1121,1,0,1
16,34,147,4,3,1
16,34,785,0,0,0
16,34,109,0,0,0
16,34,212,0,0,0
16,34,489,1,0,1
16,34,378,11,4,7
16,34,494,20,15,5
16,34,361,0,0,0
16,34,153,0,0,0
16,34,1129,0,0,0
16,34,196,0,0,0
16,34,1409,2,1,1
16,34,2076,4,3,1
16,34,3507,8,3,5
16,34,125,0,0,0
16,34,744,14,7,7
16,34,1911,20,13,7
16,34,919,1,1,0
16,34,395,0,0,0
16,34,385,1,1,0
16,35,1137,7,5,2
16,35,2684,23,13,10
16,35,2053,16,7,9
16,35,1229,6,3,3
16,35,1223,6,1,5
16,35,1506,19,10,9
16,35,175,158,85,73
16,35,1016,33,16,17
16,35,553,8,3,5
16,35,1017,2,1,1
16,35,587,155,74,81
16,35,975,4,4,0
16,35,644,96,47,49
16,35,829,17,9,8
16,35,1102,153,74,79
16,35,2411,12,4,8
16,35,1694,1,1,0
16,35,1490,8,2,6
16,35,669,0,0,0
16,35,440,0,0,0
16,35,972,5,1,4
16,35,1360,20,8,12
16,35,1408,2,2,0
16,36,1663,4,3,1
16,36,1261,5,5,0
16,36,689,2,0,2
16,36,632,1,1,0
16,36,1694,1,0,1
16,36,311,0,0,0
16,36,1394,3,1,2
16,36,539,0,0,0
16,36,1484,10,6,4
16,36,1973,1,1,0
16,37,575,0,0,0
16,37,677,0,0,0
16,37,1355,79,43,36
16,37,1244,8,5,3
16,37,364,0,0,0
16,37,366,4,2,2
16,37,411,2,2,0
16,37,421,2,1,1
16,37,917,1,1,0
16,37,842,11,6,5
16,37,773,70,38,32
16,38,1614,4,4,0
16,38,1136,17,6,11
16,38,1643,13,6,7
16,38,2113,0,0,0
16,38,2432,5,1,4
16,38,2088,11,1,10
16,38,1716,13,4,9
16,38,1167,13,5,8
16,38,1753,3,2,1
16,38,1661,4,3,1
16,38,996,2,0,2
16,38,1396,14,8,6
16,38,3075,14,6,8
16,38,1472,15,7,8
16,38,397,1,1,0
16,38,541,9,3,6
16,38,80,0,0,0
16,38,367,149,71,78
16,38,730,76,41,35
16,38,717,0,0,0
16,38,858,3,1,2
16,38,975,3,0,3
16,38,301,0,0,0
16,38,431,0,0,0
16,38,195,1,1,0
16,38,993,14,8,6
16,38,1405,1,0,1
16,38,580,0,0,0
16,38,523,2,1,1
16,38,820,2,1,1
16,38,1283,2,1,1
16,38,898,1,0,1
16,38,1189,3,1,2
16,38,767,0,0,0
16,38,170,5,1,4
16,38,140,0,0,0
16,38,198,0,0,0
16,38,102,0,0,0
16,38,757,1,0,1
16,38,506,11,6,5
16,38,718,1,1,0
16,38,172,2,1,1
16,38,344,30,15,15
16,38,288,0,0,0
16,38,254,1,0,1
16,39,3259,48,23,25
16,39,1145,37,15,22
16,39,973,1,1,0
16,39,3638,17,10,7
16,40,3141,8,6,2
16,40,1860,4,2,2
16,40,1713,3,0,3
16,40,2059,9,6,3
16,40,1296,2,1,1
16,40,665,2,1,1
16,40,712,18,9,9
16,40,345,2,1,1
16,40,3906,20,11,9
16,40,1378,32,19,13
16,40,259,0,0,0
16,40,517,0,0,0
16,40,218,0,0,0
16,41,5046,57,29,28
16,41,1494,10,6,4
16,41,619,0,0,0
16,41,992,13,11,2
16,41,2674,23,7,16
16,41,1218,5,2,3
16,41,696,49,29,20
16,41,3133,85,37,48
16,42,1764,9,5,4
16,42,1207,0,0,0
16,42,1368,2,1,1
16,42,752,8,4,4
16,42,943,6,1,5
16,42,1925,7,4,3
16,42,911,7,2,5
16,42,632,0,0,0
16,42,880,0,0,0
16,42,1349,9,5,4
16,42,1956,14,7,7
16,42,615,22,12,10
16,43,1445,41,19,22
16,43,1096,5,4,1
16,43,1776,29,18,11
16,43,3223,22,14,8
16,43,1331,9,4,5
16,43,1190,12,6,6
16,43,1110,20,12,8
16,43,1903,102,59,43
16,43,1120,7,4,3
16,43,662,12,6,6
16,43,1524,23,9,14
16,43,1105,9,5,4
16,43,1265,13,7,6
16,43,3510,50,26,24
16,43,1209,1,1,0
16,43,1655,6,2,4
16,43,6888,28,11,17
16,43,1410,17,10,7
16,43,9122,85,38,47
16,43,1221,3,1,2
16,43,1593,7,3,4
16,43,1434,0,0,0
16,43,5995,99,49,50
16,43,5611,15,5,10
16,43,7152,51,33,18
16,43,1817,40,25,15
16,43,1693,7,3,4
16,44,1233,5,1,4
16,44,944,0,0,0
16,44,1596,4,2,2
16,44,962,0,0,0
16,44,1288,10,3,7
16,44,1122,13,5,8
16,44,625,1,1,0
16,44,752,2,1,1
16,44,496,0,0,0
16,44,514,4,1,3
16,44,1647,9,7,2
16,44,1109,2,0,2
16,44,269,2,0,2
16,44,392,1,0,1
16,45,1290,26,16,10
16,45,3404,59,37,22
16,45,1926,7,1,6
16,45,1153,39,19,20
16,45,620,10,7,3
16,45,790,13,9,4
16,45,644,7,3,4
16,45,2016,576,292,284
16,45,1092,14,7,7
16,45,838,8,5,3
16,45,1511,28,17,11
16,45,928,3,1,2
16,45,1581,353,185,168
16,45,886,0,0,0
16,45,685,0,0,0
16,45,1564,1,0,1
16,45,1490,15,7,8
16,45,1279,5,2,3
16,45,2884,58,29,29
16,45,1315,12,4,8
16,45,1455,3,3,0
16,45,1421,19,10,9
16,45,412,3,1,2
16,45,1363,3,2,1
16,45,543,0,0,0
16,45,2534,13,8,5
16,45,2037,12,5,7
16,45,184,1,0,1
16,45,677,1,0,1
16,45,89,0,0,0
16,46,1915,5,3,2
16,46,790,0,0,0
16,46,2237,1,0,1
16,46,1283,4,1,3
16,46,2549,3,1,2
16,46,1878,4,2,2
16,46,1565,3,1,2
16,46,1021,5,3,2
16,46,1870,1,1,0
16,46,1510,8,5,3
16,46,1399,0,0,0
16,46,410,2,1,1
16,46,519,0,0,0
16,46,1515,0,0,0
16,46,1981,0,0,0
16,46,1130,1,0,1
16,46,1552,8,5,3
16,46,986,1,0,1
16,47,2296,7,3,4
16,47,1948,16,10,6
16,47,709,3,2,1
16,47,1403,1,1,0
16,47,620,0,0,0
16,47,734,0,0,0
16,47,757,1,0,1
16,47,309,0,0,0
16,47,580,0,0,0
16,47,1792,3,0,3
16,47,3309,5,1,4
16,47,699,0,0,0
16,48,1269,4,3,1
16,48,2077,2,0,2
16,48,2012,10,7,3
16,48,441,0,0,0
16,48,2315,1,0,1
16,48,2124,4,2,2
16,48,1342,2,1,1
16,48,1826,0,0,0
16,48,702,0,0,0
16,48,472,2,0,2
16,48,1395,0,0,0
16,48,1059,2,0,2
16,48,445,8,2,6
16,48,896,1,0,1
16,48,993,4,3,1
16,48,217,0,0,0
16,49,1371,8,5,3
16,49,1727,4,2,2
16,49,1501,13,6,7
16,49,1304,4,2,2
16,50,11202,237,123,114
16,50,9293,274,131,143
16,50,1934,11,3,8
16,50,331,0,0,0
16,50,3062,115,56,59
16,50,3185,23,6,17
16,50,3435,76,38,38
16,50,7306,121,60,61
16,50,971,10,5,5
16,50,2388,66,31,35
16,50,3924,55,24,31
16,50,1014,9,5,4
16,50,958,16,7,9
16,50,1310,59,31,28
16,50,3592,126,72,54
16,50,1258,31,17,14
16,50,1479,27,17,10
16,50,1319,9,5,4
16,50,791,24,14,10
16,50,1008,8,3,5
16,50,923,4,3,1
16,50,349,8,6,2
16,50,265,0,0,0
16,50,17,1,0,1
16,50,715,8,2,6
16,50,625,48,28,20
16,50,3463,13,8,5
16,50,609,14,3,11
16,50,2153,0,0,0
16,50,2257,9,7,2
16,50,2728,78,7,71
16,50,2295,58,25,33
16,50,1310,25,14,11
16,50,2123,141,62,79
16,50,2143,104,49,55
16,50,5285,30,14,16
16,50,2644,9,4,5
16,50,1279,40,19,21
16,50,3295,169,75,94
16,50,2030,17,4,13
16,50,2941,338,174,164
16,50,2377,108,61,47
16,50,1819,19,11,8
16,50,6318,305,150,155
16,50,1777,66,35,31
16,50,4931,55,34,21
16,50,1782,148,73,75
16,50,1456,635,310,325
16,50,1734,336,179,157
16,50,5093,109,59,50
16,50,4230,84,51,33
16,50,2378,62,28,34
16,50,8155,315,160,155
16,50,9868,378,189,189
16,50,11358,164,79,85
16,50,402,4,2,2
16,50,1769,11,6,5
16,50,2770,8,6,2
16,50,920,5,3,2
16,50,2542,65,25,40
16,50,403,6,3,3
16,50,524,15,8,7
16,50,19833,430,198,232
16,50,1056,21,10,11
16,50,3233,17,6,11
16,51,4029,44,19,25
16,51,2014,5,2,3
16,51,3339,13,7,6
16,51,1331,1,0,1
16,51,2020,5,2,3
16,51,566,2,2,0
16,51,746,0,0,0
16,51,947,4,2,2
16,51,263,0,0,0
16,51,1204,2,1,1
16,51,1258,2,1,1
16,51,718,9,6,3
16,51,326,0,0,0
16,51,248,0,0,0
16,52,4304,43,16,27
16,52,1731,17,10,7
16,52,1971,8,4,4
16,52,2358,43,24,19
16,52,1192,4,2,2
16,52,1157,9,5,4
16,52,3761,15,8,7
16,52,2353,8,5,3
16,52,950,0,0,0
16,52,2949,16,7,9
16,52,3570,24,11,13
16,52,1899,82,44,38
16,52,1711,18,9,9
16,52,5201,36,16,20
16,52,3057,26,12,14
16,52,2303,18,11,7
16,52,2613,19,10,9
16,52,922,1,1,0
16,52,3955,5,2,3
16,52,2218,48,19,29
16,52,1665,8,2,6
16,52,1401,7,3,4
16,52,447,0,0,0
16,52,2042,6,5,1
16,52,2293,8,5,3
16,52,1669,47,22,25
16,52,1410,0,0,0
16,52,5362,5,2,3
16,52,541,1,0,1
16,52,3250,12,3,9
16,52,1648,35,18,17
16,52,1135,3,0,3
16,52,922,2,2,0
16,52,607,0,0,0
16,52,2336,12,3,9
16,52,1208,4,1,3
16,52,601,1,0,1
16,52,2459,14,11,3
16,52,1769,69,30,39
16,52,2443,52,27,25
16,52,912,0,0,0
16,52,1359,27,16,11
16,52,116,0,0,0
16,52,2454,6,2,4
16,53,2360,128,59,69
16,53,2673,28,12,16
16,53,839,11,5,6
16,53,1363,1,0,1
16,53,2002,21,13,8
16,53,1273,22,11,11
16,53,34,0,0,0
16,53,550,1,0,1
16,53,1401,6,4,2
16,53,460,6,4,2
16,53,837,2,1,1
16,53,191,0,0,0
16,54,1358,6,3,3
16,54,3258,96,47,49
16,54,1124,41,21,20
16,54,1512,6,3,3
16,54,2131,6,3,3
16,54,1292,5,2,3
16,54,1543,12,5,7
16,54,1566,13,7,6
16,54,4027,32,17,15
16,54,1547,0,0,0
16,54,1556,2,1,1
16,54,2021,12,5,7
16,54,4599,92,52,40
16,54,1932,183,94,89
16,54,1936,583,318,265
16,54,1664,20,9,11
16,54,940,14,5,9
16,54,3548,26,14,12
16,54,1412,9,5,4
16,54,1642,8,3,5
16,54,721,8,2,6
16,54,940,6,4,2
16,54,1414,91,46,45
16,54,1309,35,17,18
16,54,1022,29,17,12
16,54,957,22,13,9
16,54,1017,0,0,0
16,54,956,12,6,6
16,54,1522,12,7,5
16,54,1447,18,6,12
16,54,679,2,1,1
16,54,1209,5,2,3
16,54,1003,3,1,2
16,54,735,10,2,8
16,54,373,7,5,2
16,54,677,12,5,7
16,54,800,16,6,10
16,54,4350,72,35,37
16,54,1442,4,1,3
16,54,3683,103,57,46
16,54,1528,14,9,5
16,54,1566,23,12,11
16,54,2257,41,22,19
16,54,1827,22,13,9
16,54,2237,13,4,9
16,54,813,10,4,6
16,54,750,5,5,0
16,54,893,2,2,0
16,54,1415,10,4,6
16,54,426,1,0,1
16,54,717,16,4,12
16,54,827,6,3,3
16,54,522,0,0,0
16,54,1014,6,1,5
16,54,749,30,14,16
16,54,510,1,0,1
16,54,1049,4,3,1
16,54,1322,30,14,16
16,54,1181,20,12,8
16,54,911,17,8,9
16,54,1164,48,25,23
16,54,789,22,12,10
16,54,1004,26,11,15
16,54,1101,31,18,13
16,54,1241,7,3,4
16,54,977,6,2,4
16,54,1234,59,34,25
16,54,1274,27,13,14
16,54,1143,18,9,9
16,54,1018,24,10,14
16,54,1401,3,0,3
16,54,1341,13,7,6
16,54,1026,6,2,4
16,54,1017,15,8,7
16,54,1569,11,5,6
16,54,797,7,3,4
16,54,697,177,97,80
16,54,818,221,122,99
16,54,1023,50,29,21
16,54,1270,18,14,4
16,54,1019,21,10,11
16,54,240,2,0,2
16,54,373,1,1,0
16,54,377,4,2,2
16,54,468,4,3,1
16,54,498,0,0,0
16,54,327,0,0,0
16,54,330,1,0,1
16,54,525,22,16,6
16,54,987,26,10,16
16,54,1007,1,1,0
16,54,1042,8,4,4
16,54,1865,11,5,6
16,54,1018,17,7,10
16,54,11689,50,28,22
16,54,8251,97,51,46
16,54,2250,26,13,13
16,54,1682,23,13,10
16,54,1446,65,32,33
16,54,1154,12,8,4
16,54,831,20,11,9
16,54,457,10,8,2
16,54,382,6,3,3
16,54,669,32,16,16
16,54,1206,72,38,34
16,54,912,16,11,5
16,54,636,21,8,13
16,54,749,16,10,6
16,54,733,21,12,9
16,54,864,32,16,16
16,54,1092,34,16,18
16,54,1335,24,8,16
16,54,2734,47,25,22
16,54,1204,2,1,1
16,54,886,3,3,0
16,54,1967,73,34,39
16,54,2081,4,2,2
16,54,1656,1,1,0
16,54,4168,157,75,82
16,54,2869,22,10,12
16,54,420,7,4,3
16,54,972,1,0,1
16,54,1126,26,15,11
16,54,918,11,7,4
16,54,401,10,4,6
16,54,938,9,3,6
16,54,664,14,7,7
16,54,439,11,7,4
16,54,429,6,4,2
16,54,831,32,25,7
16,54,648,7,4,3
16,54,704,34,16,18
16,54,557,5,2,3
16,54,718,108,68,40
16,54,493,9,4,5
16,54,1142,40,17,23
16,54,1240,14,8,6
16,54,1165,3,2,1
16,54,590,9,5,4
16,54,518,18,14,4
16,54,968,8,3,5
16,54,922,2,0,2
16,54,672,15,10,5
16,54,1325,13,5,8
16,54,1232,16,6,10
16,54,1311,12,6,6
16,54,1287,25,13,12
16,54,756,25,10,15
16,54,945,19,8,11
16,54,577,14,8,6
16,54,741,33,16,17
16,54,1229,50,26,24
16,54,1451,26,10,16
16,54,1090,2,1,1
16,54,677,5,3,2
16,54,1334,15,9,6
16,54,2428,41,26,15
16,54,1564,37,17,20
16,54,2369,13,5,8
16,54,2401,57,30,27
16,54,2302,18,10,8
16,54,1486,22,12,10
16,54,2636,18,11,7
16,54,2087,24,13,11
16,54,2423,45,27,18
16,54,2372,22,9,13
16,54,19948,255,127,128
16,54,1744,8,5,3
16,54,1105,19,12,7
16,54,1372,20,8,12
16,54,1419,28,13,15
16,54,1112,15,9,6
16,54,865,17,7,10
16,54,925,10,7,3
16,54,1048,26,17,9
16,54,887,33,16,17
16,54,955,31,18,13
16,54,704,16,9,7
16,54,720,16,8,8
16,54,885,28,16,12
16,54,1003,22,15,7
16,54,1145,10,5,5
16,54,792,4,2,2
16,54,829,10,4,6
16,54,1489,15,4,11
16,54,1319,13,8,5
16,54,838,3,1,2
16,54,1218,6,4,2
16,54,1405,3,2,1
16,54,776,12,6,6
16,54,1264,3,1,2
16,54,843,17,6,11
16,54,771,97,54,43
16,54,833,12,8,4
16,54,977,15,9,6
16,54,1052,1,0,1
16,54,1454,10,3,7
16,54,1086,7,2,5
16,54,920,9,4,5
16,54,1021,35,14,21
16,54,1290,71,34,37
16,54,2087,111,63,48
16,54,2336,19,8,11
16,54,1063,9,5,4
16,54,1573,48,24,24
16,54,1245,11,8,3
16,54,2198,58,27,31
16,54,1077,52,27,25
16,54,947,49,34,15
16,54,1435,9,4,5
16,54,1541,100,51,49
16,54,1521,55,27,28
16,54,1440,106,50,56
16,54,685,17,11,6
16,54,1061,5,2,3
16,54,622,14,7,7
16,54,666,9,4,5
16,54,3204,39,20,19
16,54,5750,101,46,55
16,54,5005,123,64,59
16,54,1210,17,8,9
16,54,1070,5,2,3
16,54,1859,86,43,43
16,54,1926,55,28,27
16,54,1179,9,4,5
16,54,1819,18,8,10
16,54,827,13,7,6
16,54,761,19,5,14
16,54,1087,20,11,9
16,54,1322,2,0,2
16,54,805,4,2,2
16,54,1045,7,5,2
16,54,557,7,3,4
16,54,1122,42,17,25
16,54,1064,36,19,17
16,54,552,9,6,3
16,54,1173,29,15,14
16,54,990,69,35,34
16,54,1336,31,13,18
16,54,317,3,0,3
16,54,821,58,24,34
16,54,894,10,7,3
16,54,678,0,0,0
16,54,1284,23,11,12
16,54,1135,4,3,1
16,54,1029,39,13,26
16,54,1050,6,3,3
16,54,1473,5,3,2
16,54,1460,38,19,19
16,54,1782,53,22,31
16,54,20910,225,124,101
16,54,9178,205,113,92
16,54,8648,69,31,38
16,54,2197,26,12,14
16,54,2875,42,19,23
16,54,4255,80,35,45
16,54,5647,29,15,14
16,54,3341,53,24,29
16,54,6224,43,17,26
16,54,2752,11,6,5
16,54,5021,39,20,19
16,54,2105,69,36,33
16,54,2099,162,84,78
16,54,1021,6,3,3
16,54,2888,57,31,26
16,54,1395,116,60,56
16,54,1665,57,32,25
16,54,1629,71,31,40
16,54,1104,20,10,10
16,54,1770,29,15,14
16,54,2104,12,8,4
16,54,1396,79,38,41
16,54,1898,39,22,17
16,54,8660,112,49,63
16,54,12916,342,168,174
16,54,3795,159,90,69
16,54,1852,4,1,3
16,54,2096,18,11,7
16,54,2077,53,24,29
16,54,20487,427,221,206
16,54,4822,33,18,15
16,54,3542,73,32,41
16,54,14188,224,112,112
16,54,2508,24,11,13
16,54,2333,49,29,20
16,54,576,13,7,6
16,54,9976,237,123,114
16,54,1864,26,13,13
16,54,2304,53,26,27
16,54,1465,56,33,23
16,54,5793,46,20,26
16,54,14794,488,254,234
16,54,1262,17,10,7
16,54,1794,7,4,3
16,54,4231,30,17,13
16,54,1351,4,2,2
16,54,2149,2,0,2
16,54,2761,11,5,6
16,54,3188,9,6,3
16,54,2203,10,5,5
16,54,2931,21,10,11
16,54,1339,17,9,8
16,54,1450,24,11,13
16,54,1961,12,5,7
16,54,1228,39,17,22
16,54,3140,14,10,4
16,54,1065,7,2,5
16,54,1118,3,2,1
16,54,2837,27,13,14
16,54,2256,10,5,5
16,54,2560,5,1,4
16,54,1119,1,1,0
16,54,608,5,3,2
16,54,1394,1,0,1
16,54,1675,67,38,29
16,54,958,3,1,2
16,54,453,1,0,1
16,54,377,0,0,0
16,54,1060,4,3,1
16,54,1008,2,1,1
16,54,8753,60,35,25
16,54,22585,280,124,156
16,54,12748,219,105,114
16,54,1869,4,1,3
16,54,16761,500,267,233
16,54,2641,64,33,31
16,54,6676,83,44,39
16,54,11746,483,249,234
16,54,5525,241,123,118
16,54,2020,17,12,5
16,54,263,0,0,0
16,54,517,3,2,1
16,54,2475,57,29,28
16,54,3070,11,3,8
16,54,993,10,5,5
16,54,1182,0,0,0
16,54,1674,2,1,1
16,54,719,2,1,1
16,54,1228,9,4,5
16,54,8330,71,40,31
16,54,3571,52,24,28
16,54,2504,29,12,17
16,54,5031,55,28,27
16,54,793,14,10,4
16,55,1149,2,0,2
16,55,1178,2,0,2
16,55,702,0,0,0
16,55,459,2,1,1
16,55,1023,2,0,2
16,55,1039,0,0,0
16,55,977,0,0,0
16,55,614,0,0,0
16,55,842,0,0,0
16,56,1639,39,22,17
16,56,3685,14,7,7
16,56,1241,2,0,2
16,56,1351,9,4,5
16,56,1475,18,10,8
16,56,2518,9,4,5
16,56,2712,9,7,2
16,56,1997,3,2,1
16,56,1253,10,4,6
16,56,1174,2,0,2
16,56,1889,7,4,3
16,56,1471,18,12,6
16,56,1165,9,4,5
16,56,2545,15,4,11
16,56,1690,8,7,1
16,56,2262,8,1,7
16,56,3056,28,9,19
16,56,620,10,6,4
16,56,3837,4,2,2
16,56,2707,23,10,13
16,56,2036,18,9,9
16,56,1859,9,4,5
16,56,1417,2,1,1
16,56,725,0,0,0
16,57,3785,24,11,13
16,57,2013,11,5,6
16,57,2671,37,26,11
16,57,3726,40,14,26
16,57,1408,1,1,0
16,57,2097,9,4,5
16,57,2871,25,10,15
16,57,3378,609,294,315
16,57,891,28,12,16
16,57,616,4,1,3
16,57,2227,32,15,17
16,57,1868,0,0,0
16,57,953,1,0,1
16,57,2386,640,329,311
16,57,1708,200,102,98
16,58,810,0,0,0
16,58,1325,3,2,1
16,58,1883,79,36,43
16,58,353,0,0,0
16,58,143,0,0,0
16,58,313,0,0,0
16,58,1131,1,0,1
16,58,490,10,3,7
16,58,490,1,1,0
16,58,331,0,0,0
16,58,303,0,0,0
16,58,202,0,0,0
16,58,456,14,6,8
16,59,4364,24,13,11
16,59,3762,87,47,40
16,59,1539,2,0,2
16,59,2085,2,0,2
16,59,2647,9,4,5
16,59,2951,2,0,2
16,59,886,3,1,2
16,59,1102,25,12,13
16,59,1127,13,3,10
16,59,183,0,0,0
16,59,335,2,2,0
16,60,2508,689,340,349
16,60,1010,30,14,16
16,60,495,9,4,5
16,60,959,9,2,7
16,60,1508,24,10,14
16,60,511,359,169,190
16,60,856,15,5,10
16,60,526,5,2,3
16,60,200,5,0,5
16,61,2293,4,1,3
16,61,2495,17,11,6
16,61,206,9,1,8
16,61,436,6,3,3
16,61,1368,13,6,7
16,61,454,1,0,1
16,61,484,1,0,1
16,61,986,1,0,1
16,61,709,1,0,1
16,62,1661,7,4,3
16,62,2480,5,5,0
16,62,793,4,3,1
16,62,1845,33,19,14
16,62,409,8,3,5
16,62,2368,11,7,4
16,62,3169,11,5,6
16,62,3811,27,9,18
16,62,3355,6,3,3
16,62,1153,57,35,22
16,62,3570,0,0,0
16,63,1711,0,0,0
16,63,882,3,2,1
16,63,2148,2,1,1
16,63,895,3,1,2
16,63,1462,1,0,1
16,63,1414,7,5,2
16,63,1126,1,0,1
16,63,1710,11,2,9
16,63,760,0,0,0
16,63,709,0,0,0
16,63,1056,3,2,1
16,63,1157,2,1,1
16,63,1137,10,4,6
16,63,1007,1,0,1
16,63,633,1,1,0
16,63,1198,7,3,4
16,63,1115,1,1,0
16,63,720,0,0,0
16,64,355,0,0,0
16,64,689,4,0,4
16,64,1007,12,9,3
16,64,870,6,6,0
16,64,1029,1,1,0
16,64,827,1,0,1
16,64,1044,29,16,13
16,64,808,9,3,6
16,64,553,4,2,2
16,64,183,2,1,1
16,64,1328,3,2,1
16,64,352,0,0,0
16,64,782,11,7,4
16,64,431,0,0,0
16,64,1997,7,4,3
16,64,313,3,2,1
16,64,586,0,0,0
16,64,886,1,1,0
16,64,955,2,1,1
16,65,1183,7,3,4
16,65,2981,4,2,2
16,65,2069,1,1,0
16,65,960,21,8,13
16,65,1103,0,0,0
16,65,1386,6,1,5
16,65,737,0,0,0
16,65,1865,2,2,0
16,65,5835,26,9,17
16,65,1416,4,2,2
16,65,2436,6,2,4
16,65,1321,0,0,0
16,65,792,31,13,18
16,65,923,1,1,0
16,66,2914,11,5,6
16,66,1837,6,2,4
16,66,1416,6,4,2
16,66,1401,16,9,7
16,66,1818,4,1,3
16,66,2490,5,4,1
16,66,3190,10,3,7
16,66,2161,17,9,8
16,66,4122,12,5,7
16,66,4357,23,11,12
16,66,2952,24,15,9
16,66,1952,10,6,4
16,66,2147,17,7,10
16,66,1933,23,13,10
16,66,1781,14,8,6
16,66,3196,11,9,2
16,67,2937,9,5,4
16,67,1705,14,7,7
16,67,3697,20,11,9
16,67,4302,41,23,18
16,67,2723,46,30,16
16,67,992,0,0,0
16,67,1729,17,9,8
16,67,2276,30,14,16
16,67,1013,51,31,20
16,67,1287,56,25,31
16,67,965,51,32,19
16,67,2450,13,8,5
16,67,326,23,14,9
16,67,716,18,6,12
16,67,7420,149,70,79
16,67,1787,112,55,57
16,67,1473,5,3,2
16,67,2476,5,3,2
16,67,5679,37,22,15
16,67,2457,19,13,6
16,67,4585,74,41,33
16,67,4371,58,30,28
16,67,3436,40,23,17
16,67,2787,13,5,8
16,67,1631,3,1,2
16,67,2100,29,20,9
16,67,2627,635,339,296
16,67,1107,162,88,74
16,67,1639,0,0,0
16,67,1736,20,11,9
16,67,2063,169,84,85
16,67,1172,109,54,55
16,67,1734,7,3,4
16,67,1130,0,0,0
16,67,1841,7,5,2
16,67,1503,6,3,3
16,67,2235,105,56,49
16,67,398,0,0,0
16,67,839,0,0,0
16,67,2567,3,2,1
16,67,1496,36,21,15
16,68,1257,2,2,0
16,68,820,0,0,0
16,68,789,3,1,2
16,68,1220,7,3,4
16,68,812,10,4,6
16,68,1062,0,0,0
16,68,1360,10,4,6
16,68,725,6,3,3
16,68,1155,6,1,5
16,68,1214,3,3,0
16,68,1095,2,2,0
16,68,817,37,16,21
16,68,307,0,0,0
16,68,1016,2,2,0
16,68,826,0,0,0
16,68,578,2,1,1
16,68,405,3,2,1
16,68,559,12,5,7
16,68,461,0,0,0
16,69,5223,18,7,11
16,69,2824,2,0,2
16,69,2177,3,0,3
16,69,2649,13,8,5
16,69,2514,1,0,1
16,69,2533,12,6,6
16,69,1711,3,3,0
16,69,2643,8,4,4
16,69,3259,3,0,3
16,69,2180,14,9,5
16,69,1088,4,0,4
16,69,527,2,0,2
16,70,4571,12,2,10
16,70,6483,88,40,48
16,70,5955,37,17,20
16,70,2706,31,11,20
16,70,3133,41,16,25
16,70,2747,26,14,12
16,70,1637,66,32,34
16,70,1088,8,5,3
16,70,1614,3,2,1
16,70,971,6,2,4
16,70,1396,15,8,7
16,70,1601,21,12,9
16,70,1826,76,38,38
16,70,3023,23,10,13
16,70,4465,115,63,52
16,70,2127,15,8,7
16,70,1558,10,2,8
16,70,926,5,2,3
16,70,781,10,3,7
16,70,541,4,2,2
16,70,234,6,3,3
16,70,581,4,4,0
16,70,519,2,1,1
16,70,1245,26,15,11
16,70,387,4,2,2
16,70,1256,12,5,7
16,70,886,7,5,2
16,70,1586,11,5,6
16,70,960,21,11,10
16,70,178,0,0,0
16,70,811,12,6,6
16,70,697,16,9,7
16,70,529,0,0,0
16,70,501,8,4,4
16,70,1021,101,47,54
16,70,629,1,0,1
16,70,666,1,1,0
16,70,720,13,8,5
16,70,2045,56,30,26
16,70,3359,150,83,67
16,70,861,3,2,1
16,70,1492,12,7,5
16,70,5605,38,13,25
16,70,3599,54,30,24
16,70,2025,10,5,5
16,70,433,15,12,3
16,70,366,0,0,0
16,70,925,8,2,6
16,70,1231,1,1,0
16,70,615,0,0,0
16,70,539,1,1,0
16,70,1812,5,2,3
16,70,316,0,0,0
16,70,331,0,0,0
16,70,5717,57,35,22
16,70,8640,40,18,22
16,70,340,0,0,0
16,70,680,1,1,0
16,70,1107,1,0,1
16,70,250,1,1,0
16,70,1653,8,5,3
16,71,1539,4,4,0
16,71,810,0,0,0
16,71,2233,28,16,12
16,71,1490,16,11,5
16,71,2439,7,2,5
16,71,1060,0,0,0
16,71,1526,32,17,15
16,71,1514,3,1,2
16,71,1447,10,5,5
16,71,355,0,0,0
16,71,1090,0,0,0
16,72,1907,6,1,5
16,72,2681,23,15,8
16,72,4317,39,17,22
16,72,2051,34,19,15
16,72,1065,9,4,5
16,72,811,30,19,11
16,72,2575,17,8,9
16,72,1916,3,2,1
16,72,4565,28,13,15
16,72,907,1,1,0
16,72,2102,4,4,0
16,72,1311,9,5,4
16,72,4331,65,31,34
16,72,1802,10,6,4
16,72,2074,10,5,5
16,72,1060,6,3,3
16,72,871,0,0,0
16,72,1186,1,0,1
16,72,1277,1,1,0
16,72,559,0,0,0
16,72,392,6,6,0
16,72,517,7,5,2
16,72,1884,2,2,0
16,72,2451,6,5,1
16,72,2725,4,4,0
16,72,1162,0,0,0
16,72,1085,4,1,3
16,72,1626,13,5,8
16,72,1655,8,4,4
16,72,1416,2,0,2
16,72,958,4,2,2
16,72,1093,3,1,2
16,72,646,0,0,0
16,72,620,0,0,0
16,72,2423,3,2,1
16,72,764,2,1,1
16,72,1160,2,1,1
16,72,1612,0,0,0
16,72,283,0,0,0
16,72,545,0,0,0
16,72,1303,7,3,4
16,72,356,0,0,0
16,72,727,6,3,3
16,72,512,2,2,0
16,72,487,2,1,1
16,72,1528,21,12,9
16,73,2277,2,2,0
16,73,1409,3,1,2
16,73,993,2,1,1
16,73,1895,26,7,19
16,73,1588,10,3,7
16,73,1713,17,5,12
16,73,355,2,1,1
16,73,650,1,0,1
16,73,637,0,0,0
16,73,1483,3,1,2
16,73,354,2,0,2
16,73,417,2,1,1
16,73,370,0,0,0
16,73,205,0,0,0
16,74,2185,7,4,3
16,74,5926,29,14,15
16,74,1546,5,1,4
16,74,2925,8,5,3
16,74,1679,5,4,1
16,74,1998,5,2,3
16,74,1263,21,8,13
16,74,1165,12,6,6
16,74,3423,6,4,2
16,74,2189,32,13,19
16,74,1155,10,6,4
16,74,843,0,0,0
16,74,385,7,3,4
16,74,514,6,4,2
16,75,1170,17,6,11
16,75,815,4,2,2
16,75,795,3,1,2
16,75,950,3,2,1
16,75,1887,17,7,10
16,75,2094,20,10,10
16,75,905,1,0,1
16,75,826,1,0,1
16,75,1111,4,0,4
16,76,3459,26,15,11
16,76,2587,41,21,20
16,76,1970,21,11,10
16,76,3866,48,24,24
16,76,1278,10,5,5
16,76,793,5,2,3
16,76,887,11,4,7
16,76,2590,26,15,11
16,76,1954,8,4,4
16,76,934,36,20,16
16,76,1006,6,4,2
16,76,987,8,5,3
16,76,877,5,5,0
16,76,1111,7,2,5
16,76,3898,116,55,61
16,76,2308,15,8,7
16,76,1939,22,11,11
16,76,1458,6,2,4
16,76,1588,15,9,6
16,76,1290,32,19,13
16,76,2989,32,15,17
16,76,6552,62,29,33
16,76,2638,21,10,11
16,76,1799,15,4,11
16,76,1945,8,4,4
16,76,2877,45,14,31
16,76,3768,172,96,76
16,76,3830,37,11,26
16,76,2844,14,10,4
16,76,2329,7,2,5
16,76,1593,6,3,3
16,76,2183,25,11,14
16,76,1572,14,7,7
16,76,4005,12,5,7
16,76,823,5,1,4
16,77,2482,36,16,20
16,77,1836,9,5,4
16,77,6538,63,37,26
16,77,1828,2,1,1
16,77,770,3,2,1
16,77,907,2,1,1
16,77,1262,1,0,1
16,77,1215,2,1,1
16,77,1025,6,2,4
16,77,995,0,0,0
16,77,684,15,11,4
16,77,637,1,1,0
16,77,1499,7,3,4
16,77,1981,13,5,8
16,77,757,7,2,5
16,77,668,2,2,0
16,77,634,0,0,0
16,77,390,2,2,0
16,77,792,0,0,0
16,77,1194,3,3,0
16,77,492,1,1,0
16,77,3346,2,0,2
16,77,2793,21,11,10
16,77,954,2,1,1
16,77,644,6,3,3
16,77,615,0,0,0
16,77,594,3,3,0
16,77,814,13,4,9
16,77,622,1,0,1
16,77,1106,4,3,1
16,77,1371,37,18,19
16,77,1635,21,11,10
16,77,3863,47,26,21
16,77,1100,47,25,22
16,77,1460,38,25,13
16,77,1431,5,2,3
16,77,747,4,1,3
16,77,890,3,1,2
16,77,1113,4,3,1
16,77,1017,4,3,1
16,77,883,14,6,8
16,77,1072,7,3,4
16,77,4613,7,5,2
16,77,4498,16,8,8
16,77,2627,11,6,5
16,77,896,11,6,5
16,77,291,1,0,1
16,77,360,0,0,0
16,77,6083,217,117,100
16,78,1890,13,7,6
16,78,846,3,1,2
16,78,755,3,2,1
16,78,420,2,1,1
16,78,749,5,3,2
16,78,769,1,0,1
16,78,617,0,0,0
16,78,537,0,0,0
16,78,281,27,15,12
16,78,122,0,0,0
16,78,527,0,0,0
16,78,1125,3,1,2
16,78,312,0,0,0
16,78,1294,1,0,1
16,78,1503,3,2,1
16,78,1204,15,7,8
16,78,683,1,1,0
16,78,2113,3,1,2
16,78,1497,4,3,1
16,78,459,2,0,2
16,79,1858,13,6,7
16,79,483,1,1,0
16,79,1511,6,4,2
16,79,3767,12,5,7
16,79,1742,13,6,7
16,79,511,2,0,2
16,79,221,0,0,0
16,79,944,17,8,9
16,79,619,26,7,19
16,79,678,0,0,0
16,79,478,1,1,0
16,80,2717,14,6,8
16,80,4799,69,28,41
16,80,2560,14,6,8
16,80,6119,27,6,21
16,80,2905,586,313,273
16,80,979,10,6,4
16,80,7643,41,20,21
16,80,3288,7,2,5
16,80,950,1,0,1
16,80,693,4,0,4
16,80,1110,10,6,4
16,80,2231,22,8,14
16,80,716,11,7,4
16,80,1591,3,2,1
16,80,817,36,14,22
16,80,811,3,3,0
16,80,1751,6,2,4
16,80,836,5,2,3
16,80,861,9,5,4
16,80,1600,19,10,9
16,80,1236,24,13,11
16,80,1475,2,1,1
16,81,1901,7,4,3
16,81,2859,3,0,3
16,81,1045,7,4,3
16,81,1931,24,14,10
16,81,2094,80,46,34
16,81,1454,16,9,7
16,81,1887,4,3,1
16,81,3288,239,120,119
16,81,1074,2,0,2
16,81,953,27,15,12
16,81,1863,6,4,2
16,82,838,1,1,0
16,82,1205,1,0,1
16,82,1495,5,2,3
16,82,800,0,0,0
16,82,2508,8,5,3
16,82,361,1,1,0
16,82,727,1,1,0
16,82,183,0,0,0
16,82,540,0,0,0
16,82,265,0,0,0
16,83,4257,22,10,12
16,83,606,0,0,0
16,83,1263,128,69,59
16,83,3481,1348,700,648
16,83,3066,25,10,15
16,83,1070,3,2,1
16,83,928,1,1,0
16,83,2225,15,9,6
16,83,1514,460,233,227
16,83,8979,1307,690,617
16,83,2976,17,7,10
16,83,2729,5,0,5
16,83,4056,55,28,27
16,83,399,1,0,1
16,83,319,0,0,0
16,83,2414,11,3,8
16,83,1560,7,2,5
16,83,1235,1,0,1
16,83,1793,466,231,235
16,83,2089,29,13,16
16,83,2636,32,19,13
16,83,836,1,0,1
16,83,962,4,1,3
16,83,2989,35,9,26
16,83,2783,8,5,3
16,83,1179,0,0,0
16,83,3410,19,9,10
16,83,139,1,0,1
16,83,1153,3,1,2
16,83,2508,40,15,25
16,83,1426,12,4,8
16,83,1880,1,1,0
16,83,2726,12,3,9
16,83,1233,0,0,0
16,83,1352,1,0,1
16,83,2452,7,5,2
16,83,1714,32,19,13
16,83,287,0,0,0
16,84,3497,31,19,12
16,84,2729,10,7,3
16,84,5308,15,2,13
16,84,1928,5,2,3
16,84,1138,0,0,0
16,84,2793,3,0,3
16,84,1774,2,1,1
16,84,2130,3,0,3
16,84,4452,57,27,30
16,84,1143,0,0,0
16,84,868,2,0,2
16,84,1414,7,2,5
16,84,1388,4,3,1
16,84,866,1,0,1
16,84,2259,22,11,11
16,85,1292,25,16,9
16,85,1513,9,3,6
16,85,3417,42,20,22
16,85,1521,1,1,0
16,85,1557,7,3,4
16,85,2170,2,2,0
16,85,2618,6,4,2
16,85,3144,22,16,6
16,85,2262,15,6,9
16,85,3190,30,12,18
16,85,2548,4,1,3
16,85,2951,24,9,15
16,85,2210,29,16,13
16,85,1248,2,1,1
16,86,2451,36,17,19
16,86,1086,11,5,6
16,86,2222,28,18,10
16,86,1811,16,8,8
16,86,1123,14,8,6
16,86,714,1,1,0
16,86,722,7,1,6
16,86,929,7,5,2
16,86,4330,27,13,14
16,86,859,44,22,22
16,86,1150,24,10,14
16,86,1844,15,6,9
16,86,510,1,1,0
16,86,465,2,1,1
16,86,180,10,3,7
16,86,351,9,5,4
16,86,455,10,3,7
16,86,2476,13,6,7
16,86,1382,9,3,6
16,86,1148,1,1,0
16,86,543,14,6,8
16,86,344,0,0,0
16,86,1323,20,13,7
16,86,1507,2,1,1
16,86,2231,15,4,11
16,86,806,1,0,1
16,86,2360,2,1,1
16,87,2990,7,2,5
16,87,945,0,0,0
16,87,1176,0,0,0
16,87,2338,19,9,10
16,87,996,1,1,0
16,87,2120,11,5,6
16,87,1362,0,0,0
16,87,1143,3,1,2
16,87,1249,15,11,4
16,87,820,0,0,0
16,87,372,2,1,1
16,88,2428,8,4,4
16,88,1753,8,3,5
16,88,1484,15,8,7
16,88,2041,1,1,0
16,88,1796,0,0,0
16,88,2971,15,6,9
16,88,1119,0,0,0
16,88,1457,3,1,2
16,88,540,1,0,1
16,89,2077,53,26,27
16,89,2947,29,13,16
16,89,2017,7,3,4
16,89,1886,4,1,3
16,89,1742,3,2,1
16,89,1455,12,5,7
16,89,2764,6,5,1
16,89,2864,5,1,4
16,89,5130,77,40,37
16,89,1082,8,3,5
16,89,1674,0,0,0
16,89,2064,23,12,11
16,89,4461,30,15,15
16,89,1893,3,2,1
16,89,3910,24,11,13
16,89,2684,16,9,7
16,89,2478,12,8,4
16,89,19849,496,242,254
16,89,3588,88,38,50
16,90,2178,30,14,16
16,90,785,8,2,6
16,90,2344,10,5,5
16,90,1797,16,4,12
16,90,1896,23,6,17
16,90,2258,1,1,0
16,90,2312,8,4,4
16,90,3195,3,0,3
16,90,908,1,0,1
16,90,963,3,1,2
16,90,2036,15,9,6
16,90,761,35,16,19
16,90,1487,14,8,6
16,90,427,1,1,0
16,90,408,17,10,7
16,90,346,0,0,0
16,91,1722,44,26,18
16,91,2833,440,233,207
16,91,2325,302,158,144
16,91,2292,8,3,5
16,91,2238,40,22,18
16,91,3458,25,11,14
16,91,1457,2,0,2
16,92,1797,14,8,6
16,92,1223,2,1,1
16,92,1112,20,12,8
16,92,2093,8,5,3
16,92,2070,6,5,1
16,92,1002,73,47,26
16,92,1386,117,60,57
16,92,1266,110,56,54
16,92,1274,1,1,0
16,92,1015,3,0,3
16,92,934,0,0,0
16,93,1740,2,1,1
16,93,2344,4,0,4
16,93,694,0,0,0
16,93,1296,4,2,2
16,93,1011,1,0,1
16,93,1633,7,6,1
16,93,558,2,1,1
16,93,560,7,4,3
16,93,971,1,0,1
16,93,818,0,0,0
16,93,409,1,1,0
16,94,2673,37,14,23
16,94,1476,17,13,4
16,94,1131,5,4,1
16,94,1333,11,7,4
16,94,3054,7,5,2
16,94,1664,21,8,13
16,94,2206,22,15,7
16,94,1542,1,0,1
16,94,3840,13,4,9
16,94,2105,21,5,16
16,94,1264,0,0,0
16,94,470,1,1,0
16,94,1063,1,0,1
16,94,2910,4,3,1
16,94,800,4,2,2
16,95,774,4,2,2
16,95,475,1,1,0
16,95,690,5,4,1
16,95,643,5,3,2
16,95,1149,8,4,4
16,95,234,6,2,4
16,95,196,1,1,0
16,95,132,1,0,1
16,95,372,7,5,2
16,95,583,2,1,1
16,95,654,0,0,0
16,95,518,0,0,0
16,96,947,8,4,4
16,96,645,4,2,2
16,96,757,6,3,3
16,96,2129,31,18,13
16,96,2432,17,7,10
16,96,1033,0,0,0
16,96,1019,2,0,2
16,96,1391,51,27,24
16,96,326,0,0,0
16,96,696,31,15,16
16,96,496,1,0,1
16,96,285,8,4,4
16,96,153,0,0,0
16,97,1490,7,3,4
16,97,1055,14,5,9
16,97,537,6,1,5
16,97,1389,0,0,0
16,97,245,0,0,0
16,97,578,0,0,0
16,97,99,0,0,0
16,97,250,0,0,0
16,98,965,0,0,0
16,98,1289,3,0,3
16,98,1008,2,0,2
16,98,569,1,1,0
16,98,647,3,1,2
16,98,719,1,0,1
16,98,2775,6,3,3
16,98,796,11,3,8
16,98,765,0,0,0
16,98,911,2,2,0
16,98,1339,13,9,4
16,98,2417,15,8,7
16,98,657,8,4,4
16,98,391,18,7,11
16,98,1103,8,4,4
16,98,896,3,2,1
16,98,767,0,0,0
16,98,1087,7,4,3
16,98,695,18,8,10
16,98,182,0,0,0
16,98,468,0,0,0
16,98,1060,4,2,2
16,98,1189,29,16,13
16,98,600,9,3,6
16,98,745,2,1,1
16,98,271,4,2,2
16,98,171,1,1,0
16,98,2284,18,8,10
16,98,343,0,0,0
16,98,214,1,1,0
16,98,393,2,2,0
16,98,145,0,0,0
16,98,509,4,1,3
16,98,768,2,0,2
16,98,350,0,0,0
16,98,376,2,0,2
16,99,2249,10,5,5
16,99,2099,7,3,4
16,99,1571,7,5,2
16,99,3415,58,23,35
16,99,1165,1,1,0
16,99,3383,15,10,5
16,99,1857,7,4,3
16,99,927,1,0,1
16,99,1279,6,2,4
16,99,1211,44,26,18
16,99,2276,131,71,60
16,99,261,0,0,0
16,99,962,6,4,2
16,99,1184,0,0,0
16,99,1477,10,4,6
16,99,263,2,1,1
16,99,188,0,0,0
16,100,1432,6,5,1
16,100,2112,28,16,12
16,100,555,1,1,0
16,100,944,19,7,12
16,100,465,2,1,1
16,100,659,5,4,1
16,100,583,1,0,1
16,100,150,0,0,0
16,100,747,0,0,0
16,100,1180,42,22,20
16,100,760,4,2,2
16,100,995,0,0,0
16,100,458,4,3,1
16,100,257,1,0,1
16,100,169,7,4,3
16,100,1547,4,2,2
16,100,349,0,0,0
16,100,125,1,1,0
16,100,232,0,0,0
16,100,198,0,0,0
16,101,1323,10,5,5
16,101,2382,50,23,27
16,101,2112,39,18,21
16,101,1196,12,8,4
16,101,1210,5,2,3
16,101,355,0,0,0
16,101,1763,2,1,1
16,101,2031,14,5,9
16,101,2124,3,0,3
16,102,608,11,4,7
16,102,953,20,11,9
16,102,300,5,4,1
16,102,231,0,0,0
16,102,221,0,0,0
16,102,90,0,0,0
16,102,975,1,1,0
16,102,401,0,0,0
16,102,948,0,0,0
16,102,1543,2,1,1
16,102,870,1,1,0
16,102,687,1,1,0
16,102,520,1,1,0
16,102,363,0,0,0
16,102,119,10,3,7
16,103,3356,90,47,43
16,103,1495,4,2,2
16,103,2390,30,14,16
16,103,1144,1,0,1
16,103,1972,6,4,2
16,103,2337,6,3,3
16,103,2113,98,48,50
16,103,2014,74,47,27
16,103,866,18,9,9
16,103,4247,49,25,24
16,103,5360,46,22,24
16,103,1877,12,8,4
16,103,1477,62,34,28
16,103,1538,10,4,6
16,103,1611,4,2,2
16,103,1533,2,1,1
16,103,952,17,9,8
16,103,1389,7,4,3
16,103,1056,5,2,3
16,103,1379,14,6,8
16,103,6974,92,46,46
16,103,3388,114,54,60
16,103,2740,81,49,32
16,103,2448,33,18,15
16,103,1159,3,2,1
16,103,1151,1,1,0
16,103,1100,41,16,25
16,103,974,16,7,9
16,103,1379,19,11,8
16,103,806,3,2,1
16,103,781,7,3,4
16,103,1676,10,6,4
16,103,14525,127,59,68
16,103,1471,12,8,4
16,103,1488,4,1,3
16,103,2070,5,1,4
16,103,995,1,0,1
16,103,914,1,0,1
16,103,1167,3,2,1
16,103,1086,18,10,8
16,103,837,17,10,7
16,103,726,18,9,9
16,103,742,4,1,3
16,103,2404,22,11,11
16,103,6489,58,23,35
16,103,921,4,2,2
16,103,586,7,3,4
16,103,857,1,1,0
16,103,635,0,0,0
16,103,895,1,1,0
16,103,1374,14,5,9
16,103,1571,6,4,2
16,103,1493,7,4,3
16,103,1228,7,4,3
16,103,4371,43,22,21
16,103,3109,12,9,3
16,103,3365,39,22,17
16,103,1543,5,4,1
16,103,1117,5,2,3
16,103,1421,6,2,4
16,103,2280,2,0,2
16,103,688,22,13,9
16,103,444,22,10,12
16,103,1097,13,5,8
16,103,1321,6,4,2
16,103,655,2,2,0
16,103,848,15,11,4
16,103,621,32,18,14
16,103,2860,8,4,4
16,103,2293,26,13,13
16,103,1499,32,12,20
16,103,1498,40,20,20
16,103,2176,54,28,26
16,103,10767,230,126,104
16,103,4038,153,65,88
16,103,5701,94,47,47
16,103,3385,97,49,48
16,103,1736,60,29,31
16,103,2330,21,14,7
16,103,4324,62,26,36
16,103,1111,34,24,10
16,103,1923,18,5,13
16,103,1218,24,9,15
16,103,793,15,8,7
16,103,1557,5,3,2
16,103,3594,33,20,13
16,103,9967,171,92,79
16,103,1956,3,1,2
16,103,2128,14,7,7
16,103,1890,15,12,3
16,103,1152,5,3,2
16,103,1316,7,3,4
16,103,2716,24,11,13
16,103,4601,81,43,38
16,103,17493,772,405,367
16,103,2027,22,10,12
16,103,2443,18,7,11
16,103,903,6,4,2
16,103,1436,0,0,0
16,103,1474,32,15,17
16,103,1338,34,17,17
16,103,1869,2,1,1
16,103,5951,83,45,38
16,103,2338,57,30,27
16,103,3264,13,6,7
16,103,1032,8,3,5
16,103,771,6,4,2
16,103,1439,7,5,2
16,103,2480,11,4,7
16,103,1453,19,17,2
16,103,1434,29,21,8
16,103,1251,17,8,9
16,103,1660,6,1,5
16,103,1122,2,1,1
16,103,2202,11,3,8
16,103,2023,24,12,12
16,103,4596,24,9,15
16,103,2719,24,16,8
16,103,23006,980,513,467
16,103,1145,7,3,4
16,103,3302,10,5,5
16,103,3643,15,7,8
16,103,3259,24,6,18
16,103,2778,31,9,22
16,103,2932,12,5,7
16,103,3650,154,70,84
16,103,1029,2,1,1
16,103,1078,1,0,1
16,103,2021,6,3,3
16,103,3011,10,6,4
16,103,2910,13,5,8
16,103,2078,11,6,5
16,103,695,17,7,10
16,103,1488,9,4,5
16,103,4329,10,6,4
16,103,4283,41,24,17
16,103,2189,0,0,0
16,103,797,2,1,1
16,103,1524,13,7,6
16,103,632,1,1,0
16,103,1256,4,1,3
16,104,595,1,0,1
16,104,685,4,2,2
16,104,1277,2,1,1
16,104,936,11,5,6
16,104,1442,11,4,7
16,104,629,10,4,6
16,104,1070,2,0,2
16,104,1351,41,24,17
16,104,1432,6,3,3
16,104,1108,13,5,8
16,104,1754,13,5,8
16,104,1900,2,0,2
16,104,1172,11,6,5
16,104,896,5,2,3
16,104,741,8,3,5
16,104,1057,13,8,5
16,104,982,72,44,28
16,104,758,1,0,1
16,104,1474,28,12,16
16,104,499,0,0,0
16,104,928,43,27,16
16,104,967,2,0,2
16,105,1168,10,3,7
16,105,1810,37,22,15
16,105,1605,31,18,13
16,105,1074,11,7,4
16,105,1262,19,13,6
16,105,385,8,3,5
16,105,403,2,1,1
16,105,293,0,0,0
16,105,369,31,9,22
16,105,757,15,12,3
16,105,934,3,2,1
16,105,2202,55,25,30
16,105,417,0,0,0
16,105,633,0,0,0
16,105,794,1,0,1
16,105,667,2,0,2
16,105,753,5,3,2
16,105,338,11,4,7
16,106,1908,35,18,17
16,106,1193,10,5,5
16,106,1107,121,58,63
16,106,3205,5,2,3
16,106,2718,114,57,57
16,106,2303,182,93,89
16,106,911,2,2,0
16,106,499,0,0,0
16,106,1239,0,0,0
16,106,1321,1,0,1
16,106,1217,1,0,1
16,106,1341,3,3,0
16,106,2020,0,0,0
16,107,1143,16,9,7
16,107,706,0,0,0
16,107,843,5,2,3
16,107,1587,169,86,83
16,107,2284,463,250,213
16,107,1837,0,0,0
16,107,843,0,0,0
16,107,1029,13,9,4
16,107,1572,2,1,1
16,107,3068,3,2,1
16,107,8865,27,12,15
16,107,2932,163,75,88
16,107,233,3,2,1
16,107,793,10,4,6
16,107,1090,3,0,3
16,107,1315,8,3,5
16,107,1084,14,5,9
16,107,363,3,3,0
16,107,739,4,3,1
16,108,1514,16,11,5
16,108,4066,76,38,38
16,108,5295,33,13,20
16,108,2869,234,114,120
16,108,1080,8,4,4
16,108,1441,9,4,5
16,108,675,0,0,0
16,108,1918,5,3,2
16,108,1167,29,16,13
16,108,718,4,2,2
16,108,1498,9,5,4
16,108,742,30,16,14
16,108,801,4,4,0
16,108,845,31,17,14
16,108,1224,6,2,4
16,108,1937,10,4,6
16,108,883,15,7,8
16,108,1982,33,16,17
16,108,2303,39,21,18
16,108,1576,16,7,9
16,108,1395,5,2,3
16,108,926,15,9,6
16,108,4655,13,6,7
16,108,1853,6,4,2
16,108,1612,12,2,10
16,108,1790,7,4,3
16,108,2074,21,12,9
16,108,898,37,16,21
16,108,1196,186,86,100
16,108,1815,24,10,14
16,108,1727,8,4,4
16,108,1013,51,28,23
16,108,2242,18,10,8
16,108,2306,46,24,22
16,108,565,70,43,27
16,108,928,17,4,13
16,108,750,0,0,0
16,108,702,0,0,0
16,108,867,0,0,0
16,108,818,0,0,0
16,108,1170,0,0,0
16,108,952,5,3,2
16,108,999,1,0,1
16,108,1069,4,3,1
16,108,809,1,1,0
16,108,437,9,3,6
16,109,2929,40,22,18
16,109,1010,0,0,0
16,109,3264,4,2,2
16,109,1654,98,47,51
16,109,945,619,325,294
16,109,3344,51,24,27
16,109,4324,31,18,13
16,109,4084,84,39,45
16,109,1453,9,5,4
16,109,6288,787,399,388
16,109,1912,51,29,22
16,109,3443,12,5,7
16,109,4426,45,22,23
16,109,3659,16,9,7
16,109,2994,9,3,6
16,109,4222,23,9,14
16,109,1469,120,67,53
16,109,2452,7,6,1
16,109,2490,16,4,12
16,109,934,3,1,2
16,109,1335,16,10,6
16,109,1267,3,1,2
16,109,1126,1,1,0
16,109,1351,29,12,17
16,109,1272,15,4,11
16,109,606,61,36,25
16,109,17877,643,313,330
16,109,1173,24,12,12
16,109,673,8,5,3
16,109,762,19,9,10
16,109,944,8,2,6
16,109,1013,5,4,1
16,109,1444,0,0,0
16,109,1435,17,6,11
16,109,3021,13,7,6
16,109,1032,2,0,2
16,109,1546,14,6,8
16,109,601,5,2,3
16,109,565,0,0,0
16,109,638,0,0,0
16,109,12895,295,139,156
16,109,1975,16,10,6
16,109,1627,20,8,12
16,109,633,0,0,0
16,109,613,2,2,0
16,109,332,1,1,0
16,109,527,1,1,0
16,109,416,0,0,0
16,109,436,0,0,0
16,109,962,0,0,0
16,109,642,5,3,2
16,109,1059,16,9,7
16,109,980,4,1,3
16,109,1878,21,11,10
16,109,1421,8,6,2
16,109,1200,6,3,3
16,109,966,9,3,6
16,109,909,9,5,4
16,109,733,6,0,6
16,109,2263,14,6,8
16,109,867,12,6,6
16,109,1363,17,6,11
16,109,1420,17,10,7
16,109,1372,9,7,2
16,109,1447,9,3,6
16,109,2013,105,48,57
16,109,1560,7,3,4
16,109,1404,27,16,11
16,109,1426,3,1,2
16,109,901,4,2,2
16,109,1260,8,5,3
16,109,2846,19,13,6
16,109,1361,2,1,1
16,109,2539,15,4,11
16,109,4734,18,8,10
16,109,735,2,1,1
16,109,559,24,14,10
16,109,965,0,0,0
16,109,1581,12,4,8
16,109,1587,11,2,9
16,109,513,9,4,5
16,109,402,1,1,0
16,109,525,1,0,1
16,109,2514,44,24,20
16,109,2909,50,24,26
16,109,2715,11,4,7
16,109,2015,45,23,22
16,109,1243,1,0,1
16,109,1301,8,6,2
16,109,1856,5,3,2
16,109,893,2,1,1
16,109,635,2,1,1
16,109,19030,137,66,71
16,109,973,2,2,0
16,110,531,4,1,3
16,110,757,8,3,5
16,110,486,7,2,5
16,110,206,0,0,0
16,110,244,0,0,0
16,110,397,1,1,0
16,110,611,2,1,1
16,111,1697,16,8,8
16,111,730,10,7,3
16,111,2682,6,3,3
16,111,1745,7,2,5
16,111,2067,5,3,2
16,111,1594,14,6,8
16,111,1351,6,4,2
16,111,2724,18,9,9
16,111,2424,1,1,0
16,111,1385,18,9,9
16,111,1429,0,0,0
16,111,2021,3,1,2
16,111,2752,1,0,1
16,111,527,2,1,1
16,111,1139,1,1,0
16,111,1332,1,0,1
16,111,279,0,0,0
16,111,1263,11,4,7
16,111,1333,8,4,4
16,111,1681,18,8,10
16,111,905,2,2,0
16,111,2331,49,25,24
16,111,1461,25,15,10
16,111,1591,3,1,2
16,111,251,0,0,0
16,111,933,2,1,1
16,111,1682,3,1,2
16,111,2347,4,3,1
16,111,1235,5,2,3
16,111,944,7,2,5
16,111,1908,10,6,4
16,111,630,0,0,0
16,112,2028,6,1,5
16,112,2184,3,1,2
16,112,5819,25,11,14
16,112,2457,14,9,5
16,112,1702,5,2,3
16,112,1954,94,47,47
16,112,1822,3,2,1
16,112,370,0,0,0
16,113,1180,3,0,3
16,113,1273,4,2,2
16,113,1133,9,6,3
16,113,963,5,2,3
16,113,1158,4,2,2
16,113,2852,30,13,17
16,113,3271,9,3,6
16,113,8297,40,15,25
16,113,1532,6,3,3
16,113,1415,4,2,2
16,113,1247,9,3,6
16,113,1089,16,4,12
16,113,436,0,0,0
16,113,1075,3,2,1
16,113,1588,7,4,3
16,113,1223,13,6,7
16,113,1374,23,16,7
16,113,1657,3,1,2
16,113,1509,6,3,3
16,113,1832,1,1,0
16,113,1387,3,2,1
16,113,1145,2,1,1
16,113,654,2,2,0
16,113,763,2,1,1
16,113,2057,9,3,6
16,113,1200,0,0,0
16,113,843,1,1,0
16,113,963,12,8,4
16,113,906,7,4,3
16,113,1456,25,18,7
16,113,1851,17,8,9
16,113,1145,7,4,3
16,113,5155,51,26,25
16,113,1356,20,12,8
16,113,1461,40,21,19
16,113,1979,10,4,6
16,113,981,0,0,0
16,113,3039,72,36,36
16,113,1446,8,4,4
16,113,1306,68,40,28
16,113,1052,57,31,26
16,113,1290,12,5,7
16,113,2953,30,17,13
16,113,842,8,3,5
16,113,2642,11,8,3
16,113,2024,0,0,0
16,113,375,4,1,3
16,113,1055,6,5,1
16,113,1850,90,47,43
16,113,830,0,0,0
16,113,3024,27,14,13
16,113,3960,58,32,26
16,113,1596,8,6,2
16,113,1729,73,40,33
16,113,2122,0,0,0
16,113,944,4,2,2
16,113,999,2,1,1
16,113,1408,5,4,1
16,113,2018,9,6,3
16,113,2194,204,102,102
16,113,3831,24,11,13
16,113,3000,17,10,7
16,113,3690,7,2,5
16,113,3086,6,2,4
16,113,3347,9,5,4
16,113,4763,25,16,9
16,113,4637,30,17,13
16,113,3796,70,44,26
16,113,2195,28,9,19
16,113,778,0,0,0
16,113,794,0,0,0
16,113,1540,7,7,0
16,113,2919,12,2,10
16,113,2605,11,7,4
16,113,2208,4,2,2
16,113,729,1,1,0
16,113,2902,2,0,2
16,113,1904,8,5,3
16,113,518,1,0,1
16,113,1250,2,0,2
16,113,4246,12,5,7
16,113,610,1,1,0
16,6,674,2,0,2
16,6,534,3,2,1
16,6,687,36,16,20
16,6,108,0,0,0
16,6,278,1,0,1
16,6,482,5,4,1
16,35,225,201,88,113
16,35,251,0,0,0
16,35,946,1,1,0
16,35,1307,2,1,1
16,35,650,4,1,3
16,65,697,0,0,0
16,65,541,0,0,0
16,80,1418,9,4,5
16,80,967,5,2,3
16,54,4983,108,54,54
16,109,837,4,4,0
16,54,1771,16,8,8
16,89,2840,124,62,62
16,89,3023,77,35,42
16,89,1644,10,3,7
16,89,2382,31,19,12
16,89,1428,31,15,16
16,89,2959,73,34,39
16,89,2208,37,14,23
16,89,2238,97,47,50
16,89,2229,28,12,16
16,89,3083,115,57,58
16,89,2179,32,17,15
16,89,3255,229,111,118
16,89,1704,118,59,59
16,89,2351,44,22,22
16,54,11442,114,52,62
16,89,1643,20,11,9
16,89,2776,28,16,12
16,89,1825,58,29,29
16,89,2210,66,31,35
16,89,1729,72,34,38
16,89,1953,312,158,154
16,89,1849,111,61,50
16,54,58,6,3,3
16,54,10851,123,67,56
16,54,1961,27,14,13
16,54,1803,38,19,19
16,54,4600,116,61,55
16,54,3994,87,49,38
16,54,3093,40,20,20
16,54,1358,30,15,15
16,54,4345,62,26,36
16,54,3719,145,77,68
16,54,6545,117,56,61
16,54,862,4,2,2
16,54,4673,94,53,41
16,54,5272,51,24,27
16,54,8164,241,118,123
16,54,2417,39,18,21
16,54,4686,70,35,35
16,54,2824,29,15,14
16,54,3105,32,18,14
16,54,3894,31,14,17
16,54,5175,58,33,25
16,54,3637,72,35,37
16,54,2753,22,13,9
16,109,2730,12,5,7
16,109,2361,13,6,7
16,108,4112,5,2,3
16,108,2615,5,2,3
16,54,962,1,1,0
16,54,5947,328,176,152
16,103,3649,30,14,16
16,103,4819,239,119,120
16,67,4543,66,29,37
16,67,2864,17,8,9
17,1,1968,11,7,4
17,1,1427,11,4,7
17,1,1278,3,2,1
17,1,2192,11,5,6
17,1,711,2,1,1
17,1,2150,2,1,1
17,1,1331,16,7,9
17,1,1657,10,4,6
17,1,1973,33,17,16
17,1,1915,2,1,1
17,1,840,3,1,2
17,2,3559,32,13,19
17,2,2662,55,30,25
17,2,1736,6,5,1
17,2,3563,36,17,19
17,2,1127,18,8,10
17,2,2330,7,3,4
17,2,1946,8,4,4
17,2,6984,159,78,81
17,2,1532,28,9,19
17,2,567,13,8,5
17,2,949,5,2,3
17,2,509,31,13,18
17,3,3022,2,1,1
17,3,1295,6,5,1
17,3,4490,23,12,11
17,3,1544,29,10,19
17,3,1558,11,6,5
17,3,3626,20,10,10
17,3,1890,27,13,14
17,3,2969,20,12,8
17,3,1668,24,15,9
17,3,2640,25,13,12
17,3,283,3,1,2
17,3,1994,0,0,0
17,3,1884,3,1,2
17,3,1839,2,0,2
17,3,2764,7,3,4
17,3,1711,2,2,0
17,3,1283,14,3,11
17,3,1291,12,7,5
17,3,457,1,1,0
17,3,1020,0,0,0
17,4,2617,25,10,15
17,4,3012,56,33,23
17,4,1477,58,28,30
17,4,2067,9,5,4
17,4,2436,18,11,7
17,4,1575,54,27,27
17,4,1870,8,4,4
17,4,1135,10,3,7
17,4,2221,760,400,360
17,4,1026,10,3,7
17,4,1805,4,3,1
17,4,4685,22,11,11
17,4,1785,11,10,1
17,4,1726,20,11,9
17,4,1776,17,9,8
17,4,4583,46,20,26
17,4,712,1,1,0
17,4,4217,70,32,38
17,4,3628,30,13,17
17,4,1652,33,14,19
17,4,1432,25,11,14
17,4,2601,5,4,1
17,4,2640,62,32,30
17,4,2642,217,88,129
17,4,3256,137,66,71
17,4,1440,17,11,6
17,4,2269,21,9,12
17,4,1573,29,14,15
17,4,2419,20,8,12
17,4,4455,59,25,34
17,4,2587,17,10,7
17,4,2525,14,7,7
17,4,1958,12,8,4
17,4,2821,13,3,10
17,4,323,6,2,4
17,4,1355,3,2,1
17,4,2179,15,6,9
17,4,440,2,1,1
17,4,591,19,10,9
17,4,1370,11,3,8
17,4,1972,10,4,6
17,4,998,5,2,3
17,5,944,1,0,1
17,5,1540,15,9,6
17,5,566,0,0,0
17,5,1533,2,2,0
17,5,554,1,0,1
17,5,248,3,1,2
17,5,1151,20,9,11
17,5,1201,6,4,2
17,5,1127,3,1,2
17,5,1379,66,37,29
17,5,333,38,16,22
17,6,6225,128,65,63
17,6,1388,9,5,4
17,6,2844,62,32,30
17,6,3822,38,21,17
17,6,1415,0,0,0
17,6,6379,93,49,44
17,6,1563,21,11,10
17,6,1206,33,19,14
17,6,820,53,33,20
17,6,1318,46,22,24
17,6,1272,15,9,6
17,6,2214,23,11,12
17,6,5438,111,55,56
17,6,2294,68,38,30
17,6,2929,56,32,24
17,6,1900,94,44,50
17,6,6564,374,194,180
17,6,4089,39,20,19
17,6,1349,11,5,6
17,6,1662,24,11,13
17,6,1171,14,6,8
17,6,1675,4,1,3
17,6,1360,3,0,3
17,6,1433,11,4,7
17,6,1672,6,3,3
17,6,849,0,0,0
17,6,2011,5,2,3
17,6,1196,23,11,12
17,6,4152,31,21,10
17,6,3533,57,35,22
17,6,1358,25,15,10
17,6,1383,7,2,5
17,6,1465,10,3,7
17,6,4961,210,47,163
17,6,1942,20,10,10
17,6,949,39,19,20
17,6,246,1,1,0
17,6,2113,35,15,20
17,6,6216,315,159,156
17,6,1136,15,10,5
17,6,1111,47,24,23
17,6,1696,37,19,18
17,6,1452,15,8,7
17,6,1172,7,3,4
17,6,584,12,6,6
17,6,2295,52,28,24
17,6,2239,17,10,7
17,6,896,3,1,2
17,6,821,10,7,3
17,6,809,2,1,1
17,6,1700,4,2,2
17,6,1304,1,0,1
17,6,902,24,14,10
17,6,4501,55,28,27
17,6,6362,201,108,93
17,6,1802,17,7,10
17,6,1411,14,9,5
17,6,981,8,4,4
17,6,1301,4,2,2
17,6,882,6,3,3
17,6,500,1,0,1
17,6,327,1,0,1
17,6,1332,25,12,13
17,6,503,6,3,3
17,6,275,0,0,0
17,6,894,0,0,0
17,6,353,0,0,0
17,6,328,14,5,9
17,6,1422,35,21,14
17,6,3005,56,28,28
17,6,798,12,7,5
17,6,669,5,2,3
17,6,1403,15,9,6
17,6,853,8,6,2
17,6,551,2,0,2
17,6,1516,15,8,7
17,6,1380,7,5,2
17,6,975,13,8,5
17,6,2090,14,7,7
17,6,820,13,6,7
17,6,5233,118,58,60
17,6,6070,35,18,17
17,6,1789,12,5,7
17,6,3596,16,7,9
17,6,4352,196,101,95
17,6,3518,200,107,93
17,6,1984,135,66,69
17,6,995,41,20,21
17,6,3536,31,18,13
17,6,3178,52,23,29
17,6,1140,48,20,28
17,7,5575,233,121,112
17,7,2265,116,57,59
17,7,3979,92,51,41
17,7,2326,27,14,13
17,7,2606,91,49,42
17,7,4521,52,26,26
17,7,5942,186,107,79
17,7,3597,93,47,46
17,7,4218,196,109,87
17,7,6569,378,193,185
17,7,3700,104,54,50
17,7,4282,152,82,70
17,7,3447,233,114,119
17,7,2280,119,66,53
17,7,2664,53,26,27
17,7,2269,45,24,21
17,7,2418,73,33,40
17,7,4468,95,41,54
17,7,1893,26,12,14
17,7,3863,34,18,16
17,7,3663,55,33,22
17,7,1800,27,13,14
17,7,1221,40,18,22
17,7,1126,30,12,18
17,7,2830,37,18,19
17,7,2308,26,14,12
17,7,1533,13,8,5
17,7,2122,29,13,16
17,7,995,7,6,1
17,7,1078,8,4,4
17,7,2361,7,6,1
17,7,10470,261,137,124
17,7,1878,21,12,9
17,7,10917,162,83,79
17,7,1248,12,7,5
17,7,1706,12,9,3
17,7,1305,8,4,4
17,7,1172,19,10,9
17,7,2016,56,33,23
17,7,2026,38,18,20
17,7,531,6,2,4
17,7,2038,45,18,27
17,7,956,14,10,4
17,7,1538,9,5,4
17,7,992,4,3,1
17,7,812,31,18,13
17,7,0,0,0,0
17,7,138,5,2,3
17,7,1090,43,27,16
17,7,543,9,6,3
17,7,12181,394,218,176
17,7,2729,23,12,11
17,7,1747,19,11,8
17,7,1579,19,9,10
17,7,505,18,9,9
17,7,1299,8,7,1
17,7,1049,51,27,24
17,7,2610,47,23,24
17,7,786,35,20,15
17,7,1644,28,13,15
17,7,534,5,2,3
17,7,919,7,3,4
17,7,851,17,12,5
17,7,1265,19,13,6
17,7,1381,10,2,8
17,7,1714,23,13,10
17,7,2635,44,26,18
17,7,1851,25,15,10
17,7,8093,182,94,88
17,7,827,30,13,17
17,7,651,6,5,1
17,7,1011,71,36,35
17,7,660,28,16,12
17,7,1279,22,13,9
17,7,1499,35,22,13
17,7,1161,54,27,27
17,7,745,21,15,6
17,7,736,11,7,4
17,7,1473,93,49,44
17,7,1287,63,36,27
17,7,835,6,4,2
17,7,720,31,15,16
17,7,1110,15,8,7
17,7,3191,37,20,17
17,7,1558,48,19,29
17,7,1524,25,18,7
17,7,1033,22,16,6
17,7,637,6,3,3
17,7,514,10,5,5
17,7,794,2,0,2
17,7,1582,34,11,23
17,7,352,17,10,7
17,7,1451,70,40,30
17,7,1940,72,42,30
17,7,1679,35,21,14
17,7,1990,17,10,7
17,7,1491,8,5,3
17,7,1978,24,13,11
17,7,1316,28,10,18
17,7,2495,22,10,12
17,7,856,12,8,4
17,7,1996,100,49,51
17,7,875,16,8,8
17,7,2042,45,25,20
17,7,476,8,4,4
17,7,923,25,11,14
17,7,773,6,3,3
17,7,744,8,4,4
17,7,950,9,7,2
17,7,978,4,1,3
17,7,297,3,3,0
17,7,746,15,6,9
17,7,638,13,5,8
17,7,4893,99,45,54
17,7,2547,42,23,19
17,7,1232,38,16,22
17,7,2310,75,37,38
17,7,1816,3,2,1
17,7,1155,4,2,2
17,7,1537,5,2,3
17,7,2924,37,22,15
17,7,1145,73,33,40
17,7,1452,23,13,10
17,7,1458,9,5,4
17,7,368,8,4,4
17,7,1120,10,6,4
17,7,1286,46,26,20
17,7,1745,3,2,1
17,7,1988,37,19,18
17,7,1611,10,6,4
17,7,515,7,4,3
17,7,2231,21,8,13
17,7,1215,6,3,3
17,7,1282,30,14,16
17,7,306,6,2,4
17,7,1192,38,24,14
17,7,279,6,3,3
17,7,290,6,5,1
17,7,1019,4,2,2
17,7,904,7,5,2
17,7,686,4,2,2
17,7,1208,64,32,32
17,7,773,14,7,7
17,7,1449,55,28,27
17,7,1812,15,8,7
17,7,1857,9,4,5
17,7,1660,29,13,16
17,7,1352,30,13,17
17,7,1544,107,56,51
17,7,1618,18,10,8
17,7,1876,34,18,16
17,7,1812,12,6,6
17,7,1709,16,6,10
17,7,798,15,6,9
17,7,1376,51,25,26
17,7,1741,51,31,20
17,7,539,3,1,2
17,7,435,18,8,10
17,7,270,2,1,1
17,7,1825,7,2,5
17,7,1680,21,12,9
17,7,1844,109,53,56
17,7,1083,4,4,0
17,7,497,14,9,5
17,7,451,11,4,7
17,7,1207,19,10,9
17,7,3232,110,56,54
17,7,1077,32,18,14
17,7,966,19,12,7
17,7,521,9,4,5
17,7,1295,1,0,1
17,7,1505,43,21,22
17,7,909,95,55,40
17,7,1429,35,21,14
17,7,559,23,15,8
17,7,1321,14,9,5
17,7,3745,204,114,90
17,7,2871,71,38,33
17,7,1872,13,6,7
17,7,1393,27,17,10
17,7,1300,39,18,21
17,7,1551,352,181,171
17,7,1187,286,157,129
17,7,725,11,6,5
17,7,3324,32,15,17
17,7,1702,14,6,8
17,7,3877,94,46,48
17,7,1117,37,21,16
17,7,2297,61,36,25
17,7,941,45,17,28
17,7,1311,478,261,217
17,7,915,20,13,7
17,7,377,7,4,3
17,7,1171,56,26,30
17,7,3496,81,32,49
17,7,2363,148,78,70
17,7,5896,99,63,36
17,7,1977,50,26,24
17,7,8012,59,30,29
17,7,3643,44,23,21
17,7,1403,5,3,2
17,7,1426,14,8,6
17,8,7253,77,35,42
17,8,3463,57,28,29
17,8,7985,194,88,106
17,8,2486,25,13,12
17,8,2353,12,6,6
17,8,7251,107,49,58
17,8,2291,14,6,8
17,8,1552,9,4,5
17,8,4683,67,29,38
17,8,2152,31,17,14
17,8,3444,36,18,18
17,8,6639,78,47,31
17,8,6576,125,66,59
17,8,1948,50,26,24
17,8,1502,13,8,5
17,8,11574,100,46,54
17,8,3265,56,27,29
17,8,3090,141,70,71
17,8,4127,84,48,36
17,8,4115,122,64,58
17,8,10881,442,220,222
17,9,2616,52,30,22
17,9,2912,35,18,17
17,9,2122,32,19,13
17,9,300,7,4,3
17,9,3314,14,6,8
17,9,3351,35,18,17
17,9,2730,65,36,29
17,9,2452,69,27,42
17,9,1813,24,15,9
17,9,1454,40,24,16
17,9,1451,36,20,16
17,10,2061,21,11,10
17,10,1565,15,11,4
17,10,1597,30,17,13
17,10,3300,17,10,7
17,10,2436,22,11,11
17,10,2387,8,3,5
17,10,2906,16,11,5
17,10,2341,41,18,23
17,11,1970,14,5,9
17,11,1879,16,6,10
17,11,2232,48,18,30
17,11,2980,32,20,12
17,11,2686,44,22,22
17,11,3977,151,91,60
17,11,2965,87,42,45
17,11,3213,11,5,6
17,11,2063,18,12,6
17,11,579,13,9,4
17,11,1140,14,6,8
17,11,942,13,9,4
17,11,1029,4,1,3
17,11,1670,30,13,17
17,11,3295,43,25,18
17,11,896,5,4,1
17,11,739,3,3,0
17,11,3626,29,18,11
17,11,6337,45,22,23
17,11,3242,77,41,36
17,11,1008,16,6,10
17,11,877,14,8,6
17,11,5048,46,18,28
17,11,3688,337,171,166
17,11,7142,427,215,212
17,11,4323,74,34,40
17,11,3051,62,36,26
17,11,1876,40,16,24
17,11,1711,76,38,38
17,11,1013,12,7,5
17,11,1333,13,8,5
17,11,1215,15,4,11
17,11,1602,45,26,19
17,11,3630,22,15,7
17,11,1063,8,4,4
17,11,1187,13,10,3
17,11,7410,114,50,64
17,11,1315,35,17,18
17,11,4094,278,143,135
17,11,3142,27,11,16
17,11,4254,67,33,34
17,11,2727,80,44,36
17,11,1674,25,10,15
17,11,1312,6,3,3
17,11,2428,30,17,13
17,11,7780,102,52,50
17,11,1217,1,1,0
17,11,1655,53,24,29
17,11,1261,62,43,19
17,11,6392,102,45,57
17,11,2638,44,22,22
17,11,3378,42,20,22
17,11,2836,296,161,135
17,11,5402,244,121,123
17,11,9737,230,117,113
17,11,7591,116,55,61
17,11,5527,26,14,12
17,11,6697,55,23,32
17,11,1750,15,8,7
17,11,1913,34,19,15
17,11,1963,53,28,25
17,11,2773,49,21,28
17,11,1320,17,10,7
17,11,2128,41,22,19
17,11,4357,42,21,21
17,11,6801,74,43,31
17,11,2816,3,3,0
17,11,1816,23,14,9
17,11,844,4,2,2
17,12,3011,24,12,12
17,12,1493,3,2,1
17,12,143,4,2,2
17,12,3127,47,22,25
17,12,1306,7,3,4
17,12,392,2,1,1
17,12,519,14,7,7
17,12,1090,17,8,9
17,12,16,0,0,0
17,12,2107,7,5,2
17,12,1030,2,1,1
17,12,472,1,0,1
17,12,1658,3,1,2
17,12,525,8,5,3
17,12,921,20,6,14
17,12,2203,33,16,17
17,12,308,1,1,0
17,12,1278,6,4,2
17,12,1995,1,0,1
17,12,1632,64,27,37
17,12,2693,25,11,14
17,12,752,4,2,2
17,12,824,8,4,4
17,12,980,0,0,0
17,12,6724,58,26,32
17,12,1971,2,1,1
17,12,1389,5,4,1
17,12,1441,11,5,6
17,12,3089,2,2,0
17,12,2894,45,24,21
17,12,2372,14,9,5
17,12,1488,28,11,17
17,12,2270,14,8,6
17,12,1520,1,1,0
17,12,2218,6,2,4
17,12,1492,3,2,1
17,13,1214,3,2,1
17,13,2247,25,14,11
17,13,1006,3,1,2
17,13,1476,29,15,14
17,13,1638,17,8,9
17,13,1547,42,19,23
17,13,518,0,0,0
17,13,2386,27,11,16
17,13,1220,4,2,2
17,13,1190,11,5,6
17,13,1987,1,1,0
17,14,1943,58,33,25
17,14,1022,9,5,4
17,14,902,34,18,16
17,14,1706,3,3,0
17,14,1585,64,34,30
17,14,1305,4,0,4
17,14,1277,9,5,4
17,15,1748,62,34,28
17,15,1430,50,26,24
17,15,2790,149,77,72
17,15,1854,142,67,75
17,15,1194,15,10,5
17,15,3012,27,13,14
17,15,1248,2,1,1
17,15,1480,42,26,16
17,15,1157,18,7,11
17,34,2715,15,7,8
17,34,3527,5,2,3
17,34,548,1,0,1
17,34,2076,4,3,1
17,34,2580,29,16,13
17,16,2888,22,12,10
17,16,1149,1,0,1
17,16,1822,5,4,1
17,16,2081,2,0,2
17,16,1550,29,14,15
17,16,1233,13,7,6
17,16,2310,35,18,17
17,16,2048,18,9,9
17,16,1157,1,1,0
17,16,3067,13,6,7
17,17,2247,25,14,11
17,17,2783,24,15,9
17,17,1468,6,4,2
17,17,1316,52,29,23
17,17,1215,17,7,10
17,17,1632,16,8,8
17,17,4388,125,67,58
17,17,1967,80,44,36
17,17,1317,59,31,28
17,17,608,9,4,5
17,17,776,34,20,14
17,17,1369,69,41,28
17,17,1515,21,15,6
17,17,1648,67,29,38
17,17,1722,19,11,8
17,35,4491,25,15,10
17,35,2777,24,10,14
17,35,3463,166,84,82
17,35,2749,19,11,8
17,35,5165,19,8,11
17,35,5665,34,16,18
17,35,3614,18,7,11
17,17,2503,325,183,142
17,17,2095,39,17,22
17,17,295,0,0,0
17,17,727,2,2,0
17,17,2250,18,7,11
17,17,1335,280,148,132
17,17,1707,121,59,62
17,17,1058,19,7,12
17,17,1389,13,6,7
17,17,646,1,0,1
17,18,3129,8,3,5
17,7,1854,21,15,6
17,18,2151,76,45,31
17,18,1024,72,36,36
17,18,1943,10,6,4
17,18,13781,360,168,192
17,18,2587,12,9,3
17,18,4092,71,35,36
17,18,2316,17,8,9
17,18,4103,113,57,56
17,18,1823,38,17,21
17,18,2440,37,17,20
17,18,4689,134,69,65
17,18,2538,92,52,40
17,18,1730,8,3,5
17,18,1877,53,25,28
17,18,1259,11,6,5
17,18,1310,33,16,17
17,18,3391,51,24,27
17,18,2309,84,39,45
17,18,1796,73,40,33
17,18,2167,51,24,27
17,18,2200,184,98,86
17,18,4916,226,115,111
17,18,2651,34,21,13
17,18,2066,27,15,12
17,18,1634,3,1,2
17,18,2633,55,33,22
17,18,2141,13,4,9
17,18,1344,37,16,21
17,18,1489,23,14,9
17,18,1846,5,3,2
17,18,863,0,0,0
17,18,4532,33,20,13
17,18,2268,30,16,14
17,18,2383,33,18,15
17,18,3716,19,6,13
17,18,1533,15,9,6
17,18,2772,59,30,29
17,18,970,184,101,83
17,18,4102,63,33,30
17,18,4032,11,3,8
17,19,3180,52,31,21
17,19,1985,36,17,19
17,19,1920,4,2,2
17,19,2918,26,15,11
17,19,1779,43,24,19
17,19,521,0,0,0
17,19,1934,26,13,13
17,19,1721,14,9,5
17,19,1865,4,1,3
17,19,2580,27,12,15
17,19,491,0,0,0
17,19,1437,33,14,19
17,19,131,0,0,0
17,19,2067,10,4,6
17,19,1495,3,2,1
17,19,1988,14,7,7
17,20,2399,28,14,14
17,20,1762,32,15,17
17,20,943,12,5,7
17,20,1607,49,22,27
17,20,1280,8,5,3
17,20,2654,28,15,13
17,20,1640,17,8,9
17,20,2114,56,31,25
17,20,2409,20,7,13
17,20,2093,6,3,3
17,20,2252,93,49,44
17,20,1924,5,3,2
17,20,17950,276,125,151
17,20,2446,2,0,2
17,20,1706,21,8,13
17,20,1983,30,14,16
17,20,4682,156,93,63
17,20,1377,1,1,0
17,20,1316,5,3,2
17,21,2080,1,0,1
17,21,1501,2,1,1
17,21,1455,4,2,2
17,21,1292,3,2,1
17,21,772,26,17,9
17,21,334,4,3,1
17,22,4511,27,11,16
17,22,3236,32,13,19
17,22,5091,25,15,10
17,22,1965,22,10,12
17,22,2130,3,2,1
17,22,1719,3,1,2
17,22,2127,7,5,2
17,22,1849,15,5,10
17,23,2609,7,3,4
17,23,2576,10,7,3
17,23,1740,23,13,10
17,23,1018,0,0,0
17,24,2334,46,31,15
17,24,3505,47,24,23
17,24,1561,22,7,15
17,24,3896,23,10,13
17,24,1305,19,10,9
17,24,896,8,3,5
17,24,1335,9,3,6
17,24,2004,28,12,16
17,24,966,15,6,9
17,24,1504,23,13,10
17,24,1944,11,6,5
17,24,1028,15,11,4
17,24,987,2,1,1
17,24,804,3,3,0
17,24,961,0,0,0
17,24,1673,4,0,4
17,24,2472,19,9,10
17,24,3518,18,8,10
17,24,2523,15,11,4
17,24,1033,6,4,2
17,24,3001,19,5,14
17,24,1641,23,13,10
17,24,776,9,4,5
17,24,1741,2,1,1
17,24,4891,21,11,10
17,24,1335,6,2,4
17,24,589,0,0,0
17,25,2713,5,2,3
17,25,1897,5,3,2
17,25,1268,10,5,5
17,25,3478,17,8,9
17,25,2032,15,6,9
17,25,2193,4,3,1
17,25,2687,22,13,9
17,25,1976,6,3,3
17,25,1406,9,4,5
17,25,2839,11,5,6
17,25,915,61,33,28
17,25,1763,17,10,7
17,25,863,1,1,0
17,25,486,2,0,2
17,25,780,3,1,2
17,25,1088,32,14,18
17,25,619,2,0,2
17,25,488,3,1,2
17,25,378,4,4,0
17,25,478,1,1,0
17,25,273,8,1,7
17,25,324,0,0,0
17,25,860,32,14,18
17,25,317,1,1,0
17,25,105,1,1,0
17,25,169,1,1,0
17,26,1691,17,9,8
17,26,3354,56,27,29
17,26,2214,41,16,25
17,26,1522,19,10,9
17,26,1674,20,10,10
17,26,1091,0,0,0
17,26,2577,18,7,11
17,26,2368,49,23,26
17,26,3466,30,14,16
17,27,3441,27,15,12
17,27,2220,10,5,5
17,27,2983,23,15,8
17,27,402,0,0,0
17,27,2664,45,21,24
17,27,647,0,0,0
17,27,375,2,1,1
17,28,2696,53,31,22
17,28,6664,111,58,53
17,28,3807,115,58,57
17,28,1720,98,50,48
17,28,1955,43,19,24
17,28,2260,13,4,9
17,28,1044,39,18,21
17,28,4874,305,155,150
17,28,1116,152,83,69
17,28,2656,13,7,6
17,28,3290,12,5,7
17,28,1804,1,1,0
17,28,1568,42,23,19
17,28,1717,36,22,14
17,28,5642,299,164,135
17,28,2920,24,16,8
17,28,1255,19,11,8
17,28,7560,92,38,54
17,28,1356,11,4,7
17,28,4432,154,77,77
17,28,4182,276,138,138
17,28,2930,47,24,23
17,29,4906,117,53,64
17,29,2520,70,35,35
17,29,2668,71,35,36
17,29,3457,56,33,23
17,29,1771,200,109,91
17,29,1856,9,4,5
17,29,1524,34,19,15
17,29,1117,20,13,7
17,29,943,54,31,23
17,29,1097,42,17,25
17,29,735,6,5,1
17,29,1985,60,31,29
17,29,4765,39,23,16
17,29,2037,61,24,37
17,29,1634,1,1,0
17,29,685,7,3,4
17,29,1457,125,52,73
17,29,2044,41,20,21
17,29,8781,125,60,65
17,29,3901,288,137,151
17,29,1134,12,10,2
17,29,1338,3,1,2
17,29,901,3,2,1
17,29,2828,49,25,24
17,29,1776,40,19,21
17,29,1699,38,23,15
17,29,1497,40,20,20
17,29,2123,11,4,7
17,29,1458,6,3,3
17,29,1625,35,19,16
17,29,1082,35,18,17
17,29,1515,52,29,23
17,29,2956,159,84,75
17,29,339,20,8,12
17,29,1361,16,7,9
17,29,2417,76,40,36
17,29,1047,14,4,10
17,29,1797,70,34,36
17,29,2475,46,14,32
17,29,1409,10,5,5
17,29,2122,5,2,3
17,29,1213,36,18,18
17,29,742,21,12,9
17,29,1360,136,64,72
17,29,2037,13,4,9
17,29,1466,10,6,4
17,29,1168,5,3,2
17,29,1756,46,25,21
17,29,2423,498,258,240
17,29,918,4,2,2
17,30,4750,48,20,28
17,30,2094,22,12,10
17,30,5891,40,19,21
17,30,2786,34,21,13
17,30,2685,7,6,1
17,30,3559,39,20,19
17,30,2546,8,4,4
17,30,2568,11,8,3
17,30,2918,25,7,18
17,30,5033,8,2,6
17,30,2402,212,115,97
17,30,2260,66,32,34
17,30,2850,12,6,6
17,30,3706,23,11,12
17,30,4769,22,8,14
17,30,1506,10,5,5
17,30,1195,5,1,4
17,30,1892,19,8,11
17,30,638,5,2,3
17,31,1995,17,9,8
17,31,3210,36,18,18
17,31,1753,20,8,12
17,31,226,0,0,0
17,31,2113,18,10,8
17,31,1830,23,13,10
17,31,1031,2,0,2
17,31,1147,40,22,18
17,31,303,1,1,0
17,31,348,7,2,5
17,31,1468,18,5,13
17,31,854,67,35,32
17,31,1144,12,7,5
17,31,1325,80,48,32
17,31,993,66,33,33
17,31,1808,2,1,1
17,31,1795,77,38,39
17,31,501,7,4,3
17,31,1799,40,21,19
17,31,2507,17,11,6
17,31,947,12,7,5
17,31,2158,18,9,9
17,31,1762,53,28,25
17,31,1225,8,2,6
17,31,1851,11,9,2
17,31,1632,8,5,3
17,32,1335,6,2,4
17,32,1443,5,2,3
17,32,1048,3,2,1
17,32,1500,8,5,3
17,32,1927,3,2,1
17,32,2511,13,6,7
17,33,2975,70,31,39
17,33,3818,6,3,3
17,33,979,11,8,3
17,33,1822,36,17,19
17,33,2843,4,3,1
17,33,4504,24,18,6
17,7,1147,43,26,17
17,35,32,0,0,0
17,7,5772,155,80,75
17,7,1066,10,7,3
17,11,3949,50,26,24
17,11,3437,56,25,31
17,11,3638,78,43,35
17,28,3124,113,60,53
17,28,3681,64,30,34
17,18,2321,13,7,6
17,18,4464,26,10,16
17,29,3023,36,20,16
17,29,2038,48,22,26
18,1,738,0,0,0
18,1,1683,5,1,4
18,1,3796,10,4,6
18,1,879,1,0,1
18,1,1401,4,3,1
18,1,568,0,0,0
18,1,668,1,0,1
18,1,1125,2,0,2
18,1,2143,4,0,4
18,1,1282,3,2,1
18,1,333,0,0,0
18,1,763,1,1,0
18,1,759,1,0,1
18,1,266,1,1,0
18,1,516,0,0,0
18,1,1526,6,2,4
18,1,1120,1,0,1
18,1,1360,2,1,1
18,1,133,0,0,0
18,1,324,1,0,1
18,1,476,0,0,0
18,1,245,0,0,0
18,1,735,0,0,0
18,1,1356,4,1,3
18,1,129,1,0,1
18,1,369,1,0,1
18,1,878,2,1,1
18,1,433,0,0,0
18,1,200,0,0,0
18,1,288,0,0,0
18,1,316,0,0,0
18,1,401,4,1,3
18,1,1004,0,0,0
18,1,511,1,0,1
18,1,172,2,0,2
18,1,861,4,4,0
18,1,337,0,0,0
18,1,1253,10,2,8
18,1,1065,6,5,1
18,1,945,0,0,0
18,1,425,1,0,1
18,1,921,0,0,0
18,1,203,0,0,0
18,1,240,0,0,0
18,1,983,0,0,0
18,1,663,1,0,1
18,1,423,0,0,0
18,2,979,7,4,3
18,2,1244,3,1,2
18,2,837,2,1,1
18,2,1715,7,4,3
18,2,1188,9,6,3
18,2,1313,2,1,1
18,2,354,1,1,0
18,2,704,0,0,0
18,2,1004,9,4,5
18,2,656,13,5,8
18,2,1665,0,0,0
18,2,779,5,2,3
18,2,1170,5,1,4
18,2,309,3,3,0
18,2,535,0,0,0
18,2,221,0,0,0
18,2,739,0,0,0
18,3,659,0,0,0
18,3,1056,5,2,3
18,3,860,7,4,3
18,3,516,1,1,0
18,3,241,0,0,0
18,3,205,0,0,0
18,3,97,0,0,0
18,3,533,0,0,0
18,3,746,2,1,1
18,3,125,0,0,0
18,3,605,1,0,1
18,3,823,0,0,0
18,3,1075,10,1,9
18,3,582,16,11,5
18,3,247,0,0,0
18,3,649,4,3,1
18,3,782,1,1,0
18,3,176,14,6,8
18,3,472,0,0,0
18,3,94,21,11,10
18,3,516,0,0,0
18,3,456,0,0,0
18,4,1195,36,17,19
18,4,994,52,24,28
18,4,192,0,0,0
18,4,668,3,1,2
18,4,637,1,1,0
18,4,1756,64,29,35
18,4,1499,1,0,1
18,4,6043,121,50,71
18,4,1224,5,1,4
18,4,2053,3,1,2
18,4,1921,3,1,2
18,4,1753,4,3,1
18,4,1350,0,0,0
18,4,2764,9,6,3
18,4,2095,11,9,2
18,4,2470,63,30,33
18,4,3160,7,5,2
18,4,2080,51,24,27
18,4,1791,36,13,23
18,4,2936,30,13,17
18,4,8143,61,26,35
18,4,7941,66,28,38
18,4,1724,30,13,17
18,4,4133,42,19,23
18,4,17535,227,109,118
18,4,12754,218,113,105
18,4,5270,17,7,10
18,4,32686,352,153,199
18,4,6121,48,17,31
18,4,6187,34,14,20
18,4,2491,15,10,5
18,4,5151,52,24,28
18,4,3124,30,14,16
18,5,1450,24,15,9
18,5,1412,12,6,6
18,5,2796,22,8,14
18,5,667,9,5,4
18,5,940,3,2,1
18,5,816,1,1,0
18,5,820,21,9,12
18,5,649,2,0,2
18,5,2510,6,4,2
18,5,2452,4,3,1
18,5,951,0,0,0
18,5,1035,1,1,0
18,5,666,0,0,0
18,5,2024,2,2,0
18,5,1280,0,0,0
18,5,855,0,0,0
18,5,508,0,0,0
18,5,869,3,0,3
18,5,121,1,1,0
18,5,386,6,4,2
18,5,846,2,1,1
18,5,940,1,0,1
18,5,238,1,1,0
18,5,554,1,0,1
18,5,807,1,0,1
18,5,623,1,1,0
18,5,688,2,1,1
18,5,1667,15,7,8
18,5,1318,7,4,3
18,5,293,0,0,0
18,5,463,1,0,1
18,5,617,0,0,0
18,5,495,0,0,0
18,5,1076,7,5,2
18,5,1431,28,14,14
18,5,1432,21,9,12
18,5,908,8,5,3
18,5,1368,4,2,2
18,5,850,1,0,1
18,5,1357,3,2,1
18,5,979,2,2,0
18,5,759,0,0,0
18,5,1270,4,2,2
18,5,1607,21,10,11
18,5,1587,4,2,2
18,5,963,7,3,4
18,5,388,1,0,1
18,5,1180,1,1,0
18,5,136,1,0,1
18,5,1032,1,0,1
18,5,135,0,0,0
18,5,526,1,0,1
18,5,583,2,1,1
18,5,1105,1,0,1
18,5,435,1,0,1
18,5,772,6,2,4
18,5,931,7,4,3
18,5,377,1,0,1
18,5,242,0,0,0
18,5,4447,29,10,19
18,5,2867,19,9,10
18,5,2424,14,7,7
18,5,750,7,3,4
18,5,800,21,13,8
18,5,1392,16,11,5
18,5,1458,11,6,5
18,5,3501,40,18,22
18,5,235,5,2,3
18,5,1831,15,7,8
18,5,404,0,0,0
18,5,540,6,4,2
18,5,744,24,10,14
18,6,2215,1,1,0
18,6,1874,2,1,1
18,6,450,0,0,0
18,6,385,0,0,0
18,6,546,0,0,0
18,6,357,0,0,0
18,6,1282,5,3,2
18,6,1138,3,2,1
18,6,297,0,0,0
18,6,265,0,0,0
18,6,326,0,0,0
18,6,167,0,0,0
18,6,528,3,1,2
18,6,296,0,0,0
18,6,561,0,0,0
18,6,435,0,0,0
18,6,282,0,0,0
18,6,411,0,0,0
18,6,416,0,0,0
18,7,2759,0,0,0
18,7,3159,13,5,8
18,7,1749,17,9,8
18,7,2978,6,2,4
18,7,1551,11,7,4
18,7,1420,5,5,0
18,7,727,2,0,2
18,7,738,2,0,2
18,7,1365,26,13,13
18,7,1654,7,3,4
18,7,857,1,0,1
18,7,742,1,1,0
18,7,724,0,0,0
18,7,630,0,0,0
18,7,934,0,0,0
18,7,2580,5,3,2
18,7,1021,0,0,0
18,7,705,0,0,0
18,7,448,0,0,0
18,7,299,0,0,0
18,7,351,2,2,0
18,7,1257,13,7,6
18,7,201,1,1,0
18,7,470,1,1,0
18,8,569,11,7,4
18,8,623,4,0,4
18,8,1142,1,0,1
18,8,1538,4,1,3
18,8,692,10,7,3
18,8,1311,13,5,8
18,8,177,0,0,0
18,8,634,8,4,4
18,8,429,5,1,4
18,8,2230,2,2,0
18,8,1504,25,5,20
18,8,1130,0,0,0
18,8,912,0,0,0
18,8,2136,1,0,1
18,8,1702,3,1,2
18,8,1013,0,0,0
18,8,532,1,1,0
18,8,1044,0,0,0
18,9,3039,14,6,8
18,9,3065,21,9,12
18,9,1933,6,5,1
18,9,860,0,0,0
18,9,2207,2,1,1
18,9,230,0,0,0
18,9,681,0,0,0
18,9,1015,4,2,2
18,9,1058,2,0,2
18,9,6981,12,5,7
18,9,3178,9,5,4
18,9,2906,8,4,4
18,9,4172,9,7,2
18,9,1727,5,4,1
18,9,913,2,2,0
18,9,1432,64,32,32
18,9,1342,3,0,3
18,9,1336,14,8,6
18,9,1972,486,234,252
18,10,1351,1,1,0
18,10,723,0,0,0
18,10,216,2,1,1
18,10,342,0,0,0
18,10,1003,2,1,1
18,10,697,3,2,1
18,10,869,1,1,0
18,10,234,0,0,0
18,10,683,1,1,0
18,10,1113,3,1,2
18,10,635,2,2,0
18,10,1010,2,1,1
18,10,970,0,0,0
18,10,912,0,0,0
18,10,1549,0,0,0
18,10,613,0,0,0
18,10,287,0,0,0
18,10,891,4,3,1
18,10,358,1,1,0
18,10,734,1,0,1
18,10,533,1,0,1
18,10,587,7,4,3
18,10,617,0,0,0
18,10,604,1,0,1
18,10,1283,1,1,0
18,10,1007,1,1,0
18,10,422,19,9,10
18,10,636,5,3,2
18,10,497,18,10,8
18,10,1009,15,9,6
18,10,591,7,2,5
18,10,562,1,1,0
18,10,815,4,1,3
18,10,1716,6,2,4
18,10,2024,3,1,2
18,10,742,1,0,1
18,10,538,0,0,0
18,10,693,1,1,0
18,10,933,3,2,1
18,10,634,0,0,0
18,10,791,9,5,4
18,10,746,6,3,3
18,10,457,0,0,0
18,11,2389,9,3,6
18,11,1038,0,0,0
18,11,1363,1,0,1
18,11,2325,0,0,0
18,11,710,1,0,1
18,11,429,1,0,1
18,11,781,1,1,0
18,11,1585,1,0,1
18,11,1559,4,2,2
18,11,729,0,0,0
18,11,417,1,1,0
18,11,1218,3,1,2
18,11,23,0,0,0
18,11,1658,0,0,0
18,11,243,0,0,0
18,11,205,0,0,0
18,11,481,5,5,0
18,11,686,0,0,0
18,11,602,0,0,0
18,11,179,0,0,0
18,11,449,4,3,1
18,11,974,2,1,1
18,11,343,0,0,0
18,11,1056,5,2,3
18,11,700,2,0,2
18,11,442,0,0,0
18,11,818,2,1,1
18,12,2261,16,9,7
18,12,2590,24,15,9
18,12,1247,15,9,6
18,12,1089,3,1,2
18,12,1071,0,0,0
18,12,2677,9,5,4
18,12,517,0,0,0
18,12,340,1,1,0
18,12,351,0,0,0
18,12,881,16,5,11
18,12,766,0,0,0
18,12,1036,2,1,1
18,12,583,0,0,0
18,12,927,1,1,0
18,12,1362,7,4,3
18,12,317,0,0,0
18,12,163,2,1,1
18,12,578,1,0,1
18,12,696,10,6,4
18,12,1465,0,0,0
18,12,508,9,4,5
18,12,549,0,0,0
18,12,597,0,0,0
18,12,391,2,0,2
18,12,536,4,3,1
18,12,233,0,0,0
18,12,185,2,2,0
18,12,1656,1,1,0
18,12,139,0,0,0
18,12,350,2,0,2
18,12,207,1,1,0
18,12,210,0,0,0
18,12,1598,10,4,6
18,12,1253,2,0,2
18,12,450,0,0,0
18,12,1222,4,2,2
18,12,1924,2,2,0
18,12,1248,2,2,0
18,12,509,1,0,1
18,12,1151,4,3,1
18,12,1483,1,0,1
18,12,399,2,0,2
18,12,990,8,5,3
18,12,775,0,0,0
18,12,392,1,1,0
18,12,1277,3,2,1
18,12,375,0,0,0
18,13,1040,0,0,0
18,13,888,2,1,1
18,13,800,5,3,2
18,13,1310,23,13,10
18,13,220,0,0,0
18,13,309,0,0,0
18,13,333,0,0,0
18,13,210,0,0,0
18,13,670,1,0,1
18,13,311,9,6,3
18,13,479,2,1,1
18,13,338,0,0,0
18,13,768,1,0,1
18,14,2721,5,3,2
18,14,2790,3,1,2
18,14,456,2,1,1
18,14,568,1,0,1
18,14,1388,3,2,1
18,14,1995,10,5,5
18,14,254,0,0,0
18,14,602,0,0,0
18,14,809,12,8,4
18,14,508,0,0,0
18,14,2527,4,2,2
18,14,812,1,0,1
18,14,850,1,0,1
18,14,683,3,0,3
18,14,1023,5,2,3
18,14,394,2,0,2
18,14,1077,0,0,0
18,14,144,0,0,0
18,14,1470,1,1,0
18,14,640,1,1,0
18,14,732,0,0,0
18,14,180,0,0,0
18,14,2290,2,1,1
18,15,1260,32,18,14
18,15,1380,25,12,13
18,15,2337,39,19,20
18,15,1238,11,7,4
18,15,582,0,0,0
18,15,648,0,0,0
18,15,1476,16,10,6
18,15,2030,2,2,0
18,15,620,3,3,0
18,15,447,2,0,2
18,15,361,3,2,1
18,15,426,1,0,1
18,15,331,1,1,0
18,15,995,8,2,6
18,15,229,0,0,0
18,15,568,1,0,1
18,15,1445,5,3,2
18,15,384,1,1,0
18,15,201,0,0,0
18,15,190,1,1,0
18,15,455,0,0,0
18,15,423,1,1,0
18,15,1043,2,1,1
18,15,947,6,2,4
18,15,1238,4,2,2
18,15,1449,1,1,0
18,15,758,16,7,9
18,15,156,1,1,0
18,15,810,2,0,2
18,15,129,4,2,2
18,15,965,1,0,1
18,15,757,1,0,1
18,15,415,0,0,0
18,15,710,0,0,0
18,15,760,2,1,1
18,15,1082,9,6,3
18,15,680,24,12,12
18,15,961,13,7,6
18,15,728,1,1,0
18,15,1030,2,0,2
18,15,756,6,2,4
18,15,541,0,0,0
18,15,414,0,0,0
18,15,552,0,0,0
18,15,526,1,0,1
18,15,235,0,0,0
18,15,1592,0,0,0
18,15,1551,1,0,1
18,15,1217,2,1,1
18,15,1052,1,1,0
18,15,489,0,0,0
18,15,1572,13,5,8
18,15,845,1,1,0
18,15,1353,1,1,0
18,15,933,1,1,0
18,15,687,1,0,1
18,15,365,3,2,1
18,15,1091,6,4,2
18,15,565,9,3,6
18,15,768,8,3,5
18,15,609,0,0,0
18,15,1314,2,0,2
18,15,902,0,0,0
18,15,364,0,0,0
18,15,499,2,1,1
18,15,668,2,2,0
18,15,1085,16,10,6
18,15,1424,0,0,0
18,15,927,3,0,3
18,15,1371,19,8,11
18,15,523,0,0,0
18,15,824,1,1,0
18,15,2148,143,53,90
18,15,524,10,7,3
18,15,488,0,0,0
18,15,1407,61,26,35
18,15,1090,1,1,0
18,15,752,10,6,4
18,15,299,0,0,0
18,15,755,59,35,24
18,15,726,624,304,320
18,15,660,370,173,197
18,15,226,6,3,3
18,15,609,1,0,1
18,15,827,2,0,2
18,15,635,0,0,0
18,15,940,3,3,0
18,15,1149,1,0,1
18,15,764,0,0,0
18,15,453,0,0,0
18,15,1093,6,2,4
18,15,904,3,2,1
18,15,1306,33,21,12
18,15,537,1,1,0
18,15,647,0,0,0
18,15,1050,1,0,1
18,15,1260,6,3,3
18,15,180,2,0,2
18,15,607,1,0,1
18,15,582,2,1,1
18,15,543,1,0,1
18,15,881,2,1,1
18,15,794,1,0,1
18,15,714,0,0,0
18,15,1040,0,0,0
18,15,969,0,0,0
18,15,1280,2,2,0
18,15,1476,1,1,0
18,15,542,0,0,0
18,15,1537,1,0,1
18,15,1256,1,0,1
18,16,818,42,22,20
18,16,1052,1,0,1
18,16,686,3,2,1
18,16,2338,4,0,4
18,16,931,1,0,1
18,16,788,0,0,0
18,16,742,15,6,9
18,16,765,7,4,3
18,16,629,0,0,0
18,16,334,1,1,0
18,16,321,2,0,2
18,16,434,0,0,0
18,16,541,1,1,0
18,16,457,3,2,1
18,16,539,0,0,0
18,16,873,4,1,3
18,16,868,3,1,2
18,16,1072,2,0,2
18,16,220,0,0,0
18,16,230,0,0,0
18,16,910,12,5,7
18,16,772,0,0,0
18,16,408,0,0,0
18,16,1221,10,7,3
18,16,1165,4,1,3
18,16,788,0,0,0
18,16,942,2,1,1
18,16,694,0,0,0
18,16,957,1,0,1
18,16,930,4,3,1
18,16,601,3,1,2
18,16,985,13,9,4
18,16,757,0,0,0
18,16,932,0,0,0
18,16,657,10,5,5
18,16,1266,0,0,0
18,16,941,18,8,10
18,16,741,4,2,2
18,16,639,0,0,0
18,16,763,0,0,0
18,16,880,2,0,2
18,16,1110,3,1,2
18,16,292,0,0,0
18,16,118,0,0,0
18,16,859,1,0,1
18,16,361,0,0,0
18,16,418,0,0,0
18,16,423,0,0,0
18,16,623,0,0,0
18,16,361,0,0,0
18,17,1584,6,1,5
18,17,5042,7,2,5
18,17,772,5,2,3
18,17,1360,1,1,0
18,17,3251,9,2,7
18,17,1540,14,5,9
18,17,1418,11,5,6
18,17,1884,26,15,11
18,17,1368,9,5,4
18,17,1532,10,5,5
18,17,7216,98,52,46
18,17,1796,7,5,2
18,17,2183,7,5,2
18,17,2631,11,6,5
18,17,829,3,3,0
18,17,939,2,1,1
18,17,1174,2,1,1
18,17,1170,4,2,2
18,17,582,3,2,1
18,17,1037,32,13,19
18,17,795,12,6,6
18,17,1268,10,6,4
18,17,814,25,12,13
18,17,1601,1,0,1
18,17,981,24,11,13
18,17,664,1,0,1
18,17,1711,7,3,4
18,17,1292,1,0,1
18,17,1046,11,3,8
18,17,1257,0,0,0
18,17,2031,29,16,13
18,17,2142,18,12,6
18,17,1698,1,0,1
18,17,2159,17,11,6
18,17,665,1,1,0
18,17,867,2,0,2
18,17,604,3,0,3
18,17,767,7,2,5
18,17,976,2,1,1
18,17,559,4,2,2
18,17,942,2,2,0
18,17,1002,21,11,10
18,17,823,4,1,3
18,17,895,1,1,0
18,17,1023,15,6,9
18,17,433,0,0,0
18,17,621,11,6,5
18,17,478,5,3,2
18,17,701,15,9,6
18,17,1244,11,7,4
18,17,688,33,16,17
18,17,505,11,5,6
18,17,615,9,8,1
18,17,767,10,6,4
18,17,867,0,0,0
18,17,636,5,3,2
18,17,818,1,0,1
18,17,572,0,0,0
18,17,809,2,0,2
18,17,2104,18,6,12
18,17,942,4,1,3
18,17,2386,8,2,6
18,17,2880,59,29,30
18,17,878,7,6,1
18,17,739,2,2,0
18,17,733,3,3,0
18,17,585,2,0,2
18,17,455,0,0,0
18,17,632,1,0,1
18,17,248,0,0,0
18,17,59,0,0,0
18,17,372,8,4,4
18,17,345,1,0,1
18,17,217,0,0,0
18,17,1510,30,12,18
18,17,843,0,0,0
18,17,3018,28,15,13
18,17,2729,4,1,3
18,17,1904,22,8,14
18,17,746,3,3,0
18,17,169,0,0,0
18,17,197,1,1,0
18,17,143,0,0,0
18,17,295,6,2,4
18,17,215,0,0,0
18,17,587,1,1,0
18,17,531,2,1,1
18,17,381,2,2,0
18,17,309,6,4,2
18,17,430,21,9,12
18,17,681,31,19,12
18,17,2059,11,6,5
18,17,2442,9,4,5
18,17,5526,40,18,22
18,17,983,13,5,8
18,17,535,16,12,4
18,17,352,2,0,2
18,17,258,2,0,2
18,17,1022,7,3,4
18,17,2160,8,5,3
18,17,1198,4,1,3
18,17,554,2,1,1
18,17,281,0,0,0
18,17,632,7,3,4
18,17,725,1,1,0
18,17,579,4,2,2
18,17,635,1,1,0
18,17,1530,1,1,0
18,17,1757,20,7,13
18,17,1942,7,4,3
18,17,1423,5,4,1
18,17,520,1,0,1
18,17,1364,6,3,3
18,17,557,1,0,1
18,17,280,8,5,3
18,17,596,12,5,7
18,17,1742,2,2,0
18,17,926,2,1,1
18,17,792,6,2,4
18,17,763,13,9,4
18,17,1927,4,0,4
18,17,2215,12,7,5
18,17,1423,4,2,2
18,17,855,8,3,5
18,17,802,1,1,0
18,17,1034,8,3,5
18,17,651,2,1,1
18,17,914,11,6,5
18,17,1284,11,6,5
18,17,3920,31,15,16
18,17,3221,95,24,71
18,17,877,4,1,3
18,17,960,4,0,4
18,17,4333,78,40,38
18,17,2073,4,1,3
18,17,1703,5,2,3
18,17,1063,6,3,3
18,17,918,15,8,7
18,17,1018,0,0,0
18,17,887,14,8,6
18,17,2042,18,9,9
18,17,1262,6,5,1
18,17,1572,5,1,4
18,17,1415,4,2,2
18,17,1337,36,18,18
18,17,4896,18,14,4
18,17,559,25,14,11
18,17,1132,5,2,3
18,17,1377,3,1,2
18,17,1797,9,5,4
18,17,3632,14,7,7
18,17,1433,21,9,12
18,17,1541,2,1,1
18,17,1221,3,2,1
18,17,2062,22,11,11
18,17,1091,1,0,1
18,17,1041,0,0,0
18,17,2499,20,11,9
18,17,5568,9,3,6
18,17,3466,12,5,7
18,17,2092,22,14,8
18,17,569,0,0,0
18,17,124,0,0,0
18,17,1136,1,0,1
18,17,2380,10,4,6
18,17,496,0,0,0
18,17,1010,12,9,3
18,17,668,4,4,0
18,17,1919,1,0,1
18,17,342,0,0,0
18,17,156,5,2,3
18,17,1735,13,0,13
18,17,656,1,0,1
18,17,1797,15,9,6
18,17,2460,23,7,16
18,17,1716,14,9,5
18,17,1491,7,3,4
18,17,992,0,0,0
18,17,649,0,0,0
18,17,2334,4,2,2
18,17,687,3,1,2
18,17,500,0,0,0
18,17,1077,5,2,3
18,17,1250,2,0,2
18,17,379,4,2,2
18,17,187,0,0,0
18,17,1168,3,2,1
18,17,657,1,0,1
18,17,705,0,0,0
18,17,1164,2,1,1
18,17,1846,1,0,1
18,17,1430,12,7,5
18,17,875,0,0,0
18,17,27640,523,270,253
18,17,1280,7,3,4
18,17,1358,4,1,3
18,17,1286,0,0,0
18,17,1700,3,2,1
18,17,3882,32,16,16
18,17,1823,23,11,12
18,17,2285,6,4,2
18,17,2992,50,24,26
18,17,1103,5,1,4
18,17,1016,9,4,5
18,18,1049,7,4,3
18,18,696,10,4,6
18,18,887,7,3,4
18,18,551,3,2,1
18,18,651,1,0,1
18,18,1217,9,6,3
18,18,1662,14,6,8
18,18,326,3,1,2
18,18,312,1,1,0
18,18,527,0,0,0
18,18,433,1,0,1
18,18,644,2,2,0
18,18,1203,8,6,2
18,18,1419,11,4,7
18,18,1383,1,1,0
18,18,977,6,3,3
18,18,517,2,1,1
18,18,1420,10,4,6
18,18,393,2,0,2
18,18,369,5,4,1
18,18,615,2,2,0
18,18,1311,5,3,2
18,18,943,0,0,0
18,18,696,1,0,1
18,18,480,1,0,1
18,18,1379,9,6,3
18,18,1063,6,3,3
18,18,1103,9,4,5
18,18,1114,8,6,2
18,18,1104,2,0,2
18,18,754,1,0,1
18,18,799,1,0,1
18,18,1145,6,2,4
18,18,915,0,0,0
18,19,9065,92,52,40
18,19,6858,39,15,24
18,19,2369,8,4,4
18,19,14531,223,108,115
18,19,2457,11,5,6
18,19,794,2,1,1
18,19,3460,26,13,13
18,19,1350,6,2,4
18,19,1311,0,0,0
18,19,3243,2,0,2
18,19,1492,25,12,13
18,19,1284,15,10,5
18,19,1137,5,3,2
18,19,1660,7,1,6
18,19,1997,6,2,4
18,19,2855,10,5,5
18,19,707,0,0,0
18,19,1387,10,6,4
18,19,900,0,0,0
18,19,730,2,0,2
18,19,2454,4,1,3
18,19,1104,4,2,2
18,20,779,2,2,0
18,20,3392,26,14,12
18,20,2319,4,1,3
18,20,1861,5,3,2
18,20,1359,6,1,5
18,20,268,2,1,1
18,20,786,1,0,1
18,20,895,1,1,0
18,20,431,19,7,12
18,20,570,0,0,0
18,20,1075,16,8,8
18,17,2060,3,2,1
18,17,873,2,1,1
18,17,975,1,1,0
18,17,1920,9,3,6
18,17,1762,10,6,4
18,17,1574,10,5,5
18,17,981,12,5,7
18,17,1103,9,5,4
18,17,671,7,3,4
18,17,1000,2,1,1
18,17,795,0,0,0
18,17,1484,3,0,3
18,17,1474,10,8,2
18,17,1446,16,8,8
18,17,784,5,3,2
18,17,1054,0,0,0
18,17,1559,7,6,1
18,17,1752,25,13,12
18,17,1655,11,7,4
18,17,803,0,0,0
18,17,1517,6,2,4
18,17,838,2,0,2
18,17,1443,46,23,23
18,17,526,0,0,0
18,17,1213,13,4,9
18,17,3666,11,9,2
18,17,1733,53,25,28
18,17,1075,4,2,2
18,17,1083,1,1,0
18,17,1424,4,1,3
18,17,4431,12,6,6
18,17,1794,7,3,4
18,17,1212,3,0,3
18,17,720,2,1,1
18,17,865,0,0,0
18,17,1157,0,0,0
18,17,961,2,2,0
18,17,1396,20,9,11
18,17,1195,2,1,1
18,17,870,3,1,2
18,17,663,6,2,4
18,17,1274,4,4,0
18,17,532,1,1,0
18,17,729,2,1,1
18,17,1183,4,2,2
18,17,1257,6,1,5
18,17,1070,0,0,0
18,17,1591,17,7,10
18,17,1001,6,4,2
18,17,847,2,0,2
18,17,1392,0,0,0
18,17,1489,15,8,7
18,17,2109,19,7,12
18,17,1687,6,4,2
18,17,1600,6,2,4
18,17,1171,12,5,7
18,17,1003,4,1,3
18,17,1406,9,6,3
18,17,1391,11,5,6
18,17,791,16,10,6
18,17,1717,9,4,5
18,17,1279,21,12,9
18,17,1719,17,6,11
18,17,1631,25,12,13
18,17,714,16,6,10
18,17,819,48,27,21
18,17,2183,21,11,10
18,17,2137,78,42,36
18,17,938,1,0,1
18,17,1171,6,4,2
18,17,1285,36,17,19
18,17,1296,15,6,9
18,17,680,29,11,18
18,17,1468,4,0,4
18,17,1242,2,0,2
18,17,1212,58,33,25
18,17,1097,12,8,4
18,17,960,4,3,1
18,17,1360,6,1,5
18,17,1712,5,2,3
18,17,1302,2,1,1
18,17,1601,19,12,7
18,17,1865,13,5,8
18,17,1069,10,8,2
18,17,1763,11,6,5
18,17,1279,4,2,2
18,17,1633,1,1,0
18,17,525,28,18,10
18,17,2600,42,22,20
18,17,611,22,12,10
18,17,691,5,3,2
18,17,559,1,1,0
18,17,522,1,1,0
18,4,8664,173,76,97
18,4,831,41,18,23
18,4,1827,38,14,24
18,4,2834,27,9,18
18,4,1096,2,2,0
18,4,4653,47,22,25
18,4,4958,42,19,23
18,4,5266,35,16,19
18,4,829,14,8,6
18,4,4833,65,33,32
18,19,2368,33,13,20
18,19,1818,10,5,5
18,19,3,0,0,0
18,17,1995,2,1,1
18,17,3903,42,22,20
18,9,3349,1,1,0
18,9,1616,1,1,0
18,9,2711,1,1,0
18,9,544,4,2,2
19,1,1320,5,3,2
19,1,1663,2,1,1
19,2,784,2,0,2
19,2,516,0,0,0
19,2,605,2,0,2
19,2,367,0,0,0
19,2,150,0,0,0
19,2,285,0,0,0
19,2,206,0,0,0
19,2,343,1,0,1
19,2,157,0,0,0
19,3,309,0,0,0
19,3,375,0,0,0
19,3,164,0,0,0
19,3,289,0,0,0
19,3,230,0,0,0
19,3,37,0,0,0
19,4,8457,55,23,32
19,4,2728,9,4,5
19,4,1314,1,0,1
19,4,1271,0,0,0
19,4,588,1,0,1
19,4,1914,17,12,5
19,4,1647,83,40,43
19,4,657,0,0,0
19,4,3080,49,25,24
19,4,2928,13,6,7
19,4,1777,28,16,12
19,4,2290,2,2,0
19,4,2616,3,1,2
19,4,1355,8,3,5
19,4,613,4,1,3
19,4,350,4,3,1
19,4,323,2,1,1
19,4,707,3,1,2
19,4,838,7,4,3
19,5,18,0,0,0
19,5,432,0,0,0
19,5,379,1,0,1
19,5,3125,18,7,11
19,5,6540,81,43,38
19,5,367,2,0,2
19,5,887,19,10,9
19,5,1350,4,2,2
19,5,1372,8,6,2
19,5,1146,8,5,3
19,5,992,3,1,2
19,5,367,4,0,4
19,5,343,2,1,1
19,5,223,0,0,0
19,5,82,1,1,0
19,5,48,0,0,0
19,5,258,2,0,2
19,5,100,0,0,0
19,6,7975,64,29,35
19,6,11643,86,41,45
19,6,9022,39,18,21
19,6,5335,176,84,92
19,6,9722,61,22,39
19,6,1345,8,2,6
19,6,1122,1,0,1
19,6,3984,32,22,10
19,6,1543,4,1,3
19,6,1129,1,0,1
19,6,1518,18,10,8
19,6,1649,24,14,10
19,6,1794,3,2,1
19,6,1384,2,0,2
19,6,5902,55,26,29
19,6,1156,7,3,4
19,6,1036,8,3,5
19,6,12442,92,46,46
19,6,2229,10,6,4
19,6,3341,12,7,5
19,6,4785,30,15,15
19,6,5328,23,14,9
19,6,2269,17,7,10
19,6,1601,10,3,7
19,6,1373,11,5,6
19,6,1711,169,86,83
19,6,1532,1,0,1
19,6,1620,1,1,0
19,6,3544,272,133,139
19,6,1746,3,1,2
19,6,1480,1,0,1
19,6,1584,5,2,3
19,6,1859,111,56,55
19,6,2776,2,1,1
19,6,8221,37,21,16
19,6,18658,95,42,53
19,6,1622,66,32,34
19,6,2070,38,18,20
19,6,1888,24,16,8
19,6,1121,0,0,0
19,6,4926,47,23,24
19,6,27267,492,242,250
19,6,2514,26,12,14
19,6,3703,19,13,6
19,6,2109,10,3,7
19,6,1247,14,5,9
19,6,600,12,8,4
19,6,8338,90,46,44
19,6,1595,9,3,6
19,6,2260,8,2,6
19,6,2265,55,32,23
19,6,1754,9,4,5
19,6,1925,9,7,2
19,6,2723,10,7,3
19,6,2571,16,8,8
19,6,3867,103,57,46
19,6,3366,60,27,33
19,6,5959,46,17,29
19,6,2411,14,7,7
19,6,1443,5,3,2
19,6,1540,14,8,6
19,6,1467,5,2,3
19,6,12321,211,104,107
19,6,7647,40,13,27
19,6,5223,70,28,42
19,6,2482,38,17,21
19,6,1601,8,4,4
19,6,2092,13,8,5
19,6,1568,4,0,4
19,6,1461,4,3,1
19,6,1434,4,2,2
19,6,1720,16,10,6
19,6,1045,19,8,11
19,6,10329,61,23,38
19,6,12578,77,37,40
19,6,1621,9,4,5
19,6,9842,126,47,79
19,6,5144,107,51,56
19,6,2793,18,8,10
19,26,957,375,186,189
19,6,9008,63,30,33
19,6,12587,186,90,96
19,7,2333,0,0,0
19,7,1671,3,2,1
19,7,363,0,0,0
19,7,356,0,0,0
19,7,568,0,0,0
19,7,851,4,2,2
19,7,653,1,1,0
19,7,1144,1,1,0
19,7,324,0,0,0
19,7,980,0,0,0
19,7,1434,0,0,0
19,7,657,1,0,1
19,7,523,1,0,1
19,7,614,0,0,0
19,7,1037,2,0,2
19,7,867,4,2,2
19,7,494,0,0,0
19,8,741,8,3,5
19,8,700,8,3,5
19,8,658,44,22,22
19,8,1534,158,84,74
19,9,2675,26,12,14
19,9,1058,4,1,3
19,9,2925,4,2,2
19,9,2126,2,0,2
19,9,4110,4,2,2
19,9,1251,9,4,5
19,9,1269,4,3,1
19,9,1328,3,2,1
19,9,1184,10,5,5
19,9,1291,4,1,3
19,9,2040,42,14,28
19,9,1319,10,4,6
19,9,731,2,2,0
19,9,1073,5,0,5
19,9,1721,21,9,12
19,9,1209,2,1,1
19,9,2880,148,72,76
19,9,1863,7,4,3
19,9,725,7,5,2
19,9,1060,1,0,1
19,9,1041,5,4,1
19,9,256,18,6,12
19,9,2169,17,12,5
19,9,949,21,12,9
19,9,424,4,4,0
19,9,396,7,1,6
19,9,858,13,7,6
19,9,1115,15,7,8
19,9,425,2,0,2
19,9,738,29,21,8
19,9,560,4,1,3
19,9,1040,13,6,7
19,9,665,17,8,9
19,9,455,0,0,0
19,9,285,1,0,1
19,9,439,6,1,5
19,9,1061,17,4,13
19,9,585,24,13,11
19,9,816,3,0,3
19,9,630,4,1,3
19,9,719,9,6,3
19,9,226,3,1,2
19,9,701,4,1,3
19,9,1045,8,4,4
19,10,32592,193,93,100
19,10,3297,7,0,7
19,10,43356,455,203,252
19,11,1697,14,8,6
19,11,1508,41,14,27
19,11,993,3,1,2
19,11,803,6,4,2
19,11,911,6,3,3
19,11,1109,4,0,4
19,11,114,0,0,0
19,11,147,3,2,1
19,11,138,1,0,1
19,12,28129,979,470,509
19,12,1969,13,8,5
19,12,731,5,2,3
19,12,4967,50,26,24
19,13,736,6,4,2
19,13,528,2,1,1
19,13,697,1,0,1
19,13,845,2,2,0
19,13,635,0,0,0
19,13,872,0,0,0
19,13,1034,2,1,1
19,13,1493,0,0,0
19,13,1739,5,4,1
19,13,31,0,0,0
19,13,125,0,0,0
19,13,380,6,2,4
19,13,831,1,1,0
19,14,1184,4,1,3
19,14,3407,29,14,15
19,14,1341,6,4,2
19,14,1365,3,1,2
19,14,1526,0,0,0
19,14,2971,11,6,5
19,14,3192,37,22,15
19,14,130,5,3,2
19,14,625,1,0,1
19,14,580,0,0,0
19,14,525,5,2,3
19,14,1803,3,1,2
19,14,403,0,0,0
19,14,728,1,1,0
19,14,2021,18,7,11
19,14,614,7,2,5
19,14,619,2,2,0
19,14,679,0,0,0
19,14,889,4,1,3
19,14,1269,0,0,0
19,14,1034,1,1,0
19,14,282,0,0,0
19,14,664,27,11,16
19,14,583,0,0,0
19,14,602,0,0,0
19,14,817,0,0,0
19,14,855,3,0,3
19,14,368,2,1,1
19,14,321,2,1,1
19,14,334,0,0,0
19,14,476,1,0,1
19,14,782,0,0,0
19,14,724,20,9,11
19,14,464,3,1,2
19,14,612,2,2,0
19,14,1107,75,33,42
19,14,281,1,0,1
19,15,297,0,0,0
19,15,568,1,1,0
19,15,159,0,0,0
19,15,3,0,0,0
19,15,21,0,0,0
19,15,31,1,0,1
19,15,27,0,0,0
19,15,113,0,0,0
19,15,144,1,1,0
19,16,1291,57,29,28
19,16,1057,25,13,12
19,16,601,50,24,26
19,16,309,0,0,0
19,17,2703,15,7,8
19,17,1284,5,4,1
19,17,3387,6,4,2
19,17,2380,3,1,2
19,17,664,4,2,2
19,17,266,1,0,1
19,17,536,0,0,0
19,17,1225,12,4,8
19,17,765,169,72,97
19,17,1814,3,2,1
19,17,1199,1,0,1
19,17,1659,1,0,1
19,17,2007,0,0,0
19,17,1741,1,0,1
19,17,1648,12,4,8
19,17,298,0,0,0
19,17,728,2,1,1
19,17,1335,10,6,4
19,17,444,0,0,0
19,17,832,1,1,0
19,17,2466,15,7,8
19,17,249,0,0,0
19,17,354,18,12,6
19,17,391,3,1,2
19,17,254,2,0,2
19,17,982,1,0,1
19,17,498,0,0,0
19,17,1084,7,4,3
19,17,213,0,0,0
19,17,294,1,1,0
19,17,368,0,0,0
19,17,1207,1,1,0
19,17,182,0,0,0
19,17,1174,0,0,0
19,17,2835,7,5,2
19,17,373,0,0,0
19,17,1153,1,1,0
19,18,33510,501,254,247
19,18,16394,98,50,48
19,18,1867,22,11,11
19,18,1421,1,1,0
19,18,2684,34,21,13
19,18,428,42,20,22
19,18,598,6,4,2
19,18,1404,9,6,3
19,19,2010,8,5,3
19,19,1627,0,0,0
19,19,1751,7,2,5
19,19,3710,24,10,14
19,19,2369,126,66,60
19,19,2252,4,0,4
19,19,1715,9,5,4
19,19,1698,25,9,16
19,19,1603,62,26,36
19,19,1795,8,5,3
19,19,2151,22,12,10
19,19,1661,16,8,8
19,19,1606,14,7,7
19,19,1884,9,4,5
19,19,2370,12,4,8
19,19,2445,12,8,4
19,19,1674,13,9,4
19,19,2357,444,214,230
19,19,1820,106,50,56
19,19,1738,359,188,171
19,19,909,19,9,10
19,19,1111,5,4,1
19,19,1274,9,4,5
19,19,793,18,11,7
19,19,2057,29,19,10
19,19,831,25,13,12
19,19,1951,36,22,14
19,19,1155,9,5,4
19,19,1749,23,13,10
19,19,1602,8,5,3
19,19,2294,6,3,3
19,19,4142,54,24,30
19,19,6320,78,34,44
19,19,7073,75,40,35
19,19,9265,40,23,17
19,19,2058,25,17,8
19,19,1703,1,1,0
19,19,1234,47,25,22
19,19,1200,10,5,5
19,19,482,8,4,4
19,19,628,11,4,7
19,19,1455,9,4,5
19,19,1702,13,4,9
19,19,1174,14,7,7
19,19,1015,4,3,1
19,19,1870,15,6,9
19,19,3504,21,13,8
19,19,2510,25,12,13
19,19,2229,41,23,18
19,19,1180,22,13,9
19,19,1308,26,15,11
19,19,1723,7,2,5
19,19,2154,16,8,8
19,19,2888,23,16,7
19,19,3217,29,19,10
19,19,3285,34,15,19
19,19,1823,4,1,3
19,19,1998,8,3,5
19,19,1397,9,3,6
19,19,1142,5,2,3
19,19,3140,26,16,10
19,19,1973,15,9,6
19,20,1081,0,0,0
19,20,432,2,1,1
19,20,661,0,0,0
19,20,1275,3,3,0
19,20,1106,2,1,1
19,20,847,0,0,0
19,20,112,0,0,0
19,21,3938,11,6,5
19,21,2228,3,1,2
19,21,2964,26,13,13
19,21,16179,50,23,27
19,21,2196,13,7,6
19,21,1671,5,1,4
19,21,1647,5,3,2
19,21,1889,12,7,5
19,21,3182,5,1,4
19,21,13692,208,98,110
19,21,6139,37,18,19
19,21,7136,40,20,20
19,21,5272,40,18,22
19,21,2581,21,7,14
19,21,1190,5,2,3
19,21,6324,165,92,73
19,21,5732,37,23,14
19,21,6243,24,12,12
19,21,1876,53,32,21
19,21,1439,19,14,5
19,21,1660,2,1,1
19,21,4095,10,3,7
19,21,1696,20,7,13
19,21,1820,19,10,9
19,21,3576,32,18,14
19,21,2151,12,3,9
19,21,6497,63,18,45
19,21,6560,51,21,30
19,21,978,8,2,6
19,21,1095,6,1,5
19,21,9289,61,32,29
19,21,1465,15,5,10
19,21,1165,3,2,1
19,21,909,1,1,0
19,21,2287,16,6,10
19,21,1750,36,17,19
19,21,973,0,0,0
19,21,3568,6,5,1
19,21,997,9,5,4
19,21,8923,260,139,121
19,21,2351,20,7,13
19,21,10565,124,64,60
19,21,1350,9,4,5
19,21,1700,3,2,1
19,21,1389,25,13,12
19,21,871,3,2,1
19,21,1436,7,5,2
19,21,8562,33,18,15
19,21,1390,4,2,2
19,21,3289,29,15,14
19,21,13251,332,158,174
19,21,1227,14,6,8
19,21,1063,3,3,0
19,21,854,0,0,0
19,21,1242,6,3,3
19,21,1883,6,1,5
19,21,1816,12,2,10
19,21,1657,25,11,14
19,21,16123,222,102,120
19,21,6080,70,26,44
19,22,1294,0,0,0
19,22,1828,3,2,1
19,22,788,5,0,5
19,22,1087,1,0,1
19,22,183,1,0,1
19,22,84,0,0,0
19,22,731,159,69,90
19,22,653,1,1,0
19,22,510,0,0,0
19,22,1761,129,62,67
19,22,569,0,0,0
19,22,403,9,5,4
19,22,1610,227,109,118
19,22,1780,376,184,192
19,22,28,0,0,0
19,22,265,0,0,0
19,22,470,0,0,0
19,23,357,0,0,0
19,23,662,0,0,0
19,23,788,0,0,0
19,24,1664,6,4,2
19,24,3237,4,0,4
19,24,238,0,0,0
19,24,277,0,0,0
19,24,838,3,2,1
19,25,1976,26,12,14
19,25,7471,75,35,40
19,26,699,4,1,3
19,26,553,19,9,10
19,26,616,16,6,10
19,26,320,6,1,5
19,26,389,0,0,0
19,26,640,2,0,2
19,26,665,6,4,2
19,26,1342,3,0,3
19,26,630,3,2,1
19,26,1046,2,0,2
19,26,1002,12,8,4
19,26,1421,15,7,8
19,26,1491,7,5,2
19,26,1375,22,11,11
19,26,913,4,2,2
19,26,1155,9,5,4
19,26,1189,41,17,24
19,26,1028,5,2,3
19,26,1561,2,2,0
19,26,772,8,5,3
19,26,1379,30,13,17
19,26,753,20,11,9
19,26,1689,13,5,8
19,26,1322,4,3,1
19,26,687,7,3,4
19,26,950,34,15,19
19,26,1239,19,11,8
19,26,1097,8,4,4
19,26,1411,9,7,2
19,26,1214,62,33,29
19,26,1343,139,74,65
19,26,1033,6,3,3
19,26,921,25,19,6
19,26,699,0,0,0
19,26,1637,25,13,12
19,26,565,8,3,5
19,26,657,8,5,3
19,26,677,3,0,3
19,26,408,11,5,6
19,26,600,3,2,1
19,26,507,9,6,3
19,26,305,2,1,1
19,26,951,50,15,35
19,26,949,5,2,3
19,26,1106,22,15,7
19,26,1134,5,4,1
19,26,626,42,22,20
19,26,590,1,0,1
19,26,610,3,1,2
19,26,502,6,2,4
19,26,1166,13,4,9
19,26,1551,30,11,19
19,26,1640,6,3,3
19,26,948,23,9,14
19,26,435,6,2,4
19,26,6878,86,39,47
19,26,2450,154,81,73
19,26,1964,51,24,27
19,26,1745,17,6,11
19,26,1434,0,0,0
19,26,1628,2,0,2
19,26,1089,6,3,3
19,26,596,5,3,2
19,26,275,4,1,3
19,26,951,7,6,1
19,26,594,5,1,4
19,26,1313,12,7,5
19,26,1817,39,24,15
19,26,3413,35,13,22
19,26,2076,19,12,7
19,26,2541,153,84,69
19,26,2433,29,11,18
19,26,2674,12,5,7
19,26,1515,21,15,6
19,26,2021,27,14,13
19,26,1922,105,54,51
19,26,1893,81,40,41
19,26,2162,43,21,22
19,26,5734,48,24,24
19,26,2614,3,3,0
19,26,12861,166,73,93
19,26,1895,348,178,170
19,26,1715,121,58,63
19,26,1687,15,8,7
19,26,1953,356,173,183
19,26,1773,30,16,14
19,26,1850,6,4,2
19,26,1619,2,1,1
19,26,1742,1,0,1
19,26,745,2,1,1
19,26,3347,384,191,193
19,26,3432,64,32,32
19,26,5588,206,95,111
19,26,2124,7,4,3
19,26,2519,22,7,15
19,26,10067,57,32,25
19,26,2261,477,250,227
19,26,2183,22,15,7
19,26,3311,23,12,11
19,26,2087,11,5,6
19,26,2021,23,9,14
19,26,1558,460,230,230
19,26,1378,224,112,112
19,26,768,3,2,1
19,26,979,41,17,24
19,26,1178,22,11,11
19,26,1324,37,23,14
19,26,1263,29,14,15
19,26,1237,13,9,4
19,26,1017,5,3,2
19,26,2471,26,11,15
19,26,1467,13,6,7
19,26,1974,6,3,3
19,26,1563,19,12,7
19,26,1406,2,2,0
19,26,1654,7,2,5
19,26,2070,0,0,0
19,26,1962,0,0,0
19,26,2191,5,3,2
19,26,14044,353,164,189
19,26,2080,56,28,28
19,26,2355,4,3,1
19,26,3539,2,1,1
19,26,1511,24,7,17
19,26,1497,21,15,6
19,26,1675,27,11,16
19,26,1130,30,17,13
19,26,586,15,6,9
19,26,723,1,1,0
19,26,718,19,11,8
19,26,839,14,6,8
19,26,981,12,8,4
19,26,612,14,6,8
19,26,910,18,8,10
19,26,1102,9,6,3
19,26,913,27,15,12
19,26,1393,20,6,14
19,26,2284,20,8,12
19,26,1705,3,2,1
19,26,1769,6,1,5
19,26,1855,12,6,6
19,26,2214,14,5,9
19,26,2242,2,0,2
19,26,1765,7,2,5
19,26,1934,2,0,2
19,26,2167,8,5,3
19,26,2332,18,6,12
19,26,2010,8,3,5
19,26,1810,13,6,7
19,26,2382,14,8,6
19,26,1456,5,2,3
19,26,1519,12,5,7
19,26,1428,16,9,7
19,26,1588,9,4,5
19,26,1665,0,0,0
19,26,1523,2,2,0
19,26,1938,117,59,58
19,26,1883,56,31,25
19,26,1473,76,43,33
19,26,1825,16,5,11
19,26,1611,18,7,11
19,26,1460,9,4,5
19,26,1603,0,0,0
19,26,2547,13,5,8
19,26,14075,195,99,96
19,26,1461,76,48,28
19,26,1930,1,0,1
19,26,1372,15,9,6
19,26,2019,9,3,6
19,26,5065,44,18,26
19,26,4978,20,6,14
19,26,1775,1,0,1
19,26,2411,34,20,14
19,26,9754,39,22,17
19,26,2599,4,1,3
19,26,2216,16,11,5
19,26,3296,83,42,41
19,26,1294,5,2,3
19,26,3297,101,50,51
19,26,2684,9,5,4
19,26,1315,3,2,1
19,26,1530,3,2,1
19,26,3364,25,14,11
19,26,1802,4,4,0
19,26,1621,80,38,42
19,26,1388,20,11,9
19,26,1279,9,7,2
19,26,1531,8,3,5
19,26,1375,7,4,3
19,26,1381,8,1,7
19,26,1712,8,3,5
19,26,1514,5,2,3
19,26,1876,7,4,3
19,26,1822,22,9,13
19,26,3170,37,18,19
19,26,1434,15,2,13
19,26,1653,21,7,14
19,26,1672,7,3,4
19,26,1630,9,4,5
19,26,1961,7,3,4
19,26,1299,11,6,5
19,26,2734,2,0,2
19,26,2068,62,30,32
19,26,1521,26,14,12
19,26,2168,18,7,11
19,26,2811,9,1,8
19,26,1421,17,4,13
19,26,1724,33,16,17
19,26,1803,15,6,9
19,26,11036,73,42,31
19,26,2550,11,5,6
19,26,2400,4,3,1
19,26,11929,114,58,56
19,26,3848,22,10,12
19,26,12740,114,58,56
19,26,1416,12,5,7
19,26,1560,3,2,1
19,26,1312,48,23,25
19,26,1424,20,15,5
19,26,1798,61,30,31
19,26,2703,38,16,22
19,26,2509,26,14,12
19,26,1312,12,8,4
19,26,2188,5,2,3
19,26,1718,11,3,8
19,26,2357,6,3,3
19,26,1292,6,3,3
19,26,1326,4,2,2
19,26,1432,3,1,2
19,26,4498,78,44,34
19,26,2063,75,38,37
19,26,865,3,1,2
19,26,1064,6,2,4
19,26,2814,11,5,6
19,26,1437,4,2,2
19,26,1686,1,1,0
19,26,1794,4,1,3
19,26,2541,7,2,5
19,26,1471,8,4,4
19,26,1793,4,2,2
19,26,1858,8,4,4
19,26,1787,12,2,10
19,26,1359,18,9,9
19,26,1977,19,8,11
19,26,1046,8,2,6
19,26,1603,12,5,7
19,26,2010,7,2,5
19,26,4376,22,11,11
19,26,1367,34,18,16
19,26,1649,9,5,4
19,26,1726,6,3,3
19,26,4529,31,17,14
19,26,1621,0,0,0
19,26,1509,5,2,3
19,26,2838,58,29,29
19,26,2100,9,2,7
19,26,2190,2,1,1
19,26,4287,31,13,18
19,26,4496,5,2,3
19,26,4423,40,25,15
19,26,2848,34,20,14
19,26,4609,32,15,17
19,26,2167,1,1,0
19,26,2274,3,0,3
19,26,9125,220,120,100
19,26,2673,858,447,411
19,26,1835,428,212,216
19,26,1329,1,1,0
19,26,2553,19,10,9
19,26,7415,67,29,38
19,26,3178,32,15,17
19,26,2401,10,5,5
19,26,1623,15,6,9
19,26,3192,15,5,10
19,26,8025,68,35,33
19,27,370,0,0,0
19,27,402,0,0,0
19,27,408,0,0,0
19,27,398,0,0,0
19,27,250,0,0,0
19,27,145,0,0,0
19,28,1989,6,1,5
19,28,809,6,4,2
19,28,1605,3,2,1
19,28,494,1,1,0
19,28,1520,5,3,2
19,28,4294,41,21,20
19,28,2046,2,1,1
19,28,860,3,1,2
19,28,2453,10,4,6
19,29,358,0,0,0
19,29,1029,1,0,1
19,30,1959,0,0,0
19,30,639,2,1,1
19,30,859,1,0,1
19,30,1107,3,1,2
19,30,1366,1,0,1
19,30,487,1,1,0
19,30,333,6,3,3
19,30,202,0,0,0
19,30,88,0,0,0
19,31,1693,4,4,0
19,31,685,13,6,7
19,31,397,1,0,1
19,31,532,0,0,0
19,32,1514,37,21,16
19,32,3741,25,12,13
19,32,2324,618,306,312
19,32,8467,217,102,115
19,32,5513,319,152,167
19,32,12066,190,89,101
19,32,661,9,4,5
19,32,1921,2,1,1
19,32,3880,39,18,21
19,32,616,10,1,9
19,32,4295,12,5,7
19,32,664,15,5,10
19,32,107,1,1,0
19,32,356,5,2,3
19,33,1313,0,0,0
19,33,949,1,1,0
19,33,2050,3,2,1
19,33,961,0,0,0
19,33,79,0,0,0
19,34,3796,33,12,21
19,34,1310,2,1,1
19,34,620,1,0,1
19,34,5708,14,5,9
19,34,6654,5,3,2
19,34,5697,21,12,9
19,34,4062,17,10,7
19,34,1460,2,1,1
19,34,543,10,5,5
19,34,3247,4,3,1
19,34,2209,24,6,18
19,34,1493,2,0,2
19,34,1163,5,3,2
19,34,1075,2,1,1
19,34,344,0,0,0
19,34,970,2,1,1
19,34,1377,4,2,2
19,34,445,0,0,0
19,34,391,0,0,0
19,34,1140,4,1,3
19,34,802,2,1,1
19,34,2477,40,18,22
19,34,9337,30,14,16
19,34,4900,115,62,53
19,34,1344,2,1,1
19,34,1098,12,5,7
19,34,2256,4,1,3
19,34,2578,8,1,7
19,34,2458,10,2,8
19,34,1488,10,2,8
19,34,215,1,0,1
19,34,316,1,0,1
19,34,296,1,1,0
19,34,385,0,0,0
19,34,221,7,2,5
19,34,460,2,1,1
19,34,287,1,1,0
19,34,1947,2,2,0
19,34,1148,1,0,1
19,34,439,0,0,0
19,34,524,0,0,0
19,34,542,2,1,1
19,34,1442,3,1,2
19,34,1728,1,1,0
19,34,533,1,0,1
19,34,516,2,1,1
19,34,1229,9,2,7
19,35,1135,3,0,3
19,35,534,9,4,5
19,35,3281,5,4,1
19,36,667,11,4,7
19,36,816,8,5,3
19,37,1134,3,1,2
19,37,604,9,4,5
19,37,1471,9,3,6
19,37,571,0,0,0
19,37,1061,0,0,0
19,37,483,0,0,0
19,37,1321,4,1,3
19,37,564,8,4,4
19,37,137,0,0,0
19,37,277,0,0,0
19,38,562,7,2,5
19,38,301,6,3,3
19,38,121,1,0,1
19,38,119,1,0,1
19,39,3434,87,35,52
19,39,1026,28,17,11
19,39,1451,12,8,4
19,39,744,4,1,3
19,39,3061,10,4,6
19,39,1088,3,1,2
19,39,603,9,5,4
19,39,2690,26,16,10
19,39,3929,31,18,13
19,39,1929,110,52,58
19,39,1020,4,2,2
19,39,1312,11,4,7
19,39,283,2,1,1
19,39,899,3,2,1
19,39,582,2,0,2
19,39,1922,37,21,16
19,39,3459,13,8,5
19,39,4755,27,17,10
19,39,1381,3,3,0
19,39,1986,5,3,2
19,39,915,4,3,1
19,39,1539,4,1,3
19,39,636,14,10,4
19,39,742,4,2,2
19,39,355,2,1,1
19,39,176,0,0,0
19,39,896,1,0,1
19,39,1230,12,6,6
19,39,2272,2,2,0
19,39,9499,74,38,36
19,39,675,1,0,1
19,39,1864,7,2,5
19,39,1008,9,3,6
19,39,1272,4,2,2
19,39,294,2,1,1
19,39,185,1,0,1
19,39,156,0,0,0
19,39,4545,10,9,1
19,39,497,3,2,1
19,39,280,0,0,0
19,39,437,0,0,0
19,39,502,2,1,1
19,40,1067,0,0,0
19,40,1997,2,1,1
19,40,1115,15,7,8
19,40,1372,8,4,4
19,40,1824,0,0,0
19,40,1533,1,0,1
19,40,1128,2,2,0
19,40,1227,35,14,21
19,40,1412,22,8,14
19,40,1451,17,5,12
19,40,1055,10,4,6
19,40,856,20,11,9
19,40,1370,2,1,1
19,40,1251,27,15,12
19,40,1046,56,33,23
19,40,826,6,4,2
19,40,1002,1,0,1
19,40,940,0,0,0
19,40,846,12,6,6
19,40,751,4,1,3
19,40,1380,10,6,4
19,40,814,3,1,2
19,40,837,4,1,3
19,40,731,1,0,1
19,40,449,2,2,0
19,40,756,5,3,2
19,40,933,4,2,2
19,40,1113,11,4,7
19,40,1209,13,6,7
19,40,1175,16,7,9
19,40,2012,27,7,20
19,40,1334,24,13,11
19,40,1303,41,20,21
19,40,1326,22,10,12
19,40,1143,19,10,9
19,40,991,5,2,3
19,40,751,3,2,1
19,40,1198,0,0,0
19,40,956,1,1,0
19,40,1448,63,32,31
19,40,1257,10,6,4
19,40,235,17,8,9
19,40,1263,6,2,4
19,40,1187,12,6,6
19,40,646,4,2,2
19,40,722,7,3,4
19,40,599,11,6,5
19,40,204,5,2,3
19,40,825,11,5,6
19,40,684,13,8,5
19,40,878,155,83,72
19,40,615,1,0,1
19,40,443,0,0,0
19,40,611,31,5,26
19,40,1177,14,7,7
19,40,562,1,0,1
19,40,657,0,0,0
19,40,875,2,1,1
19,40,721,2,2,0
19,40,977,4,1,3
19,40,848,13,7,6
19,40,818,21,12,9
19,40,384,13,5,8
19,40,644,33,14,19
19,40,710,24,14,10
19,40,704,2,1,1
19,40,1347,39,22,17
19,40,1332,72,34,38
19,40,1480,66,35,31
19,40,1876,4,3,1
19,40,2563,16,8,8
19,40,1293,361,200,161
19,40,1181,179,87,92
19,40,468,20,14,6
19,40,710,35,19,16
19,40,1084,100,58,42
19,40,684,14,8,6
19,40,831,17,11,6
19,40,353,0,0,0
19,40,941,4,1,3
19,40,610,0,0,0
19,40,446,0,0,0
19,40,453,1,0,1
19,40,1315,2,0,2
19,40,1580,3,1,2
19,40,312,3,2,1
19,40,420,16,6,10
19,40,286,0,0,0
19,40,743,1,1,0
19,40,1597,4,2,2
19,40,2169,13,6,7
19,40,1229,4,3,1
19,40,682,27,13,14
19,40,646,4,3,1
19,40,815,2,2,0
19,40,528,2,0,2
19,40,1551,54,30,24
19,40,376,4,2,2
19,40,559,11,5,6
19,40,536,14,11,3
19,40,487,2,0,2
19,40,330,10,5,5
19,40,348,0,0,0
19,40,467,4,0,4
19,40,229,1,1,0
19,40,471,3,1,2
19,40,463,4,2,2
19,40,510,6,2,4
19,40,820,13,3,10
19,40,1533,16,8,8
19,40,944,28,15,13
19,40,724,25,14,11
19,40,707,1,1,0
19,40,861,41,24,17
19,40,847,15,9,6
19,40,3638,35,21,14
19,40,5113,48,23,25
19,40,6085,62,29,33
19,40,1929,17,10,7
19,40,1921,29,19,10
19,40,2933,54,30,24
19,40,5049,102,58,44
19,40,3908,63,27,36
19,40,2853,40,22,18
19,40,262,4,0,4
19,40,828,5,2,3
19,40,653,6,4,2
19,40,456,8,4,4
19,40,608,5,2,3
19,40,216,0,0,0
19,40,330,5,2,3
19,40,321,0,0,0
19,40,326,16,6,10
19,40,406,9,2,7
19,40,550,13,6,7
19,40,373,1,0,1
19,40,261,1,1,0
19,40,244,0,0,0
19,40,308,0,0,0
19,40,251,2,0,2
19,40,670,17,9,8
19,40,923,16,6,10
19,40,631,14,7,7
19,40,464,0,0,0
19,40,131,2,0,2
19,40,692,30,17,13
19,40,409,11,7,4
19,40,429,10,2,8
19,40,731,16,9,7
19,40,2427,29,12,17
19,40,1743,12,6,6
19,40,842,9,7,2
19,40,1466,12,5,7
19,40,1420,9,4,5
19,40,1272,18,11,7
19,40,1705,35,12,23
19,40,156,0,0,0
19,40,89,0,0,0
19,40,450,3,0,3
19,40,5859,239,117,122
19,40,409,4,1,3
19,40,479,4,2,2
19,40,324,6,3,3
19,40,331,3,2,1
19,40,278,6,2,4
19,40,254,1,0,1
19,40,238,6,4,2
19,40,262,10,4,6
19,40,392,33,15,18
19,40,224,1,1,0
19,40,430,123,58,65
19,40,402,3,2,1
19,40,462,2,0,2
19,40,515,47,30,17
19,40,724,0,0,0
19,40,245,1,0,1
19,40,504,2,0,2
19,40,249,9,5,4
19,40,836,0,0,0
19,40,324,0,0,0
19,40,579,0,0,0
19,40,701,2,0,2
19,40,466,4,2,2
19,40,480,23,12,11
19,40,220,4,1,3
19,40,218,0,0,0
19,40,521,17,9,8
19,40,347,21,9,12
19,40,192,1,1,0
19,40,229,1,1,0
19,40,548,7,4,3
19,40,345,26,15,11
19,40,78,0,0,0
19,40,82,0,0,0
19,40,120,1,0,1
19,40,137,0,0,0
19,40,369,2,1,1
19,40,188,0,0,0
19,40,146,4,0,4
19,40,152,0,0,0
19,40,256,3,1,2
19,40,90,0,0,0
19,40,179,0,0,0
19,40,174,0,0,0
19,40,136,5,3,2
19,40,246,22,14,8
19,40,233,0,0,0
19,40,286,0,0,0
19,40,479,8,3,5
19,40,192,1,0,1
19,40,66,0,0,0
19,40,71,4,0,4
19,40,95,0,0,0
19,40,210,0,0,0
19,40,512,2,1,1
19,40,43,0,0,0
19,40,72,1,1,0
19,40,236,1,0,1
19,40,91,0,0,0
19,40,70,0,0,0
19,40,484,8,3,5
19,40,429,9,4,5
19,40,391,11,4,7
19,40,351,18,11,7
19,40,716,9,3,6
19,40,530,9,4,5
19,40,443,2,1,1
19,40,516,15,5,10
19,40,302,5,3,2
19,40,309,1,0,1
19,40,294,1,0,1
19,40,287,3,3,0
19,40,351,0,0,0
19,40,268,0,0,0
19,40,537,23,14,9
19,40,625,1,0,1
19,40,849,8,5,3
19,40,609,2,1,1
19,40,811,7,4,3
19,40,879,0,0,0
19,40,547,8,4,4
19,40,1042,22,12,10
19,40,378,1,1,0
19,40,754,7,2,5
19,40,995,5,3,2
19,40,921,2,2,0
19,40,1480,5,3,2
19,40,1111,1,1,0
19,40,1060,6,3,3
19,40,981,8,3,5
19,40,551,10,7,3
19,40,1266,7,3,4
19,40,1041,13,6,7
19,40,1522,106,54,52
19,40,1184,353,176,177
19,40,643,53,29,24
19,40,955,24,11,13
19,40,398,6,2,4
19,40,464,4,2,2
19,40,804,11,6,5
19,40,697,3,1,2
19,40,196,1,0,1
19,40,609,2,1,1
19,40,2657,59,29,30
19,40,742,2,1,1
19,40,320,0,0,0
19,40,535,4,2,2
19,40,524,6,3,3
19,40,530,2,1,1
19,40,612,8,4,4
19,40,292,1,0,1
19,40,707,63,32,31
19,40,298,0,0,0
19,40,483,0,0,0
19,40,627,7,2,5
19,40,384,1,1,0
19,40,338,0,0,0
19,40,336,1,0,1
19,40,137,3,2,1
19,40,318,6,3,3
19,40,454,15,5,10
19,40,298,4,1,3
19,40,522,4,4,0
19,40,225,4,4,0
19,40,259,14,5,9
19,40,226,15,8,7
19,40,204,5,4,1
19,40,276,6,3,3
19,40,165,4,1,3
19,40,699,5,1,4
19,40,651,7,5,2
19,40,283,6,3,3
19,40,417,5,3,2
19,40,318,2,1,1
19,40,395,2,1,1
19,40,1101,1,0,1
19,40,596,3,1,2
19,40,562,5,3,2
19,40,120,1,0,1
19,40,619,4,3,1
19,40,1181,10,5,5
19,40,1038,36,15,21
19,40,141,1,0,1
19,40,499,21,8,13
19,40,797,88,44,44
19,40,465,75,37,38
19,40,796,22,11,11
19,40,1457,48,29,19
19,40,462,4,4,0
19,40,857,102,50,52
19,40,529,36,12,24
19,40,754,97,45,52
19,40,488,9,6,3
19,40,529,8,3,5
19,40,1039,7,3,4
19,40,522,7,3,4
19,40,663,38,18,20
19,40,436,6,3,3
19,40,440,6,6,0
19,40,984,30,18,12
19,40,876,22,10,12
19,40,506,11,6,5
19,40,1867,6,6,0
19,40,515,8,4,4
19,40,1886,18,12,6
19,40,1379,16,6,10
19,40,1289,12,3,9
19,40,1397,28,14,14
19,40,4090,56,24,32
19,40,1440,20,10,10
19,40,1446,16,5,11
19,40,1320,14,7,7
19,40,580,3,2,1
19,40,1363,6,4,2
19,40,672,142,75,67
19,40,454,14,7,7
19,40,577,6,2,4
19,40,293,0,0,0
19,40,338,94,48,46
19,40,374,144,79,65
19,40,932,10,4,6
19,40,1861,17,5,12
19,40,880,25,19,6
19,40,1267,22,9,13
19,40,1280,19,5,14
19,40,1228,3,1,2
19,40,1609,13,9,4
19,40,2327,8,4,4
19,40,1575,8,5,3
19,40,1858,8,3,5
19,40,1682,13,4,9
19,40,1958,13,5,8
19,40,2058,11,5,6
19,40,1697,20,10,10
19,40,888,139,68,71
19,40,395,3,0,3
19,40,522,7,3,4
19,40,713,19,11,8
19,40,902,4,2,2
19,40,723,7,1,6
19,40,825,6,1,5
19,40,1829,14,4,10
19,40,2031,21,12,9
19,40,1776,24,9,15
19,40,705,7,4,3
19,40,3970,24,8,16
19,40,2350,22,9,13
19,40,1745,10,4,6
19,40,928,25,15,10
19,40,965,4,2,2
19,40,2259,5,3,2
19,40,2124,2,1,1
19,40,1476,11,6,5
19,40,1990,1,0,1
19,40,2165,15,6,9
19,40,2337,12,4,8
19,40,731,21,10,11
19,40,962,23,8,15
19,40,937,2,1,1
19,40,1820,19,8,11
19,40,1734,23,12,11
19,40,1089,5,2,3
19,40,1157,2,0,2
19,40,1060,1,1,0
19,40,1113,10,4,6
19,40,1084,23,10,13
19,40,1409,58,33,25
19,40,1401,19,9,10
19,40,1724,6,3,3
19,40,1679,36,14,22
19,40,2857,76,37,39
19,40,2663,17,7,10
19,40,1164,5,3,2
19,40,1031,5,2,3
19,40,1179,7,2,5
19,40,1973,35,24,11
19,40,1086,34,23,11
19,40,1973,10,3,7
19,40,2039,4,2,2
19,40,2716,25,12,13
19,40,2836,11,4,7
19,40,1772,10,4,6
19,40,1908,15,9,6
19,40,2217,60,28,32
19,40,1722,45,23,22
19,40,1729,32,15,17
19,40,1426,8,5,3
19,40,1332,4,2,2
19,40,2274,8,5,3
19,40,2381,15,7,8
19,40,555,3,2,1
19,40,1864,9,4,5
19,40,2129,74,39,35
19,40,1885,7,5,2
19,40,2184,6,4,2
19,40,3729,50,32,18
19,40,2147,9,3,6
19,40,1408,3,2,1
19,40,3979,114,70,44
19,40,3084,2,1,1
19,40,5164,79,48,31
19,40,1235,20,6,14
19,40,1149,13,9,4
19,40,1793,14,7,7
19,40,4555,110,49,61
19,40,2002,33,14,19
19,40,1734,17,10,7
19,40,3299,39,22,17
19,40,2766,43,21,22
19,40,2295,195,96,99
19,40,2183,69,39,30
19,40,8167,86,43,43
19,40,2226,20,11,9
19,40,3212,57,30,27
19,40,2303,72,38,34
19,40,2087,28,12,16
19,40,5607,91,48,43
19,40,20582,282,142,140
19,40,2696,14,7,7
19,40,1941,8,3,5
19,40,8373,103,54,49
19,40,1738,29,13,16
19,40,2966,35,17,18
19,40,7744,136,67,69
19,40,5499,50,30,20
19,40,741,1,1,0
19,40,1895,4,2,2
19,40,1976,7,4,3
19,40,1968,66,36,30
19,40,2377,12,8,4
19,40,2674,13,4,9
19,40,2350,41,10,31
19,40,1738,0,0,0
19,40,2245,19,9,10
19,40,2059,5,4,1
19,40,2832,12,9,3
19,40,2587,29,14,15
19,40,2691,26,16,10
19,40,2977,18,12,6
19,40,2473,9,3,6
19,40,1470,48,20,28
19,40,2443,19,9,10
19,40,2085,5,3,2
19,40,6692,15,4,11
19,40,3587,21,14,7
19,40,2385,5,3,2
19,40,2456,13,7,6
19,40,2625,12,6,6
19,40,2254,34,16,18
19,40,2777,33,14,19
19,40,3771,13,8,5
19,40,3238,38,18,20
19,40,1621,14,8,6
19,40,2486,13,7,6
19,40,1946,15,7,8
19,40,2227,0,0,0
19,40,2443,18,10,8
19,40,2860,19,11,8
19,40,2911,19,10,9
19,40,1857,123,53,70
19,40,2106,332,156,176
19,40,1616,18,12,6
19,40,2159,27,16,11
19,40,2032,13,7,6
19,40,2305,16,9,7
19,40,2559,18,12,6
19,40,2192,4,2,2
19,40,2119,3,1,2
19,40,2921,4,3,1
19,40,2333,4,2,2
19,40,1873,23,10,13
19,40,2414,15,6,9
19,40,1806,12,2,10
19,40,1900,27,14,13
19,40,2303,12,8,4
19,40,2697,8,4,4
19,40,2104,16,8,8
19,40,1893,14,10,4
19,40,2402,15,7,8
19,40,2385,13,5,8
19,40,1781,15,7,8
19,40,2141,25,13,12
19,40,4161,16,6,10
19,40,4091,16,5,11
19,40,2663,18,8,10
19,40,2013,20,8,12
19,40,2223,10,4,6
19,40,4300,44,21,23
19,40,1323,22,11,11
19,40,1266,12,5,7
19,40,2268,10,2,8
19,40,1539,14,5,9
19,40,2146,8,3,5
19,40,2183,10,3,7
19,40,1951,14,6,8
19,40,1840,11,6,5
19,40,1218,4,1,3
19,40,1120,6,3,3
19,40,974,7,2,5
19,40,5664,180,83,97
19,40,2229,64,32,32
19,40,8494,95,50,45
19,40,9372,88,45,43
19,40,1534,4,3,1
19,40,1795,24,9,15
19,40,1694,29,13,16
19,40,1266,18,11,7
19,40,1514,4,2,2
19,40,3895,173,75,98
19,40,1652,5,3,2
19,40,1178,41,16,25
19,40,1317,3,0,3
19,40,1915,37,22,15
19,40,2587,7,2,5
19,40,2228,6,3,3
19,40,3820,5,1,4
19,40,3417,4,0,4
19,40,2474,5,2,3
19,40,1895,140,65,75
19,40,1794,2,0,2
19,40,1717,23,11,12
19,40,1184,5,3,2
19,40,1494,712,339,373
19,40,1571,0,0,0
19,40,1391,38,15,23
19,40,1490,53,22,31
19,40,1810,7,4,3
19,40,3353,21,10,11
19,40,2092,7,3,4
19,40,1718,5,1,4
19,40,2007,5,2,3
19,40,1486,68,35,33
19,40,1323,21,12,9
19,40,1331,7,4,3
19,40,1174,22,13,9
19,40,1523,4,0,4
19,40,1649,10,6,4
19,40,911,4,2,2
19,40,1109,17,8,9
19,40,1575,17,10,7
19,40,1881,3,1,2
19,40,1894,7,2,5
19,40,1948,465,232,233
19,40,2503,74,41,33
19,40,2124,3,2,1
19,40,2253,31,21,10
19,40,2335,37,19,18
19,40,2200,6,5,1
19,40,2264,11,5,6
19,40,1583,13,6,7
19,40,1957,816,404,412
19,40,1352,2,0,2
19,40,689,10,6,4
19,40,650,17,11,6
19,40,1365,8,2,6
19,40,1705,12,6,6
19,40,3408,8,4,4
19,40,1672,2,1,1
19,40,2058,2,0,2
19,40,1608,9,6,3
19,40,1533,12,10,2
19,40,1325,2,1,1
19,40,1213,25,14,11
19,40,1336,23,13,10
19,40,1346,25,16,9
19,40,1112,2,1,1
19,40,1753,109,51,58
19,40,1538,3,1,2
19,40,1823,11,4,7
19,40,7946,357,180,177
19,40,3594,14,7,7
19,40,3186,16,5,11
19,40,1012,32,15,17
19,40,2827,125,55,70
19,40,1512,11,4,7
19,40,1332,27,13,14
19,40,1604,132,65,67
19,40,1409,18,12,6
19,40,1394,7,4,3
19,40,1415,21,11,10
19,40,4785,35,22,13
19,40,1847,20,11,9
19,40,1968,45,27,18
19,40,1893,9,4,5
19,40,1805,5,5,0
19,40,2415,23,11,12
19,40,2481,61,31,30
19,40,1881,9,6,3
19,40,1623,8,2,6
19,40,1412,11,3,8
19,40,3927,410,191,219
19,40,1414,65,31,34
19,40,1284,7,4,3
19,40,1628,10,3,7
19,40,2546,32,18,14
19,40,1991,18,11,7
19,40,2338,33,13,20
19,40,1902,4,1,3
19,40,1927,9,5,4
19,40,1831,31,21,10
19,40,1557,22,8,14
19,40,425,2,2,0
19,40,1256,71,41,30
19,40,1552,5,1,4
19,40,1094,4,2,2
19,40,1165,10,4,6
19,40,948,4,3,1
19,40,2178,6,3,3
19,40,1842,19,9,10
19,40,556,10,7,3
19,40,2283,33,4,29
19,40,2583,8,3,5
19,40,1655,5,3,2
19,40,1885,10,5,5
19,40,1865,21,11,10
19,40,1666,24,12,12
19,40,716,7,5,2
19,40,1547,53,28,25
19,40,1791,21,12,9
19,40,1930,15,7,8
19,40,2106,50,29,21
19,40,1626,69,33,36
19,40,1440,66,30,36
19,40,1522,34,12,22
19,40,298,8,4,4
19,40,1050,1,1,0
19,40,326,1,0,1
19,40,564,1,1,0
19,40,1182,2,1,1
19,40,232,0,0,0
19,40,911,2,1,1
19,40,898,0,0,0
19,40,803,1,1,0
19,40,772,1,0,1
19,40,1114,1,0,1
19,40,87,0,0,0
19,40,1223,2,1,1
19,40,512,3,1,2
19,40,319,0,0,0
19,40,428,0,0,0
19,40,251,2,1,1
19,40,400,3,2,1
19,40,597,2,0,2
19,40,463,0,0,0
19,40,225,6,1,5
19,40,859,5,1,4
19,40,760,3,2,1
19,40,1023,1,0,1
19,40,706,2,1,1
19,40,645,6,4,2
19,40,748,2,2,0
19,40,1156,254,141,113
19,40,1038,0,0,0
19,40,1595,14,5,9
19,40,930,5,2,3
19,40,911,18,8,10
19,40,713,6,2,4
19,40,825,6,3,3
19,40,548,1,0,1
19,40,430,0,0,0
19,40,384,1,0,1
19,40,654,1,1,0
19,40,521,1,0,1
19,40,352,5,3,2
19,40,769,0,0,0
19,40,907,3,2,1
19,40,702,6,0,6
19,40,1327,18,9,9
19,40,1033,8,6,2
19,40,1190,10,6,4
19,40,1130,3,0,3
19,40,424,4,2,2
19,40,607,4,2,2
19,40,868,7,4,3
19,40,1162,8,4,4
19,40,1002,1,0,1
19,40,1221,2,1,1
19,40,331,4,0,4
19,40,545,0,0,0
19,40,1077,11,4,7
19,40,1451,570,300,270
19,40,1968,104,57,47
19,40,401,3,1,2
19,40,380,2,0,2
19,40,818,1,0,1
19,40,1035,21,11,10
19,40,594,34,17,17
19,40,332,14,6,8
19,40,531,31,14,17
19,40,468,8,3,5
19,40,271,1,0,1
19,40,1079,8,2,6
19,40,572,11,4,7
19,40,161,0,0,0
19,41,184,8,4,4
19,41,566,8,6,2
19,41,150,0,0,0
19,42,3300,9,3,6
19,42,2116,11,5,6
19,42,12055,56,23,33
19,42,10710,30,11,19
19,42,41870,685,312,373
19,42,251,2,1,1
19,42,1064,2,0,2
19,42,432,2,1,1
19,43,776,0,0,0
19,43,608,4,4,0
19,43,268,0,0,0
19,43,251,1,1,0
19,43,228,0,0,0
19,43,360,1,1,0
19,43,195,0,0,0
19,43,542,0,0,0
19,43,1068,1,0,1
19,43,452,1,1,0
19,43,220,3,0,3
19,43,322,8,4,4
19,44,851,6,6,0
19,44,695,0,0,0
19,44,269,0,0,0
19,44,161,1,0,1
19,44,398,0,0,0
19,45,3014,12,10,2
19,45,1158,7,3,4
19,45,1199,3,2,1
19,45,1306,1,0,1
19,45,2816,9,2,7
19,45,821,8,4,4
19,45,577,0,0,0
19,45,1946,8,4,4
19,45,3093,5,4,1
19,45,2891,4,1,3
19,45,496,13,7,6
19,45,177,0,0,0
19,45,786,0,0,0
19,45,2317,26,10,16
19,45,970,1,0,1
19,45,788,2,2,0
19,45,1805,3,1,2
19,45,470,0,0,0
19,45,179,0,0,0
19,46,10173,33,13,20
19,46,936,8,4,4
19,46,2997,9,4,5
19,46,4770,4,3,1
19,46,246,4,2,2
19,46,271,0,0,0
19,46,1185,6,5,1
19,46,1456,1,1,0
19,47,2928,28,12,16
19,47,1690,4,1,3
19,47,3427,74,34,40
19,47,1817,27,10,17
19,47,1591,61,25,36
19,47,1428,14,10,4
19,47,1609,86,37,49
19,47,2336,35,16,19
19,47,3627,23,15,8
19,47,5120,22,11,11
19,47,1115,6,3,3
19,47,1627,43,21,22
19,47,1536,9,6,3
19,47,1599,9,4,5
19,47,1276,26,11,15
19,47,2402,12,5,7
19,47,2601,36,17,19
19,47,1842,8,3,5
19,47,1569,15,9,6
19,47,1469,7,3,4
19,47,1825,7,4,3
19,47,1547,20,9,11
19,47,1862,14,5,9
19,47,1486,10,6,4
19,47,525,3,1,2
19,47,2288,30,11,19
19,47,1728,35,16,19
19,47,2709,65,26,39
19,47,2124,14,6,8
19,47,1853,24,9,15
19,47,1605,313,158,155
19,47,1541,6,3,3
19,47,1568,8,1,7
19,47,2195,5,3,2
19,47,523,10,7,3
19,47,508,11,4,7
19,47,1743,11,3,8
19,47,208,2,0,2
19,47,355,3,1,2
19,47,749,2,1,1
19,47,494,0,0,0
19,47,600,8,4,4
19,47,1405,43,21,22
19,47,1559,16,9,7
19,47,1451,12,4,8
19,47,1182,4,2,2
19,47,1347,3,1,2
19,47,1653,8,6,2
19,47,1897,5,0,5
19,47,2005,7,4,3
19,47,1741,403,198,205
19,47,1696,611,314,297
19,47,1722,78,40,38
19,47,1611,27,12,15
19,47,2182,5,2,3
19,47,1554,96,46,50
19,47,619,1,1,0
19,47,771,10,7,3
19,47,1414,1,1,0
19,47,1412,17,13,4
19,47,1061,25,9,16
19,47,696,1,1,0
19,47,653,10,5,5
19,47,724,0,0,0
19,47,665,1,0,1
19,47,1206,23,8,15
19,47,1498,7,4,3
19,47,1019,3,2,1
19,47,855,34,19,15
19,47,1020,24,10,14
19,47,1725,49,25,24
19,47,1569,4,2,2
19,47,1581,13,8,5
19,47,1108,13,8,5
19,47,942,1,0,1
19,47,1258,9,5,4
19,47,1204,10,7,3
19,47,614,17,8,9
19,47,716,17,8,9
19,47,614,1,1,0
19,47,727,8,3,5
19,47,1303,5,2,3
19,47,614,0,0,0
19,47,2812,6,2,4
19,47,1673,9,3,6
19,47,990,2,2,0
19,47,1521,2,2,0
19,47,1489,7,2,5
19,47,1570,673,344,329
19,47,1792,6,2,4
19,47,1349,20,8,12
19,47,1833,19,9,10
19,47,1855,32,12,20
19,47,2044,23,5,18
19,47,2349,7,4,3
19,47,1863,80,40,40
19,47,3458,36,17,19
19,47,1591,2,1,1
19,47,1984,10,5,5
19,47,1953,389,197,192
19,47,1806,711,354,357
19,47,1663,31,13,18
19,47,1427,12,7,5
19,47,1388,5,3,2
19,47,1465,12,6,6
19,47,1179,30,14,16
19,47,1045,6,2,4
19,47,973,4,4,0
19,47,3877,59,32,27
19,47,1855,388,207,181
19,47,1042,13,4,9
19,47,650,16,7,9
19,47,707,195,93,102
19,47,2153,51,27,24
19,47,7625,50,19,31
19,47,2139,4,2,2
19,47,483,6,3,3
19,47,2057,5,1,4
19,47,1463,8,2,6
19,47,1658,3,2,1
19,47,1574,104,59,45
19,47,1769,21,9,12
19,47,1528,4,1,3
19,47,1672,6,1,5
19,47,2029,13,6,7
19,47,1870,39,20,19
19,47,1715,4,2,2
19,47,1962,13,8,5
19,47,1777,98,47,51
19,47,1438,15,9,6
19,47,3093,39,17,22
19,47,1826,63,34,29
19,47,2641,44,20,24
19,47,1320,5,3,2
19,47,1524,7,3,4
19,47,5475,76,39,37
19,47,4691,24,13,11
19,47,2060,15,8,7
19,47,1576,16,10,6
19,47,1171,26,14,12
19,47,4597,960,477,483
19,47,2695,8,2,6
19,47,2006,17,8,9
19,47,2021,18,11,7
19,47,1816,11,5,6
19,47,882,10,5,5
19,47,2239,74,35,39
19,47,1929,27,11,16
19,47,1946,10,7,3
19,47,1745,24,16,8
19,47,2502,19,11,8
19,47,133,0,0,0
19,47,396,7,2,5
19,47,943,107,58,49
19,47,717,9,7,2
19,47,617,11,6,5
19,47,1042,29,13,16
19,47,1569,3,3,0
19,47,1766,19,8,11
19,47,2290,43,22,21
19,47,1656,38,14,24
19,47,1054,3,0,3
19,47,1024,9,4,5
19,47,1522,6,2,4
19,47,1527,0,0,0
19,47,1616,105,55,50
19,47,1501,48,30,18
19,47,1443,12,5,7
19,47,1783,14,6,8
19,47,815,0,0,0
19,47,1086,6,3,3
19,47,1471,0,0,0
19,47,830,40,20,20
19,47,707,3,1,2
19,47,1452,20,12,8
19,47,1495,1,0,1
19,47,1559,1,0,1
19,47,853,5,3,2
19,47,503,8,5,3
19,47,1153,0,0,0
19,47,617,1,0,1
19,47,834,2,1,1
19,47,1715,30,16,14
19,47,1796,24,13,11
19,47,1513,10,4,6
19,47,1426,22,10,12
19,47,1007,7,5,2
19,47,878,6,3,3
19,47,535,3,1,2
19,47,697,2,1,1
19,47,558,22,13,9
19,47,798,13,5,8
19,47,1808,20,9,11
19,47,1710,8,5,3
19,47,1869,13,8,5
19,47,1629,5,1,4
19,47,3053,19,9,10
19,47,2324,13,5,8
19,47,2373,16,8,8
19,47,1519,18,10,8
19,47,3700,121,61,60
19,47,3546,16,7,9
19,47,5769,44,17,27
19,47,8689,108,53,55
19,47,1813,10,5,5
19,47,2807,12,6,6
19,47,1631,11,6,5
19,47,1600,18,16,2
19,47,1710,10,4,6
19,47,1835,17,9,8
19,47,1812,4,1,3
19,47,1461,4,2,2
19,47,1663,2,0,2
19,47,7345,44,19,25
19,47,1815,50,21,29
19,47,1791,8,4,4
19,47,4209,31,17,14
19,47,6308,103,62,41
19,47,1666,5,1,4
19,47,1807,23,11,12
19,47,844,3,2,1
19,47,970,11,6,5
19,47,2651,22,12,10
19,47,1690,19,6,13
19,47,1547,4,4,0
19,47,426,17,5,12
19,47,1104,8,4,4
19,47,1467,13,9,4
19,47,3339,8,3,5
19,47,1209,6,3,3
19,47,1126,12,8,4
19,47,837,8,5,3
19,47,1137,6,4,2
19,47,1478,65,30,35
19,47,891,55,27,28
19,47,2399,4,2,2
19,47,2036,12,3,9
19,47,1902,4,1,3
19,48,8045,57,30,27
19,48,10554,47,23,24
19,48,3277,17,5,12
19,48,18668,549,255,294
19,48,8156,193,85,108
19,48,2078,15,8,7
19,48,1768,6,4,2
19,48,13409,112,56,56
19,48,2224,18,6,12
19,48,5458,91,48,43
19,48,5885,99,47,52
19,48,2316,16,8,8
19,48,3107,8,3,5
19,48,1286,15,8,7
19,48,1708,125,63,62
19,48,2458,17,10,7
19,48,2218,13,5,8
19,48,1571,5,1,4
19,48,460,2,0,2
19,48,1829,30,15,15
19,48,4305,107,52,55
19,48,1216,27,15,12
19,48,1485,22,11,11
19,48,1231,475,233,242
19,48,770,77,40,37
19,48,618,159,92,67
19,48,759,10,5,5
19,48,895,1,0,1
19,48,1681,461,224,237
19,48,1559,67,32,35
19,48,1356,5,1,4
19,48,1457,12,8,4
19,48,1728,1,1,0
19,48,1604,10,5,5
19,48,1852,2,1,1
19,48,1804,23,5,18
19,48,1645,2,1,1
19,48,1708,1,1,0
19,48,1647,1,0,1
19,48,1876,107,50,57
19,48,4596,18,10,8
19,48,6162,67,35,32
19,48,5401,99,51,48
19,48,1044,26,11,15
19,48,1598,2,1,1
19,48,6706,53,27,26
19,48,2520,50,25,25
19,48,14936,166,86,80
19,48,5756,23,12,11
19,48,8010,27,13,14
19,48,2562,7,2,5
19,48,2212,9,4,5
19,48,1679,3,2,1
19,48,9865,258,133,125
19,48,1412,11,6,5
19,48,1378,22,8,14
19,48,1133,7,5,2
19,48,1070,8,3,5
19,48,2563,180,88,92
19,48,1306,8,4,4
19,48,2085,36,17,19
19,48,1542,4,4,0
19,48,918,11,4,7
19,48,1915,13,6,7
19,48,2137,34,17,17
19,48,2124,7,3,4
19,48,1967,5,3,2
19,48,1199,3,1,2
19,48,2489,29,18,11
19,48,1782,7,3,4
19,48,1758,13,6,7
19,48,2079,5,3,2
19,48,1199,7,4,3
19,48,3681,13,7,6
19,48,1613,1,0,1
19,48,2521,26,10,16
19,48,1598,2,1,1
19,48,2755,19,5,14
19,48,1489,12,7,5
19,48,6596,15,13,2
19,48,2472,53,25,28
19,48,4374,26,13,13
19,48,1160,8,4,4
19,48,1087,2,1,1
19,48,381,0,0,0
19,48,112,0,0,0
19,49,2413,73,38,35
19,49,1842,407,205,202
19,49,1879,77,43,34
19,49,516,63,34,29
19,49,487,3,2,1
19,49,1350,8,4,4
19,49,604,41,20,21
19,49,729,8,5,3
19,49,683,5,2,3
19,49,3852,370,172,198
19,49,2185,149,71,78
19,49,5654,654,332,322
19,49,2470,85,39,46
19,49,5089,280,147,133
19,49,330,19,6,13
19,49,5550,48,25,23
19,49,411,6,4,2
19,49,2710,9,3,6
19,49,3522,29,14,15
19,49,3203,29,12,17
19,49,2463,15,7,8
19,49,146,1,0,1
19,49,294,1,0,1
19,49,1075,3,1,2
19,49,758,22,12,10
19,50,405,2,1,1
19,50,171,0,0,0
19,50,32,1,0,1
19,50,116,1,0,1
19,50,453,0,0,0
19,50,154,1,0,1
19,50,224,3,0,3
19,51,1295,2,1,1
19,51,451,5,2,3
19,51,887,3,2,1
19,51,386,2,2,0
19,51,125,0,0,0
19,51,530,0,0,0
19,40,24457,101,53,48
19,40,3530,20,8,12
19,40,10703,141,73,68
19,40,2785,24,15,9
19,40,5410,10,3,7
19,40,6619,1134,579,555
19,40,6217,41,18,23
19,40,6497,66,31,35
19,40,8899,34,14,20
19,40,8446,30,12,18
19,40,19010,151,66,85
19,21,1683,6,3,3
19,21,1226,6,2,4
19,21,5151,1954,976,978
19,21,3809,480,236,244
19,21,2009,666,350,316
19,21,398,14,7,7
19,21,1232,32,11,21
19,21,1322,73,35,38
19,21,1166,0,0,0
19,21,1941,36,19,17
19,21,2065,6,3,3
19,21,10516,92,38,54
19,21,5417,98,46,52
19,21,1410,3,1,2
19,21,1448,4,2,2
19,21,1508,1,1,0
19,21,1084,1,0,1
19,21,1402,123,59,64
19,21,1754,222,107,115
19,21,1235,141,70,71
19,21,1187,1,0,1
19,21,1337,0,0,0
19,21,1562,16,10,6
19,21,1283,178,77,101
19,21,1401,6,3,3
19,21,1854,10,3,7
19,21,1251,48,21,27
19,21,1514,5,2,3
19,21,1412,0,0,0
19,6,1484,0,0,0
19,6,1125,32,12,20
19,6,1074,3,2,1
19,6,981,0,0,0
19,6,1901,12,9,3
19,6,1297,3,3,0
19,6,440,2,2,0
19,6,741,11,5,6
19,6,1629,17,6,11
19,6,1362,5,3,2
19,6,1042,0,0,0
19,6,2311,2,2,0
19,6,2046,2,1,1
19,6,1584,0,0,0
19,6,2362,121,56,65
19,6,1129,2,0,2
19,6,1881,6,1,5
19,6,1405,6,4,2
19,6,907,3,2,1
19,6,1440,0,0,0
19,6,615,1,0,1
19,6,377,1,1,0
19,6,1480,55,22,33
19,6,1503,17,8,9
19,6,1583,1,0,1
19,6,1457,6,3,3
19,6,1226,1,0,1
19,6,807,3,2,1
19,6,1099,18,10,8
19,6,1371,7,5,2
19,6,12194,585,276,309
19,6,3003,42,20,22
19,6,6287,44,19,25
19,6,5478,96,42,54
19,6,3082,38,20,18
19,6,1501,38,17,21
19,6,2292,98,48,50
19,6,971,15,9,6
19,6,1274,8,2,6
19,6,462,11,5,6
19,6,1215,10,3,7
19,6,2552,42,21,21
19,6,904,22,10,12
19,6,2011,63,36,27
19,6,2039,24,14,10
19,6,1567,15,6,9
19,6,2024,7,2,5
19,6,3044,14,5,9
19,6,2752,16,5,11
19,6,2422,8,4,4
19,6,2516,14,8,6
19,6,809,20,14,6
19,6,1660,5,2,3
19,6,2210,4,1,3
19,6,1852,11,5,6
19,6,1104,26,13,13
19,6,1157,13,6,7
19,6,1189,13,6,7
19,6,927,1,1,0
19,6,1675,23,10,13
19,6,1596,23,12,11
19,6,1437,3,1,2
19,6,2134,4,1,3
19,6,1543,1,1,0
19,6,2625,333,161,172
19,6,999,2,0,2
19,6,971,8,5,3
19,6,1635,24,11,13
19,6,4392,66,35,31
19,6,1857,90,45,45
19,6,2223,16,10,6
19,6,1059,3,0,3
19,6,2044,20,8,12
19,6,2169,79,35,44
19,6,2023,89,46,43
19,6,744,1,0,1
19,6,1250,10,7,3
19,6,1690,34,16,18
19,6,1586,23,13,10
19,6,1831,16,8,8
19,6,1058,7,3,4
19,6,562,5,3,2
19,6,486,5,4,1
19,6,821,3,2,1
19,6,1911,0,0,0
19,6,1638,21,12,9
19,6,1274,6,4,2
19,6,2241,17,7,10
19,6,1431,12,6,6
19,6,1330,9,4,5
19,6,646,13,4,9
19,6,1160,15,6,9
19,6,1677,10,7,3
19,6,1507,11,4,7
19,6,954,3,3,0
19,6,984,0,0,0
19,6,1541,3,1,2
19,6,1705,6,5,1
19,6,1605,23,9,14
19,6,1258,6,2,4
19,6,1726,3,2,1
19,6,937,3,2,1
19,6,1053,9,4,5
19,6,1416,26,11,15
19,6,1587,23,10,13
19,6,697,0,0,0
19,6,1601,9,2,7
19,6,5515,266,127,139
19,18,4768,14,8,6
19,18,8772,172,80,92
19,18,3243,35,21,14
19,18,2037,41,17,24
19,18,2933,38,18,20
19,18,2163,121,54,67
19,18,4259,115,47,68
19,18,1720,7,3,4
19,18,634,4,1,3
19,18,788,6,3,3
19,18,489,0,0,0
19,18,928,1,1,0
19,18,372,26,13,13
19,18,3045,19,9,10
19,18,1262,12,6,6
19,18,923,11,5,6
19,18,1272,12,6,6
19,18,811,9,4,5
19,18,1177,5,1,4
19,18,1264,62,32,30
19,18,896,0,0,0
19,18,1076,0,0,0
19,18,4545,6,3,3
19,18,1255,4,1,3
19,18,1120,9,6,3
19,18,1068,2,2,0
19,18,1337,2,1,1
19,18,2005,11,3,8
19,18,3261,13,5,8
19,18,4012,4,1,3
19,18,1433,6,4,2
19,18,2805,23,15,8
19,18,23792,288,135,153
19,32,9006,428,221,207
19,32,644,1,0,1
19,32,1433,9,3,6
19,32,3630,11,6,5
19,32,625,3,1,2
19,32,558,18,8,10
19,32,246,1,0,1
19,32,840,90,48,42
19,32,235,63,33,30
19,32,1455,546,270,276
19,32,363,10,5,5
19,32,3937,23,9,14
19,32,2261,3,1,2
19,32,2165,12,5,7
19,32,1116,0,0,0
19,32,861,0,0,0
19,32,491,0,0,0
19,32,908,1,0,1
19,32,925,67,33,34
19,32,1578,7,2,5
19,32,2533,11,6,5
19,32,18259,103,39,64
19,32,565,3,0,3
19,32,732,0,0,0
19,32,553,7,2,5
19,32,454,0,0,0
19,32,7337,144,58,86
19,32,2012,7,4,3
19,32,1212,3,1,2
19,32,3406,8,4,4
19,32,1131,7,5,2
19,32,1158,0,0,0
19,32,722,5,1,4
19,32,1041,11,5,6
19,32,946,4,1,3
19,32,9108,80,42,38
19,32,1047,35,16,19
19,32,785,35,18,17
19,32,1106,3,1,2
19,32,1124,6,3,3
19,32,2319,6,3,3
19,32,2065,24,12,12
19,32,1718,40,24,16
19,32,1247,5,2,3
19,32,12934,76,35,41
19,32,2061,40,18,22
19,32,753,8,3,5
19,32,2008,17,9,8
19,32,1760,46,22,24
19,32,1599,12,5,7
19,32,6699,124,59,65
19,32,565,2,1,1
19,32,2763,31,15,16
19,32,2941,11,6,5
19,32,3724,67,35,32
19,32,3313,135,70,65
19,32,1659,10,4,6
19,32,1041,2,1,1
19,32,1922,11,4,7
19,32,1098,3,0,3
19,32,1407,3,2,1
19,32,1033,3,1,2
19,32,1404,9,5,4
19,32,1124,3,1,2
19,32,2569,6,4,2
19,32,2442,15,4,11
19,32,1663,4,1,3
19,32,6147,121,57,64
19,32,3435,37,18,19
19,32,1316,28,13,15
19,32,749,2,0,2
19,32,491,1,1,0
19,32,16314,173,92,81
19,32,1318,3,2,1
19,32,1009,40,20,20
19,32,852,1,0,1
19,32,1059,9,3,6
19,32,1018,2,1,1
19,32,1716,2,0,2
19,32,1480,19,11,8
19,32,5516,12,8,4
19,32,676,2,1,1
19,32,1679,6,3,3
19,32,1530,14,7,7
19,32,11821,260,127,133
19,32,2133,1,1,0
19,32,1396,2,2,0
19,32,1296,2,1,1
19,32,1735,3,1,2
19,32,1543,6,2,4
19,32,2216,4,2,2
19,32,4484,3,1,2
19,32,1627,8,4,4
19,32,1527,12,6,6
19,32,1185,2,0,2
19,32,3360,24,14,10
19,32,5631,313,157,156
19,32,4711,20,8,12
19,32,9508,79,38,41
19,32,3582,40,22,18
19,38,2333,9,2,7
19,38,1400,9,4,5
19,38,1247,3,2,1
19,45,1951,3,1,2
19,45,1132,0,0,0
19,45,1813,6,4,2
19,45,2181,1,1,0
19,45,736,0,0,0
19,6,1680,27,14,13
19,6,1671,11,6,5
19,6,1294,12,5,7
19,6,1316,21,14,7
19,6,1639,16,6,10
19,6,1318,1,0,1
19,6,1226,10,9,1
19,6,1386,3,2,1
19,6,1596,4,3,1
19,6,1634,6,3,3
19,6,2055,3,1,2
19,6,1319,0,0,0
19,6,1590,2,2,0
19,6,1416,3,2,1
19,6,1267,9,5,4
19,6,1236,14,7,7
19,6,977,3,2,1
19,6,911,6,3,3
19,6,868,6,5,1
19,6,1373,68,35,33
19,6,1374,3,2,1
19,10,9532,45,17,28
19,6,321,8,5,3
19,6,1541,2,0,2
19,6,4420,22,10,12
19,6,1112,2,1,1
19,6,1281,4,1,3
19,6,825,3,2,1
19,6,315,2,2,0
19,6,272,0,0,0
19,6,891,10,3,7
19,6,1518,4,2,2
19,6,1256,7,4,3
19,6,100,0,0,0
19,6,1534,7,3,4
19,6,881,8,5,3
19,6,1093,29,16,13
19,6,1169,7,4,3
19,6,1000,4,3,1
19,6,2253,8,6,2
19,6,2196,4,1,3
19,6,1127,4,1,3
19,6,1423,2,0,2
19,6,709,2,1,1
19,6,793,8,2,6
19,6,2385,1,1,0
19,6,839,3,1,2
19,6,572,1,0,1
19,6,2038,8,4,4
19,6,734,0,0,0
19,6,653,1,0,1
19,6,2455,39,19,20
19,6,1779,16,9,7
19,6,838,3,2,1
19,6,4321,59,26,33
19,6,1920,19,9,10
19,6,1352,10,5,5
19,6,1326,8,5,3
19,6,3066,29,11,18
19,6,1256,18,7,11
19,6,1032,5,5,0
19,6,1009,14,8,6
19,6,760,11,6,5
19,6,1487,9,6,3
19,6,2056,20,7,13
19,6,1617,28,17,11
19,6,927,128,61,67
19,6,981,9,4,5
19,6,599,11,6,5
19,6,1783,11,5,6
19,6,867,3,0,3
19,6,1133,25,8,17
19,6,1281,5,3,2
19,6,1330,6,3,3
19,6,1245,1,1,0
19,6,1178,0,0,0
19,6,1209,16,6,10
19,6,1140,0,0,0
19,6,1238,124,57,67
19,6,1244,6,0,6
19,6,1363,4,1,3
19,6,1002,12,5,7
19,6,1271,6,2,4
19,6,1661,6,2,4
19,6,909,1,0,1
19,6,1580,1,0,1
19,6,1016,3,1,2
19,6,1008,0,0,0
19,6,907,1,0,1
19,6,1549,20,6,14
19,6,662,3,1,2
19,6,833,14,7,7
19,6,1053,1,1,0
19,6,1758,31,14,17
19,6,906,3,2,1
19,6,1165,5,4,1
19,6,843,2,2,0
19,6,1411,6,3,3
19,6,794,7,4,3
19,21,1249,11,7,4
19,21,1194,34,17,17
19,21,1237,10,6,4
19,21,753,0,0,0
19,21,919,1,0,1
19,21,875,1,0,1
19,21,752,4,1,3
19,21,899,4,2,2
19,21,1809,23,8,15
19,21,843,12,6,6
19,21,869,32,20,12
19,21,693,3,2,1
19,21,821,16,7,9
19,21,634,1,1,0
19,21,463,0,0,0
19,21,612,2,0,2
19,21,712,5,2,3
19,21,7991,115,56,59
19,21,1928,46,15,31
19,21,1271,13,10,3
19,21,2827,34,19,15
19,21,1014,4,0,4
19,21,1253,16,6,10
19,21,3907,50,24,26
19,21,1225,11,6,5
19,21,726,17,13,4
19,21,228,0,0,0
19,21,1297,8,5,3
19,21,2762,43,23,20
19,21,1504,7,2,5
19,21,993,19,7,12
19,21,1517,33,14,19
19,18,5226,113,54,59
19,18,7818,84,38,46
19,18,18236,411,197,214
19,18,3423,155,76,79
19,18,762,1,0,1
19,18,6861,367,165,202
19,18,979,48,26,22
19,18,1126,8,5,3
19,18,1320,18,7,11
19,18,830,6,2,4
19,18,10661,752,365,387
19,18,912,56,30,26
19,18,932,0,0,0
19,18,1168,24,10,14
19,18,3530,160,78,82
19,18,781,4,2,2
19,18,719,1,0,1
19,18,753,15,6,9
19,18,653,3,1,2
19,18,473,3,1,2
19,18,1674,1,0,1
19,18,1287,3,3,0
19,18,7240,189,91,98
19,18,369,6,2,4
19,18,1323,40,19,21
19,18,535,0,0,0
19,18,1474,470,226,244
19,18,918,2,2,0
19,18,3896,76,39,37
19,18,859,19,12,7
19,18,1317,7,3,4
19,18,465,2,2,0
19,18,402,0,0,0
19,18,1665,17,10,7
19,18,873,0,0,0
19,18,425,3,2,1
19,18,2042,11,7,4
19,18,704,1,1,0
19,18,4804,38,19,19
19,18,337,0,0,0
19,18,685,30,11,19
19,18,667,3,2,1
19,18,703,0,0,0
19,18,510,0,0,0
19,18,3931,14,3,11
19,18,4050,21,14,7
19,18,1953,170,89,81
19,18,3336,68,31,37
19,18,577,0,0,0
19,18,1188,32,16,16
19,18,1019,20,9,11
19,18,19629,336,165,171
19,18,1484,88,47,41
19,18,737,2,2,0
19,18,1152,5,3,2
19,18,1262,8,4,4
19,18,1073,4,2,2
19,18,1192,26,13,13
19,18,981,19,9,10
19,18,661,0,0,0
19,18,996,6,3,3
19,18,1439,0,0,0
19,18,387,4,4,0
19,18,620,3,1,2
19,18,700,2,2,0
19,18,1324,6,4,2
19,18,1230,1,0,1
19,18,4451,41,19,22
19,18,793,3,2,1
19,18,1410,14,6,8
19,18,1398,7,3,4
19,18,2956,23,9,14
19,25,3102,49,28,21
19,25,3889,96,40,56
19,25,1616,13,4,9
19,25,2223,177,91,86
19,25,1915,56,26,30
19,25,1466,5,3,2
19,25,1485,19,6,13
19,25,1163,11,4,7
19,25,1009,52,23,29
19,25,1261,19,10,9
19,25,1748,9,3,6
19,25,1585,23,11,12
19,25,1181,1,1,0
19,25,963,2,1,1
19,25,2034,16,6,10
19,25,1691,7,5,2
19,25,1566,0,0,0
19,25,1083,0,0,0
19,25,1114,4,2,2
19,25,1102,18,9,9
19,25,1042,11,3,8
19,25,1591,16,10,6
19,25,908,4,1,3
19,25,1355,2,1,1
19,25,1112,3,2,1
19,25,1007,0,0,0
19,25,793,2,1,1
19,25,1154,59,24,35
19,25,1079,1,0,1
19,25,1256,6,3,3
19,25,1756,16,7,9
19,25,375,8,3,5
19,25,1272,2,0,2
19,25,1117,6,4,2
19,25,962,0,0,0
19,25,1424,1,0,1
19,25,1003,5,3,2
19,25,1343,8,6,2
19,25,563,3,2,1
19,25,1587,0,0,0
19,25,590,9,3,6
19,25,91,0,0,0
19,32,25890,617,306,311
19,32,3603,70,40,30
19,32,1818,10,4,6
19,32,7080,905,453,452
19,32,1283,7,7,0
19,32,1619,39,20,19
19,32,1869,26,11,15
19,32,1545,14,4,10
19,32,2381,63,32,31
19,32,2156,1,1,0
19,32,3608,44,22,22
19,32,3070,30,14,16
19,32,1592,10,7,3
19,32,1507,10,4,6
19,32,1533,13,4,9
19,32,1980,6,2,4
19,32,830,12,6,6
19,32,547,18,10,8
19,32,2188,17,8,9
19,32,15013,231,111,120
19,32,3177,48,22,26
19,32,847,7,6,1
19,32,708,0,0,0
19,32,579,0,0,0
19,32,1689,204,113,91
19,32,953,1,0,1
19,32,1953,6,2,4
19,32,934,1,1,0
19,32,1647,1,1,0
19,32,978,4,3,1
19,32,1335,2,0,2
19,32,891,4,2,2
19,32,1392,17,7,10
19,32,949,0,0,0
19,26,1700,30,14,16
19,26,1570,17,6,11
19,26,1448,6,3,3
19,26,1629,13,6,7
19,26,2201,20,13,7
19,26,3578,10,3,7
19,26,1499,2,1,1
19,26,2511,22,13,9
19,26,2260,21,10,11
19,26,2206,4,2,2
19,26,1737,6,2,4
19,26,1954,22,14,8
19,26,1582,12,6,6
19,26,1400,22,12,10
19,26,2890,17,12,5
19,42,17957,814,390,424
19,42,5310,14,7,7
19,42,5040,46,25,21
19,42,3477,56,25,31
19,42,4281,19,7,12
19,40,1374,7,3,4
19,25,18984,332,156,176
19,32,106,1,0,1
19,40,188,36,15,21
19,40,382,36,23,13
19,40,372,7,2,5
19,9,8360,199,101,98
19,9,5990,61,30,31
19,9,6660,83,43,40
19,9,4639,55,23,32
19,9,3708,160,70,90
19,6,654,5,1,4
19,26,0,0,0,0
19,47,0,0,0,0
19,6,124,1,1,0
19,6,188,0,0,0
19,21,93,0,0,0
19,9,4814,12,7,5
19,9,851,4,2,2
19,9,5178,9,3,6
19,9,2003,13,8,5
19,9,4129,36,18,18
19,9,2982,25,15,10
19,9,4039,29,14,15
19,9,3259,36,17,19
19,9,3142,48,25,23
19,21,1242,1,0,1
19,21,6250,19,8,11
19,21,4246,14,3,11
19,21,3631,9,3,6
19,21,1397,4,1,3
19,21,3907,18,14,4
19,21,4194,25,9,16
19,21,3922,10,5,5
19,21,3687,27,14,13
19,21,2714,6,3,3
19,21,7280,147,81,66
19,21,2109,10,4,6
19,21,4867,259,118,141
19,21,6457,249,128,121
19,21,4228,78,37,41
19,21,3910,27,13,14
19,21,6260,615,306,309
19,21,2180,64,31,33
19,21,3318,15,5,10
19,21,3201,49,24,25
19,46,2857,8,3,5
19,46,3081,9,3,6
19,46,7340,74,35,39
19,46,5844,18,7,11
19,46,2849,16,7,9
19,46,4174,78,40,38
19,46,3099,25,12,13
19,46,18499,91,36,55
19,46,2707,38,20,18
19,46,3156,43,21,22
19,46,1530,5,1,4
19,46,1692,25,12,13
19,46,2289,22,13,9
19,46,2613,35,14,21
19,46,4280,18,7,11
19,46,5304,38,16,22
19,46,2978,10,3,7
19,46,4738,291,135,156
19,46,2530,70,44,26
19,48,6501,32,14,18
19,48,2413,32,15,17
19,48,4562,31,17,14
19,48,2433,9,5,4
19,48,2845,8,5,3
19,48,2629,64,27,37
19,48,3038,29,15,14
19,48,5603,59,28,31
19,48,1219,56,28,28
19,48,1859,118,52,66
19,48,3909,1186,567,619
19,48,4603,307,152,155
19,48,2194,20,9,11
19,40,4492,122,71,51
19,40,2518,16,10,6
19,40,6313,66,27,39
19,40,4001,17,5,12
19,40,3567,56,22,34
19,40,6901,101,52,49
19,40,4852,58,25,33
19,40,5390,153,72,81
19,40,2149,45,18,27
19,40,6625,25,13,12
19,21,4168,131,54,77
19,21,4369,86,39,47
19,21,3105,96,45,51
19,21,4139,2,1,1
19,21,5482,7,3,4
19,21,3798,510,240,270
19,21,4039,18,7,11
19,21,3674,7,4,3
19,21,6242,811,398,413
19,21,6030,24,11,13
19,21,4123,34,19,15
19,21,6073,22,8,14
19,21,4415,50,20,30
19,21,3123,66,37,29
19,18,5076,32,15,17
19,18,2584,23,9,14
19,18,2425,27,13,14
19,18,5850,30,11,19
19,18,5317,21,10,11
19,18,1468,3,2,1
19,18,2610,6,4,2
19,18,2647,4,3,1
19,18,2071,17,6,11
19,18,3749,14,9,5
19,18,3621,33,16,17
19,18,2827,21,6,15
19,18,3757,14,6,8
19,18,1332,8,3,5
19,18,6972,26,7,19
19,18,1962,9,5,4
19,18,4371,23,8,15
19,18,5889,27,10,17
19,18,2207,4,2,2
19,18,1963,11,4,7
19,18,3791,36,12,24
19,18,4775,39,20,19
19,18,5770,372,168,204
19,12,3710,47,17,30
19,12,526,2,1,1
19,12,1843,108,48,60
19,12,2287,1,0,1
19,12,2119,5,3,2
19,12,5093,31,14,17
19,12,4503,18,10,8
19,12,5188,54,27,27
19,12,3890,38,17,21
19,12,1286,57,27,30
19,12,1348,6,3,3
19,12,5351,62,30,32
19,12,2592,18,9,9
19,12,3668,53,23,30
19,12,4030,47,24,23
19,12,2854,61,25,36
19,32,974,4,1,3
19,32,5893,38,18,20
19,32,3557,10,6,4
19,32,2216,2,1,1
19,32,1317,13,7,6
19,32,4126,11,7,4
19,32,6372,158,81,77
19,32,2707,9,5,4
19,32,2067,18,7,11
19,32,3175,252,137,115
19,32,3735,57,28,29
19,32,640,1,1,0
19,32,619,0,0,0
19,32,2818,30,17,13
19,32,2489,172,72,100
19,32,3444,11,2,9
19,32,3199,64,28,36
19,32,2719,70,27,43
19,32,3844,25,14,11
19,32,4383,13,2,11
19,32,5253,101,50,51
19,42,970,0,0,0
19,42,1999,4,4,0
19,42,1860,9,5,4
19,42,1215,8,3,5
19,42,3320,5,4,1
19,42,4256,9,4,5
19,42,3407,8,3,5
19,42,2341,11,3,8
19,42,2332,7,3,4
19,42,3886,42,23,19
19,42,4657,39,14,25
19,42,3151,63,32,31
19,42,1647,33,13,20
19,42,3354,23,9,14
19,42,1210,13,4,9
19,26,2181,16,9,7
19,26,3069,31,14,17
19,26,3316,32,14,18
19,26,3266,35,18,17
19,26,2897,27,10,17
19,26,2513,116,42,74
19,9,3355,34,12,22
19,9,3586,86,43,43
19,9,4226,87,39,48
20,1,849,1,0,1
20,2,925,12,9,3
20,2,2537,19,9,10
20,2,2504,25,13,12
20,2,916,7,3,4
20,2,2159,9,4,5
20,2,1264,7,2,5
20,2,1544,6,2,4
20,2,2030,19,10,9
20,2,1820,8,4,4
20,2,2245,6,0,6
20,2,2029,1,1,0
20,2,844,32,14,18
20,2,1059,20,11,9
20,2,1122,1,1,0
20,2,441,6,2,4
20,2,1714,8,5,3
20,2,466,2,1,1
20,2,77,0,0,0
20,2,899,61,33,28
20,2,1734,13,8,5
20,2,735,0,0,0
20,2,26,3,2,1
20,2,1694,7,5,2
20,2,1115,5,3,2
20,2,1380,2,0,2
20,2,1140,12,8,4
20,2,973,13,5,8
20,2,1360,0,0,0
20,2,1373,1,1,0
20,2,2638,3,2,1
20,2,954,4,3,1
20,2,1911,2,2,0
20,2,1591,2,0,2
20,3,1851,45,27,18
20,3,2637,102,57,45
20,386,2546,78,38,40
20,386,1692,105,55,50
20,4,1210,0,0,0
20,4,423,0,0,0
20,4,905,0,0,0
20,5,1107,15,10,5
20,6,894,4,1,3
20,6,1106,4,2,2
20,6,820,15,10,5
20,6,1191,14,8,6
20,6,1993,28,11,17
20,6,1108,2,0,2
20,6,1292,128,65,63
20,6,837,3,0,3
20,6,1277,378,193,185
20,6,1089,63,28,35
20,6,1393,48,28,20
20,6,1107,16,10,6
20,6,204,4,2,2
20,6,1032,21,9,12
20,7,5536,281,150,131
20,7,4547,43,22,21
20,7,2814,30,11,19
20,7,4679,171,94,77
20,7,1041,131,70,61
20,7,768,6,3,3
20,7,505,4,1,3
20,7,569,19,9,10
20,8,1000,0,0,0
20,8,887,46,23,23
20,8,504,0,0,0
20,9,432,2,2,0
20,9,302,26,11,15
20,10,2194,6,1,5
20,10,987,1,0,1
20,10,1364,15,10,5
20,10,329,0,0,0
20,11,2185,7,6,1
20,11,2323,22,11,11
20,11,1662,0,0,0
20,12,2809,151,77,74
20,12,1082,68,33,35
20,12,2374,69,37,32
20,12,1520,26,11,15
20,12,370,13,9,4
20,12,1348,2,1,1
20,12,727,0,0,0
20,12,1340,27,14,13
20,12,533,8,3,5
20,12,1307,135,69,66
20,13,745,4,1,3
20,13,152,12,5,7
20,13,21,0,0,0
20,14,2847,199,108,91
20,14,2202,10,4,6
20,14,290,1,0,1
20,14,688,8,5,3
20,14,474,3,1,2
20,14,2694,42,24,18
20,14,2165,5,2,3
20,15,1588,40,19,21
20,15,2272,39,19,20
20,15,1325,32,14,18
20,15,1521,55,27,28
20,15,1360,104,51,53
20,15,1641,48,26,22
20,15,1643,19,12,7
20,16,1958,28,16,12
20,16,1442,15,6,9
20,16,2043,8,4,4
20,16,1414,7,5,2
20,16,337,0,0,0
20,16,1005,1,1,0
20,16,721,0,0,0
20,17,1529,54,26,28
20,17,1514,42,21,21
20,18,1736,0,0,0
20,18,3004,6,3,3
20,18,977,1,0,1
20,18,215,1,1,0
20,19,2395,4,2,2
20,19,435,0,0,0
20,19,2805,3,1,2
20,19,3631,4,2,2
20,20,1155,21,14,7
20,20,511,2,0,2
20,20,1197,1,1,0
20,20,777,2,1,1
20,21,296,0,0,0
20,21,337,0,0,0
20,22,1119,304,148,156
20,22,705,70,32,38
20,22,155,0,0,0
20,22,775,2,2,0
20,23,4447,59,33,26
20,23,909,0,0,0
20,23,904,6,4,2
20,24,1169,12,9,3
20,24,1706,9,4,5
20,24,4311,24,10,14
20,24,883,9,5,4
20,24,856,6,5,1
20,24,1925,27,13,14
20,24,661,5,3,2
20,24,977,4,1,3
20,24,641,1,1,0
20,24,1452,24,11,13
20,25,454,54,32,22
20,25,258,0,0,0
20,25,92,0,0,0
20,26,3868,49,29,20
20,26,8598,211,110,101
20,26,2897,73,36,37
20,26,2031,32,17,15
20,26,4839,146,76,70
20,26,2642,48,25,23
20,27,1634,66,34,32
20,27,281,0,0,0
20,27,1294,2,0,2
20,27,498,3,1,2
20,28,4001,107,59,48
20,28,2953,7,6,1
20,28,1383,41,24,17
20,28,2656,97,51,46
20,28,1976,11,5,6
20,28,302,3,2,1
20,28,296,1,0,1
20,28,681,1,0,1
20,28,162,0,0,0
20,28,1479,10,6,4
20,28,754,394,197,197
20,28,795,0,0,0
20,28,655,86,46,40
20,28,876,6,2,4
20,28,456,3,2,1
20,28,410,0,0,0
20,28,1703,23,8,15
20,28,384,3,3,0
20,28,361,0,0,0
20,29,1834,4,2,2
20,29,96,0,0,0
20,29,494,0,0,0
20,29,1205,127,63,64
20,30,1043,17,7,10
20,30,1065,24,13,11
20,30,1433,88,46,42
20,30,1377,102,50,52
20,30,1237,46,20,26
20,30,1049,123,67,56
20,30,1341,58,24,34
20,31,538,15,7,8
20,31,566,2,1,1
20,32,445,4,1,3
20,32,338,0,0,0
20,32,656,0,0,0
20,33,3636,121,61,60
20,34,604,30,10,20
20,35,2044,5,3,2
20,35,1390,1,1,0
20,35,1134,8,5,3
20,35,651,1,0,1
20,36,2898,87,45,42
20,36,470,2,1,1
20,36,1106,3,2,1
20,37,5110,270,164,106
20,37,3973,125,64,61
20,37,4409,136,67,69
20,37,2530,47,23,24
20,37,1805,142,81,61
20,37,2672,22,12,10
20,37,2904,50,27,23
20,37,5040,86,44,42
20,37,1787,12,4,8
20,37,985,38,24,14
20,37,531,45,22,23
20,37,1240,29,19,10
20,37,870,3,3,0
20,37,3198,70,35,35
20,37,652,11,7,4
20,37,4084,249,132,117
20,37,5426,64,32,32
20,37,5621,56,24,32
20,37,2730,113,61,52
20,37,5118,172,74,98
20,37,1781,51,21,30
20,37,1793,178,106,72
20,37,247,2,0,2
20,37,205,0,0,0
20,37,249,0,0,0
20,37,964,2,1,1
20,37,1207,55,26,29
20,37,119,0,0,0
20,37,283,1,0,1
20,37,3548,105,52,53
20,38,2794,17,7,10
20,38,761,0,0,0
20,38,1148,0,0,0
20,38,1716,38,26,12
20,39,2212,46,24,22
20,39,1389,6,4,2
20,39,1236,41,20,21
20,39,2637,15,7,8
20,39,1463,3,1,2
20,39,4904,58,29,29
20,39,763,0,0,0
20,39,785,15,10,5
20,39,1785,12,5,7
20,39,466,1,1,0
20,39,1165,3,2,1
20,39,1833,1,0,1
20,39,1832,1,1,0
20,39,346,0,0,0
20,39,2230,1,0,1
20,39,2517,89,51,38
20,39,989,117,61,56
20,39,2422,0,0,0
20,39,40,2,1,1
20,40,987,40,25,15
20,40,151,0,0,0
20,40,137,1,0,1
20,41,2518,249,129,120
20,41,986,63,38,25
20,41,826,11,6,5
20,41,1525,2,2,0
20,41,2166,11,7,4
20,41,848,1,1,0
20,41,1025,192,106,86
20,41,4777,289,138,151
20,41,735,17,8,9
20,41,836,35,16,19
20,41,946,55,24,31
20,41,1360,42,21,21
20,41,2682,48,23,25
20,41,1598,38,22,16
20,41,1553,43,22,21
20,41,1243,39,21,18
20,41,2411,249,125,124
20,41,43,0,0,0
20,42,1737,21,12,9
20,42,1901,92,49,43
20,42,1254,4,2,2
20,42,725,1,0,1
20,42,505,0,0,0
20,42,1279,5,1,4
20,42,1059,8,5,3
20,43,7838,201,121,80
20,43,7030,263,142,121
20,43,4461,118,51,67
20,43,1827,31,17,14
20,43,2001,47,20,27
20,43,1915,46,19,27
20,43,1569,18,6,12
20,43,1921,32,13,19
20,43,1190,26,14,12
20,43,1974,33,14,19
20,43,7125,261,131,130
20,43,1145,24,14,10
20,43,1191,28,17,11
20,43,820,7,4,3
20,43,499,12,7,5
20,43,1115,8,4,4
20,43,4705,71,32,39
20,43,1207,48,22,26
20,43,1476,23,19,4
20,43,1335,47,25,22
20,43,1441,12,5,7
20,43,595,11,7,4
20,43,1363,28,12,16
20,43,961,9,4,5
20,43,784,16,6,10
20,43,802,4,1,3
20,43,1488,16,9,7
20,43,1569,30,14,16
20,43,2025,17,10,7
20,43,1764,13,4,9
20,43,1230,4,0,4
20,43,1239,40,19,21
20,43,1698,74,36,38
20,43,860,15,6,9
20,43,636,1,1,0
20,43,9417,65,34,31
20,43,1776,19,13,6
20,43,2387,36,21,15
20,43,5297,143,71,72
20,43,1473,44,21,23
20,43,1006,90,52,38
20,43,2196,33,19,14
20,43,3175,71,43,28
20,43,1230,117,67,50
20,43,1313,51,27,24
20,43,927,14,8,6
20,43,2750,4,3,1
20,43,2937,18,11,7
20,43,775,4,3,1
20,44,1547,50,27,23
20,44,997,9,6,3
20,44,1806,40,20,20
20,44,1112,16,9,7
20,44,956,52,30,22
20,44,1158,68,29,39
20,44,1252,93,49,44
20,44,1076,21,12,9
20,44,3282,128,58,70
20,44,1213,6,2,4
20,44,818,8,7,1
20,44,693,43,22,21
20,44,1277,71,34,37
20,44,1601,65,31,34
20,44,1147,49,25,24
20,44,1297,43,24,19
20,44,535,16,9,7
20,44,1707,31,13,18
20,44,1466,46,23,23
20,44,1252,112,56,56
20,44,1125,38,24,14
20,44,1605,53,26,27
20,44,1829,77,37,40
20,44,1280,22,10,12
20,44,1806,779,388,391
20,44,620,39,18,21
20,44,1048,193,93,100
20,44,2316,23,12,11
20,44,735,17,11,6
20,44,1131,8,4,4
20,44,731,0,0,0
20,44,486,0,0,0
20,45,1477,15,8,7
20,45,5176,338,190,148
20,45,907,29,13,16
20,45,794,3,3,0
20,46,1259,23,11,12
20,46,507,1,1,0
20,46,753,63,40,23
20,46,489,4,3,1
20,47,789,106,56,50
20,48,1208,347,181,166
20,49,1661,6,4,2
20,49,1399,4,1,3
20,49,846,3,2,1
20,50,2015,4,3,1
20,50,2749,2,2,0
20,51,1417,6,4,2
20,51,1160,8,5,3
20,51,1983,19,11,8
20,51,168,0,0,0
20,51,158,0,0,0
20,51,667,1,1,0
20,52,1297,47,18,29
20,53,1682,14,8,6
20,54,404,2,1,1
20,55,1698,1,1,0
20,55,397,4,1,3
20,55,513,13,5,8
20,55,148,4,1,3
20,55,356,0,0,0
20,55,443,0,0,0
20,55,184,0,0,0
20,56,1446,1248,644,604
20,57,2158,31,15,16
20,57,1106,68,38,30
20,57,1556,39,21,18
20,57,2560,541,296,245
20,57,999,76,43,33
20,57,788,19,10,9
20,57,1179,8,5,3
20,57,1906,41,21,20
20,57,1156,77,44,33
20,57,1644,232,131,101
20,57,2488,149,76,73
20,57,2557,55,18,37
20,57,2593,11,6,5
20,57,2318,7,4,3
20,57,1102,6,2,4
20,57,2083,9,6,3
20,57,901,3,0,3
20,57,1297,1,1,0
20,57,2601,4,1,3
20,57,2224,4,0,4
20,57,1054,6,4,2
20,57,487,1,0,1
20,57,937,1,0,1
20,57,2827,71,47,24
20,57,677,7,3,4
20,58,3626,15,6,9
20,58,776,5,2,3
20,58,1007,1,1,0
20,58,1822,13,6,7
20,58,1582,5,3,2
20,58,739,5,2,3
20,58,1152,0,0,0
20,58,1041,2,1,1
20,58,645,2,0,2
20,58,213,0,0,0
20,59,2923,212,106,106
20,59,6814,200,49,151
20,59,2331,153,86,67
20,59,2215,101,53,48
20,59,2048,9,4,5
20,59,2766,25,16,9
20,59,4530,68,41,27
20,59,1737,36,22,14
20,59,3236,45,15,30
20,59,5719,100,53,47
20,59,2595,28,16,12
20,59,667,0,0,0
20,59,2428,10,4,6
20,59,1660,48,24,24
20,59,2438,2,1,1
20,59,2404,29,2,27
20,59,516,1,1,0
20,59,2022,6,1,5
20,59,684,5,3,2
20,59,644,8,3,5
20,59,1356,5,2,3
20,59,148,1,0,1
20,60,1799,18,10,8
20,60,1321,1,1,0
20,61,1638,3,2,1
20,61,0,0,0,0
20,62,487,37,20,17
20,63,2439,120,60,60
20,63,1745,65,30,35
20,64,950,0,0,0
20,64,2255,7,4,3
20,64,1160,1,0,1
20,64,742,0,0,0
20,64,780,5,2,3
20,64,1420,16,7,9
20,64,347,1,0,1
20,64,690,1,0,1
20,65,1688,79,38,41
20,66,8846,254,138,116
20,66,3338,140,71,69
20,66,2143,303,162,141
20,66,2281,19,14,5
20,66,2064,7,4,3
20,66,2199,72,41,31
20,66,3432,235,122,113
20,66,5310,233,135,98
20,66,2214,186,92,94
20,66,2157,93,47,46
20,66,4735,395,206,189
20,66,2039,39,18,21
20,66,1766,84,49,35
20,66,1537,111,64,47
20,66,1620,11,6,5
20,66,2365,20,14,6
20,66,2439,88,45,43
20,66,1848,93,53,40
20,66,1488,119,62,57
20,66,1679,61,31,30
20,66,1990,148,76,72
20,66,5588,418,236,182
20,66,2452,50,24,26
20,66,2259,57,32,25
20,66,1482,69,32,37
20,66,1413,71,32,39
20,66,1381,48,26,22
20,66,1442,59,29,30
20,66,5986,248,121,127
20,66,2127,40,18,22
20,66,3160,96,53,43
20,66,1083,24,16,8
20,66,1991,64,41,23
20,66,1561,76,41,35
20,66,1142,21,13,8
20,66,2184,59,31,28
20,66,1053,31,17,14
20,66,1287,26,10,16
20,66,1409,27,18,9
20,66,1435,45,28,17
20,66,1007,37,20,17
20,66,1915,49,25,24
20,66,1811,28,15,13
20,66,1072,43,24,19
20,66,1136,18,8,10
20,66,1436,64,44,20
20,66,1078,33,19,14
20,66,1276,22,12,10
20,66,1044,9,5,4
20,66,2180,35,19,16
20,66,1549,50,21,29
20,66,1171,79,44,35
20,66,5379,158,67,91
20,66,1057,37,21,16
20,66,999,5,3,2
20,66,1497,25,15,10
20,66,1915,60,32,28
20,66,841,33,19,14
20,66,879,28,14,14
20,66,565,15,9,6
20,66,669,11,7,4
20,66,290,17,10,7
20,66,989,52,26,26
20,66,1057,43,22,21
20,66,726,16,7,9
20,66,979,10,6,4
20,66,1182,25,12,13
20,66,1003,28,12,16
20,66,3545,65,34,31
20,66,3533,53,20,33
20,66,1192,34,17,17
20,66,1463,41,22,19
20,66,601,11,6,5
20,66,657,5,3,2
20,66,1078,16,8,8
20,66,640,19,7,12
20,66,364,3,1,2
20,66,321,21,14,7
20,66,820,42,27,15
20,66,1233,23,17,6
20,66,1694,71,39,32
20,66,770,10,6,4
20,66,620,10,4,6
20,66,590,12,5,7
20,66,1108,60,34,26
20,66,1114,27,13,14
20,66,2542,18,9,9
20,66,4124,133,65,68
20,66,1420,21,14,7
20,66,1324,12,8,4
20,66,890,6,2,4
20,66,942,10,3,7
20,66,1005,21,11,10
20,66,1100,14,7,7
20,66,833,15,5,10
20,66,961,38,19,19
20,66,915,19,11,8
20,66,873,36,20,16
20,66,461,21,11,10
20,66,422,43,23,20
20,66,410,11,8,3
20,66,1112,9,4,5
20,66,1582,91,36,55
20,66,2274,66,40,26
20,66,1709,28,16,12
20,66,2876,72,36,36
20,66,2384,9,5,4
20,66,1387,53,34,19
20,66,890,16,8,8
20,66,859,22,11,11
20,66,774,58,28,30
20,66,775,115,61,54
20,66,754,29,19,10
20,66,1144,61,35,26
20,66,1353,51,18,33
20,66,1140,20,9,11
20,66,946,42,22,20
20,66,1606,59,30,29
20,66,1165,24,11,13
20,66,1611,11,5,6
20,66,4972,49,28,21
20,66,2225,24,7,17
20,66,1253,12,4,8
20,66,2337,64,32,32
20,66,1599,62,35,27
20,66,645,72,40,32
20,66,721,41,20,21
20,66,1520,47,20,27
20,66,1333,78,47,31
20,66,1328,76,45,31
20,66,766,17,10,7
20,66,1000,68,38,30
20,66,1898,80,43,37
20,66,1173,87,48,39
20,66,1378,74,41,33
20,66,800,37,21,16
20,66,4549,290,144,146
20,66,920,35,21,14
20,66,1319,50,26,24
20,66,1178,70,38,32
20,66,1068,97,46,51
20,66,1087,58,29,29
20,66,1596,67,38,29
20,66,8459,137,66,71
20,67,1684,28,18,10
20,67,2639,33,19,14
20,67,2490,23,10,13
20,67,3361,28,16,12
20,67,2086,26,9,17
20,67,2744,35,16,19
20,67,1883,8,3,5
20,67,921,9,7,2
20,67,411,4,2,2
20,67,1133,6,4,2
20,67,224,1,0,1
20,67,593,4,1,3
20,67,216,0,0,0
20,67,1870,2,2,0
20,67,393,0,0,0
20,68,3154,68,34,34
20,69,1442,86,45,41
20,69,1216,40,21,19
20,69,1032,8,3,5
20,69,1137,9,6,3
20,69,1611,26,10,16
20,70,2339,6,3,3
20,70,543,26,13,13
20,70,363,0,0,0
20,70,630,26,15,11
20,71,2789,104,59,45
20,71,4691,160,80,80
20,71,5553,139,72,67
20,71,1439,58,27,31
20,71,283,27,17,10
20,71,2523,718,375,343
20,71,1307,96,51,45
20,71,1386,15,10,5
20,71,1223,9,5,4
20,71,975,8,4,4
20,71,122,0,0,0
20,71,2258,11,4,7
20,71,1382,62,31,31
20,71,1376,224,114,110
20,71,2027,61,33,28
20,71,388,9,6,3
20,71,1648,42,21,21
20,71,1169,4,2,2
20,72,1340,9,6,3
20,72,1306,25,10,15
20,73,1698,159,70,89
20,73,1172,70,42,28
20,73,744,42,22,20
20,74,2521,12,7,5
20,74,1643,36,20,16
20,75,1682,16,10,6
20,76,4371,90,46,44
20,76,1989,7,3,4
20,76,2424,45,17,28
20,76,1824,54,22,32
20,76,2031,37,18,19
20,76,1335,40,25,15
20,76,1896,41,19,22
20,76,2426,42,19,23
20,76,2911,17,10,7
20,76,1756,1,0,1
20,76,1309,5,1,4
20,76,2053,28,10,18
20,76,3532,33,15,18
20,76,2653,17,7,10
20,76,1980,50,22,28
20,76,4224,24,11,13
20,76,2002,8,5,3
20,76,1455,46,25,21
20,76,1393,4,2,2
20,76,571,19,8,11
20,76,1378,30,12,18
20,76,1234,26,16,10
20,76,2371,28,13,15
20,76,868,5,2,3
20,76,1268,2,2,0
20,76,763,1,0,1
20,76,1838,113,47,66
20,76,213,1,0,1
20,76,1513,27,15,12
20,76,1152,2,0,2
20,76,1402,9,4,5
20,76,1106,7,3,4
20,76,2130,22,10,12
20,76,594,29,9,20
20,76,419,0,0,0
20,76,1316,10,4,6
20,76,1104,2,1,1
20,76,3707,40,16,24
20,76,1285,2,1,1
20,77,778,5,1,4
20,77,815,23,12,11
20,78,1422,6,4,2
20,78,469,15,8,7
20,79,1631,16,6,10
20,79,1614,66,35,31
20,79,1314,347,175,172
20,80,5115,52,17,35
20,80,6104,109,61,48
20,81,2174,51,31,20
20,81,2228,66,34,32
20,82,880,12,5,7
20,82,4238,45,25,20
20,82,1945,80,37,43
20,82,1324,3,3,0
20,82,1644,7,4,3
20,82,1572,7,3,4
20,82,871,0,0,0
20,82,1943,6,3,3
20,82,1244,16,5,11
20,82,2121,1,0,1
20,82,2076,2,2,0
20,82,3251,147,88,59
20,82,2653,86,42,44
20,83,453,8,3,5
20,83,579,47,28,19
20,84,4103,40,22,18
20,84,1450,6,1,5
20,85,1274,21,13,8
20,85,200,0,0,0
20,85,1463,67,34,33
20,86,1784,44,22,22
20,86,429,7,3,4
20,86,95,0,0,0
20,87,2075,331,168,163
20,87,2192,291,142,149
20,87,1967,613,334,279
20,88,3547,149,79,70
20,88,2668,58,33,25
20,89,2104,19,10,9
20,90,518,4,3,1
20,91,1099,9,4,5
20,91,821,0,0,0
20,92,2676,204,112,92
20,92,1495,2,2,0
20,92,426,123,48,75
20,93,802,44,21,23
20,94,851,2,0,2
20,94,919,1,1,0
20,95,2787,4,3,1
20,95,1236,3,1,2
20,96,415,0,0,0
20,97,393,5,3,2
20,98,715,9,3,6
20,99,2125,127,62,65
20,99,3079,40,20,20
20,100,2131,9,5,4
20,100,1843,28,14,14
20,100,925,9,3,6
20,100,1731,24,11,13
20,101,1912,115,62,53
20,101,294,63,29,34
20,102,2832,61,30,31
20,102,855,4,1,3
20,102,2155,699,378,321
20,102,1831,29,18,11
20,103,249,90,41,49
20,104,6315,219,116,103
20,104,5747,201,99,102
20,104,4523,99,51,48
20,104,3558,170,97,73
20,104,6636,151,81,70
20,105,719,5,1,4
20,105,896,0,0,0
20,105,155,0,0,0
20,105,333,2,1,1
20,105,331,0,0,0
20,105,551,73,35,38
20,106,1393,27,16,11
20,107,1586,7,5,2
20,108,2971,119,50,69
20,108,1973,29,17,12
20,109,1236,0,0,0
20,109,1340,22,7,15
20,110,3174,16,9,7
20,111,273,0,0,0
20,111,189,0,0,0
20,111,212,0,0,0
20,112,2193,38,20,18
20,112,4781,77,40,37
20,112,4921,157,62,95
20,113,540,5,2,3
20,113,0,0,0,0
20,114,653,6,2,4
20,115,1855,11,5,6
20,115,1223,1,0,1
20,115,1053,151,76,75
20,116,1434,7,5,2
20,116,738,0,0,0
20,117,2346,27,18,9
20,118,735,4,2,2
20,119,475,2,2,0
20,120,809,153,82,71
20,120,1955,9,6,3
20,121,2773,18,5,13
20,121,3927,8,4,4
20,121,1851,9,5,4
20,121,1143,0,0,0
20,121,4940,31,16,15
20,122,1003,4,1,3
20,122,1420,0,0,0
20,122,443,2,0,2
20,122,1456,8,4,4
20,122,1811,175,86,89
20,122,805,2,2,0
20,122,1026,1,0,1
20,122,931,0,0,0
20,122,783,1,1,0
20,122,2276,9,3,6
20,123,2412,362,190,172
20,123,2241,760,397,363
20,123,180,0,0,0
20,123,558,0,0,0
20,124,1191,5,3,2
20,125,1331,4,3,1
20,126,334,4,3,1
20,127,2009,22,13,9
20,127,1356,6,2,4
20,127,1784,7,4,3
20,128,6116,29,16,13
20,128,834,8,6,2
20,128,258,5,2,3
20,128,556,0,0,0
20,128,3639,8,5,3
20,129,1473,14,7,7
20,130,1451,7,1,6
20,130,511,0,0,0
20,130,997,1,1,0
20,130,709,1,0,1
20,131,2868,15,9,6
20,131,776,0,0,0
20,131,3606,48,29,19
20,131,3719,25,10,15
20,131,1344,3,1,2
20,131,3438,250,137,113
20,131,1514,42,22,20
20,131,4564,31,14,17
20,131,1478,11,8,3
20,131,1238,5,2,3
20,131,2041,3,1,2
20,132,2299,12,6,6
20,132,1886,3,2,1
20,132,2521,6,4,2
20,132,1006,6,5,1
20,133,2797,2,2,0
20,133,3920,11,8,3
20,133,2742,4,2,2
20,133,2119,7,4,3
20,133,637,0,0,0
20,134,1594,13,1,12
20,134,490,1,0,1
20,134,1141,2,1,1
20,135,532,12,5,7
20,136,2210,24,10,14
20,137,817,0,0,0
20,138,3267,63,37,26
20,138,2567,10,4,6
20,138,940,1,0,1
20,138,313,0,0,0
20,138,886,3,0,3
20,139,831,0,0,0
20,140,1284,13,7,6
20,140,1711,16,7,9
20,140,1757,3,1,2
20,140,911,0,0,0
20,140,2229,25,13,12
20,140,606,10,4,6
20,140,1677,69,29,40
20,140,68,0,0,0
20,141,454,0,0,0
20,141,621,0,0,0
20,142,5061,170,88,82
20,143,1474,15,7,8
20,143,1329,3,2,1
20,144,376,0,0,0
20,145,1387,2,2,0
20,145,756,0,0,0
20,146,2214,3,1,2
20,147,2175,31,14,17
20,147,4425,42,25,17
20,147,2292,185,101,84
20,147,3660,289,145,144
20,147,0,0,0,0
20,147,1361,34,17,17
20,148,312,5,1,4
20,149,2956,55,28,27
20,150,734,10,5,5
20,150,1814,53,28,25
20,150,2594,111,54,57
20,151,996,16,5,11
20,151,813,3,1,2
20,152,1256,10,6,4
20,153,2209,171,86,85
20,153,1049,35,15,20
20,153,430,7,4,3
20,154,4405,101,51,50
20,154,4910,215,111,104
20,155,2233,10,4,6
20,156,2274,8,2,6
20,156,1001,2,0,2
20,156,2186,22,11,11
20,157,578,1,0,1
20,157,851,1,0,1
20,37,544,0,0,0
20,158,609,1,1,0
20,158,312,3,1,2
20,158,1324,0,0,0
20,158,353,10,5,5
20,159,1987,4,2,2
20,160,1296,0,0,0
20,160,281,1,0,1
20,161,1494,58,34,24
20,161,1079,40,19,21
20,161,1958,43,22,21
20,161,1393,9,4,5
20,162,1840,24,13,11
20,162,647,37,20,17
20,162,394,19,9,10
20,163,318,20,13,7
20,163,1226,3,1,2
20,164,2166,12,6,6
20,164,2314,4,2,2
20,164,773,3,3,0
20,164,2495,3,1,2
20,164,1567,25,14,11
20,164,1817,24,9,15
20,165,1625,17,8,9
20,165,442,1,0,1
20,166,932,760,386,374
20,167,1647,0,0,0
20,167,931,2,2,0
20,167,710,0,0,0
20,168,1178,2,1,1
20,168,444,3,2,1
20,168,1159,11,6,5
20,169,2156,165,80,85
20,169,2505,204,109,95
20,169,1480,5,2,3
20,169,1981,20,6,14
20,170,2974,159,72,87
20,170,435,1,1,0
20,170,209,0,0,0
20,170,738,0,0,0
20,170,978,7,2,5
20,170,662,2,1,1
20,170,820,0,0,0
20,170,672,8,4,4
20,170,1443,19,11,8
20,170,1470,14,5,9
20,170,1684,1,1,0
20,170,1030,1,1,0
20,170,134,0,0,0
20,170,150,1,0,1
20,170,1447,2,2,0
20,170,876,0,0,0
20,171,406,48,29,19
20,172,715,19,14,5
20,172,742,0,0,0
20,173,1438,4,3,1
20,174,905,1,1,0
20,174,588,10,6,4
20,174,525,5,2,3
20,174,674,2,1,1
20,175,1765,244,124,120
20,175,2447,172,85,87
20,175,1391,145,64,81
20,175,616,24,11,13
20,175,258,26,16,10
20,175,229,1,0,1
20,175,510,81,45,36
20,175,1097,166,83,83
20,175,714,0,0,0
20,175,679,225,119,106
20,175,314,10,6,4
20,175,297,13,7,6
20,175,50,1,1,0
20,176,755,2,1,1
20,176,2954,105,60,45
20,176,2565,10,2,8
20,177,1447,1,0,1
20,178,979,960,487,473
20,178,1388,1306,635,671
20,179,330,0,0,0
20,179,123,2,1,1
20,180,823,8,3,5
20,180,732,7,1,6
20,181,2087,72,41,31
20,182,9165,407,208,199
20,182,1475,6,4,2
20,182,1455,112,54,58
20,182,1374,166,83,83
20,182,1480,37,23,14
20,182,1791,41,19,22
20,182,1354,43,17,26
20,182,1734,15,8,7
20,182,6975,149,72,77
20,182,2187,99,55,44
20,182,2235,56,23,33
20,182,1102,72,41,31
20,182,2179,76,40,36
20,182,1717,50,27,23
20,182,1785,50,28,22
20,182,1465,88,47,41
20,182,1055,128,64,64
20,182,1073,176,90,86
20,182,1033,56,34,22
20,182,935,22,9,13
20,182,906,149,77,72
20,182,1048,122,72,50
20,182,708,170,92,78
20,182,1906,13,5,8
20,182,6082,123,70,53
20,182,1879,63,37,26
20,182,1903,104,56,48
20,182,2327,17,10,7
20,182,2342,81,35,46
20,182,2079,128,68,60
20,182,915,66,33,33
20,182,624,109,56,53
20,182,9824,120,61,59
20,182,1481,203,104,99
20,182,1796,84,44,40
20,182,1706,693,364,329
20,182,1152,73,40,33
20,182,898,74,38,36
20,182,3393,28,11,17
20,182,716,16,8,8
20,182,1219,17,9,8
20,182,1976,13,7,6
20,182,5008,127,59,68
20,182,6500,70,39,31
20,182,2159,11,7,4
20,182,3832,142,73,69
20,182,1462,99,44,55
20,182,1500,7,6,1
20,182,1025,71,32,39
20,182,2235,67,37,30
20,182,1478,2,2,0
20,182,1960,25,10,15
20,182,801,7,2,5
20,182,2839,10,5,5
20,182,2629,34,22,12
20,182,1178,17,5,12
20,182,1220,2,2,0
20,182,2076,33,18,15
20,182,4445,113,51,62
20,182,1803,53,23,30
20,182,764,3,1,2
20,182,2462,22,12,10
20,182,1248,2,0,2
20,182,1339,25,11,14
20,182,1410,10,3,7
20,182,1254,19,11,8
20,182,970,0,0,0
20,182,2017,3,1,2
20,182,2370,12,7,5
20,182,1401,10,5,5
20,182,1984,18,9,9
20,182,624,2,1,1
20,182,1656,25,9,16
20,183,2661,222,128,94
20,183,1537,113,54,59
20,183,1966,10,5,5
20,183,2295,31,15,16
20,183,1925,10,4,6
20,183,1657,82,41,41
20,183,1975,45,19,26
20,183,1623,13,8,5
20,183,1201,3,1,2
20,183,1106,23,13,10
20,183,1719,2,1,1
20,183,1710,5,4,1
20,183,787,394,215,179
20,183,625,0,0,0
20,183,649,65,36,29
20,184,1810,422,219,203
20,184,2481,387,198,189
20,184,1133,195,109,86
20,184,1597,465,224,241
20,184,733,62,35,27
20,184,680,2,1,1
20,184,404,210,97,113
20,185,305,5,3,2
20,186,1822,33,24,9
20,187,934,10,5,5
20,187,1245,167,79,88
20,188,524,0,0,0
20,189,1791,0,0,0
20,190,2811,209,104,105
20,190,1781,275,141,134
20,190,1852,67,37,30
20,190,1818,68,30,38
20,190,453,24,13,11
20,191,1443,2,1,1
20,191,1250,0,0,0
20,192,3446,5,2,3
20,192,2099,37,20,17
20,192,1438,138,64,74
20,192,1159,51,20,31
20,192,2038,10,5,5
20,192,5300,28,14,14
20,192,2193,3,3,0
20,192,2134,22,10,12
20,192,2163,32,20,12
20,192,296,1,1,0
20,193,1744,39,18,21
20,193,166,1,1,0
20,194,1301,9,6,3
20,194,1506,0,0,0
20,195,1377,19,7,12
20,196,342,0,0,0
20,196,1072,2,1,1
20,197,407,1,0,1
20,198,1978,5,4,1
20,198,1310,0,0,0
20,199,1138,6,2,4
20,199,1242,0,0,0
20,199,1472,4,3,1
20,199,1837,8,6,2
20,199,492,1,0,1
20,199,1346,1,0,1
20,199,815,1,0,1
20,199,770,1,0,1
20,199,925,0,0,0
20,199,1528,1,0,1
20,199,984,2,2,0
20,199,880,2,2,0
20,199,1603,2,2,0
20,199,813,0,0,0
20,199,873,0,0,0
20,199,1417,3,1,2
20,199,1392,0,0,0
20,199,1324,0,0,0
20,199,1294,10,7,3
20,199,1771,0,0,0
20,199,1395,1,0,1
20,199,1745,5,3,2
20,199,1346,0,0,0
20,200,272,0,0,0
20,200,222,4,1,3
20,201,816,3,2,1
20,201,585,2,0,2
20,201,790,1,0,1
20,201,1467,9,6,3
20,202,721,3,3,0
20,202,801,0,0,0
20,203,3015,183,95,88
20,203,1765,54,27,27
20,204,1237,2,2,0
20,204,968,11,7,4
20,204,858,3,2,1
20,204,462,2,2,0
20,205,634,0,0,0
20,206,2224,6,3,3
20,206,2532,16,6,10
20,206,2477,3,2,1
20,206,1569,6,2,4
20,206,1365,9,3,6
20,206,3568,2,1,1
20,206,3476,9,2,7
20,207,1299,126,62,64
20,207,2418,12,6,6
20,207,2477,10,7,3
20,207,3163,5,3,2
20,207,611,1,0,1
20,207,1409,4,1,3
20,207,1209,1,1,0
20,207,3666,135,63,72
20,207,1621,69,33,36
20,208,276,2,1,1
20,208,937,2,2,0
20,208,1230,10,5,5
20,208,249,0,0,0
20,208,240,2,1,1
20,208,659,0,0,0
20,208,1417,45,17,28
20,208,539,0,0,0
20,208,511,2,1,1
20,208,677,3,3,0
20,208,383,5,2,3
20,209,607,1,0,1
20,210,1119,1,1,0
20,210,1343,0,0,0
20,210,1001,1,1,0
20,210,1418,0,0,0
20,210,957,3,2,1
20,211,634,3,1,2
20,211,628,4,2,2
20,211,2200,7,2,5
20,212,1443,4,3,1
20,212,1674,0,0,0
20,213,2778,13,7,6
20,213,1425,72,40,32
20,214,1592,68,33,35
20,214,606,342,175,167
20,215,879,1,0,1
20,216,1216,1,0,1
20,217,737,17,11,6
20,217,1172,1,0,1
20,217,964,10,5,5
20,217,791,0,0,0
20,218,1648,6,4,2
20,219,1445,18,11,7
20,219,1223,8,1,7
20,220,482,1,0,1
20,220,1100,1,0,1
20,220,651,20,10,10
20,220,451,0,0,0
20,221,954,81,44,37
20,221,519,0,0,0
20,222,1082,12,5,7
20,222,344,2,2,0
20,223,440,6,5,1
20,224,652,19,11,8
20,225,1986,121,67,54
20,225,2573,411,200,211
20,225,1842,83,50,33
20,226,2448,23,10,13
20,226,530,2,2,0
20,227,4651,466,252,214
20,227,2565,68,34,34
20,227,4714,130,65,65
20,227,5209,117,68,49
20,227,2249,22,16,6
20,228,844,0,0,0
20,229,4769,10,7,3
20,229,4379,13,9,4
20,230,391,6,4,2
20,230,541,3,1,2
20,231,3187,16,5,11
20,232,1309,2,0,2
20,232,1943,4,2,2
20,232,834,2,1,1
20,232,2496,10,5,5
20,232,3425,51,27,24
20,232,3345,9,4,5
20,232,2030,4,1,3
20,232,1709,1,0,1
20,232,1291,1,1,0
20,232,1854,5,2,3
20,232,1962,2,0,2
20,232,1594,0,0,0
20,233,1714,1,0,1
20,234,1923,4,4,0
20,234,1400,6,2,4
20,234,1096,0,0,0
20,234,2496,9,5,4
20,235,782,5,2,3
20,235,834,36,17,19
20,235,1079,98,41,57
20,235,1149,4,2,2
20,236,820,2,1,1
20,236,499,0,0,0
20,237,796,84,47,37
20,237,566,13,6,7
20,37,713,0,0,0
20,237,347,1,0,1
20,238,1001,66,33,33
20,239,1015,3,1,2
20,240,2749,18,7,11
20,241,1136,29,17,12
20,242,2192,2,1,1
20,242,2717,9,5,4
20,242,2713,25,17,8
20,242,1026,4,3,1
20,242,3841,2,0,2
20,243,1966,2,1,1
20,244,2287,46,24,22
20,244,1538,7,2,5
20,245,796,0,0,0
20,245,528,0,0,0
20,246,611,21,9,12
20,247,3732,13,5,8
20,247,2779,2,1,1
20,247,2490,3,2,1
20,247,3563,48,22,26
20,247,3007,130,71,59
20,248,1120,6,3,3
20,249,1217,83,39,44
20,250,1365,37,20,17
20,250,0,0,0,0
20,251,1017,9,4,5
20,251,285,0,0,0
20,251,398,1,1,0
20,251,278,0,0,0
20,252,1639,175,87,88
20,252,817,1,0,1
20,252,806,4,2,2
20,252,1169,6,4,2
20,253,1977,41,22,19
20,254,229,0,0,0
20,255,1857,53,28,25
20,255,2281,35,20,15
20,256,1052,6,3,3
20,257,700,16,8,8
20,258,1804,0,0,0
20,258,304,0,0,0
20,259,1649,5,3,2
20,259,542,0,0,0
20,260,1894,3,3,0
20,260,1211,3,3,0
20,260,1371,21,11,10
20,260,836,0,0,0
20,260,185,0,0,0
20,260,301,4,1,3
20,260,4086,4,1,3
20,260,737,1,0,1
20,260,251,0,0,0
20,261,191,0,0,0
20,261,24,0,0,0
20,261,672,0,0,0
20,262,1449,16,7,9
20,262,498,12,6,6
20,263,1016,29,14,15
20,263,853,1,0,1
20,263,1240,29,11,18
20,263,534,1,1,0
20,263,1461,1,1,0
20,263,1519,2,1,1
20,264,1763,9,4,5
20,264,1009,3,1,2
20,265,1650,3,2,1
20,265,2126,19,10,9
20,265,851,13,5,8
20,265,1508,5,1,4
20,265,440,2,0,2
20,266,245,8,1,7
20,267,1244,499,277,222
20,268,854,47,20,27
20,268,1402,17,11,6
20,268,726,3,2,1
20,268,774,12,5,7
20,268,834,41,22,19
20,269,479,25,15,10
20,269,830,25,17,8
20,270,1162,10,4,6
20,270,2137,6,1,5
20,271,2426,7,5,2
20,271,3826,649,363,286
20,272,2463,14,6,8
20,272,2317,25,15,10
20,273,1266,6,3,3
20,274,2731,5,1,4
20,274,2998,0,0,0
20,274,1535,1,0,1
20,275,673,124,54,70
20,276,2825,32,20,12
20,276,1416,24,14,10
20,276,2097,45,28,17
20,276,973,24,9,15
20,276,1300,37,22,15
20,276,2444,16,8,8
20,276,526,0,0,0
20,276,2119,2,1,1
20,276,473,0,0,0
20,276,2074,7,5,2
20,276,1325,16,14,2
20,276,2276,61,31,30
20,276,1324,2,2,0
20,276,1773,8,3,5
20,276,1976,6,4,2
20,276,1144,0,0,0
20,276,1634,27,15,12
20,276,1518,1,0,1
20,276,1139,1,0,1
20,276,1404,1,0,1
20,276,1850,6,4,2
20,276,1925,6,4,2
20,276,1025,0,0,0
20,276,1740,0,0,0
20,277,1558,1,1,0
20,277,1376,2,0,2
20,278,1296,0,0,0
20,278,658,2,1,1
20,278,415,4,1,3
20,279,424,2,1,1
20,280,745,21,11,10
20,281,741,0,0,0
20,281,152,1,0,1
20,281,159,0,0,0
20,282,2228,10,5,5
20,282,913,3,1,2
20,283,2336,552,293,259
20,283,1261,463,231,232
20,284,735,0,0,0
20,284,1286,6,5,1
20,284,380,0,0,0
20,284,540,3,1,2
20,285,307,15,8,7
20,286,585,4,3,1
20,287,1207,0,0,0
20,288,996,58,30,28
20,289,1294,4,2,2
20,289,1260,4,3,1
20,289,1713,3,2,1
20,290,1505,9,4,5
20,291,3480,75,28,47
20,291,10243,515,262,253
20,291,3145,285,159,126
20,292,1505,24,14,10
20,292,1703,34,17,17
20,292,1467,27,14,13
20,292,2222,41,17,24
20,292,276,2,1,1
20,293,1944,56,30,26
20,293,1737,22,10,12
20,293,1683,38,16,22
20,293,1632,24,11,13
20,293,1237,66,35,31
20,293,1762,22,13,9
20,294,955,5,1,4
20,295,1313,6,4,2
20,295,1486,78,41,37
20,296,1791,1,0,1
20,296,1517,0,0,0
20,296,2240,31,16,15
20,296,2239,28,18,10
20,296,2954,44,23,21
20,296,332,0,0,0
20,296,674,0,0,0
20,296,1870,80,42,38
20,297,1125,4,2,2
20,298,2467,180,96,84
20,298,1836,175,105,70
20,298,2329,176,92,84
20,299,624,30,13,17
20,299,970,33,18,15
20,300,1359,18,12,6
20,300,2358,6,3,3
20,300,508,0,0,0
20,300,334,12,8,4
20,301,1000,4,0,4
20,302,568,0,0,0
20,302,148,1,0,1
20,303,2553,11,3,8
20,303,1866,36,17,19
20,304,2381,18,9,9
20,304,2494,1,1,0
20,305,1520,54,29,25
20,305,813,0,0,0
20,305,237,3,2,1
20,305,1601,6,3,3
20,305,541,3,0,3
20,305,2100,22,6,16
20,305,2921,19,8,11
20,306,3971,27,18,9
20,307,2123,22,12,10
20,307,1625,12,6,6
20,307,710,1,1,0
20,307,612,1,1,0
20,307,1066,3,1,2
20,307,1480,776,413,363
20,307,1019,500,252,248
20,307,1159,45,26,19
20,307,1836,6,3,3
20,308,3817,31,14,17
20,308,7599,182,95,87
20,309,483,2,2,0
20,310,1801,70,39,31
20,310,1449,46,28,18
20,310,1520,139,79,60
20,310,1532,12,6,6
20,310,1760,328,176,152
20,310,1500,28,11,17
20,310,1717,43,21,22
20,311,730,1,1,0
20,312,1572,16,9,7
20,313,1915,30,18,12
20,314,738,1,1,0
20,315,842,14,8,6
20,315,400,0,0,0
20,316,4393,521,267,254
20,316,4126,325,173,152
20,316,2880,98,49,49
20,316,2800,281,125,156
20,316,2403,190,94,96
20,316,17534,2570,1376,1194
20,316,979,45,22,23
20,316,4210,615,326,289
20,316,1821,70,31,39
20,316,1404,77,41,36
20,316,906,123,58,65
20,316,1857,386,209,177
20,316,3633,566,289,277
20,317,972,0,0,0
20,318,694,9,5,4
20,319,822,16,11,5
20,320,773,0,0,0
20,321,2404,6,4,2
20,322,4871,240,115,125
20,322,1870,39,21,18
20,322,4089,99,56,43
20,322,6530,219,109,110
20,322,1707,94,48,46
20,322,605,51,26,25
20,322,3660,604,314,290
20,322,53,1,1,0
20,322,22,0,0,0
20,322,1787,22,8,14
20,322,3845,14,10,4
20,322,1859,27,16,11
20,322,3561,178,92,86
20,322,2007,68,37,31
20,322,2534,13,4,9
20,322,2094,223,105,118
20,322,3177,222,97,125
20,322,2754,27,12,15
20,323,1026,6,3,3
20,323,1799,5,3,2
20,323,2478,13,7,6
20,323,1257,1,0,1
20,323,3009,4,3,1
20,323,3226,11,8,3
20,324,2565,11,4,7
20,324,1265,3,2,1
20,324,1222,9,3,6
20,325,1670,37,20,17
20,325,2076,41,22,19
20,325,1272,22,10,12
20,325,1405,27,14,13
20,325,1987,83,43,40
20,325,1997,55,25,30
20,325,3611,93,46,47
20,325,452,0,0,0
20,325,960,23,11,12
20,326,1441,2,1,1
20,327,1460,43,20,23
20,328,1910,182,84,98
20,328,2119,5,4,1
20,328,493,0,0,0
20,329,618,2,1,1
20,329,364,1,0,1
20,330,596,3,0,3
20,331,1702,15,8,7
20,331,813,5,0,5
20,331,779,45,17,28
20,332,1593,720,367,353
20,332,846,307,162,145
20,332,1826,894,460,434
20,332,1927,1310,674,636
20,332,2662,919,457,462
20,332,2921,1624,855,769
20,332,3976,1708,894,814
20,332,1477,821,412,409
20,332,2640,1449,752,697
20,332,2772,1116,583,533
20,332,2892,1368,727,641
20,332,3767,2278,1168,1110
20,332,4626,2708,1410,1298
20,332,2608,1299,667,632
20,332,2604,1435,729,706
20,332,1923,295,149,146
20,332,2088,555,276,279
20,332,1884,1064,517,547
20,332,1484,1361,659,702
20,332,2285,1489,730,759
20,332,2365,1208,602,606
20,333,2032,136,76,60
20,333,1059,65,37,28
20,333,1127,2,0,2
20,333,262,0,0,0
20,334,1724,126,61,65
20,334,1481,92,49,43
20,334,388,1,1,0
20,334,670,4,2,2
20,334,85,6,3,3
20,335,485,14,8,6
20,335,206,0,0,0
20,335,262,1,1,0
20,335,118,0,0,0
20,335,179,0,0,0
20,335,153,0,0,0
20,335,357,0,0,0
20,336,867,7,4,3
20,337,1288,112,54,58
20,337,94,0,0,0
20,338,241,0,0,0
20,339,3123,113,62,51
20,340,1664,17,5,12
20,341,1167,25,13,12
20,341,1826,20,10,10
20,342,1386,322,146,176
20,342,1085,437,221,216
20,342,521,216,127,89
20,342,1297,686,336,350
20,343,1542,9,4,5
20,344,1751,6,4,2
20,344,1976,7,4,3
20,344,1039,5,3,2
20,345,2110,42,18,24
20,345,2025,11,7,4
20,345,838,4,1,3
20,345,269,0,0,0
20,345,383,0,0,0
20,345,304,0,0,0
20,345,351,2,1,1
20,345,1299,19,10,9
20,345,753,2,1,1
20,346,2191,14,5,9
20,347,5437,83,45,38
20,347,2011,60,39,21
20,347,878,18,8,10
20,347,1291,112,65,47
20,347,1413,100,51,49
20,347,1445,43,21,22
20,347,3810,137,69,68
20,348,1609,6,4,2
20,348,925,2,0,2
20,349,804,1,1,0
20,350,1895,31,15,16
20,350,1617,0,0,0
20,351,3450,9,6,3
20,352,449,32,16,16
20,353,2406,7,5,2
20,354,1076,7,5,2
20,355,618,4,2,2
20,356,1312,2,1,1
20,356,867,1,0,1
20,357,848,6,2,4
20,358,1098,4,2,2
20,358,870,11,3,8
20,359,637,1,1,0
20,360,2300,101,59,42
20,360,1789,67,32,35
20,361,825,0,0,0
20,362,1394,53,29,24
20,363,926,0,0,0
20,363,664,66,33,33
20,363,304,0,0,0
20,363,766,5,3,2
20,364,4162,693,319,374
20,364,5474,537,275,262
20,364,2224,11,3,8
20,364,1297,440,229,211
20,364,2596,59,31,28
20,364,1478,31,15,16
20,364,1239,75,39,36
20,365,272,1,1,0
20,365,551,15,9,6
20,365,287,2,1,1
20,366,1180,24,15,9
20,366,2184,12,7,5
20,366,311,5,2,3
20,367,2571,110,58,52
20,367,2011,58,26,32
20,368,1017,29,15,14
20,368,1050,89,43,46
20,369,2189,40,21,19
20,370,456,0,0,0
20,371,662,11,6,5
20,372,458,0,0,0
20,372,528,29,19,10
20,373,614,7,4,3
20,373,76,0,0,0
20,373,693,2,1,1
20,374,403,8,6,2
20,375,1645,4,2,2
20,376,6959,332,171,161
20,376,1276,29,13,16
20,376,3926,95,55,40
20,376,1411,17,11,6
20,377,365,2,0,2
20,378,1549,65,30,35
20,378,838,0,0,0
20,378,1605,38,15,23
20,378,1059,2,1,1
20,378,1632,6,3,3
20,378,1598,12,7,5
20,378,1141,10,6,4
20,378,2171,11,6,5
20,379,1506,95,52,43
20,379,785,1,1,0
20,379,1324,10,5,5
20,380,3011,11,6,5
20,381,2242,20,9,11
20,382,1277,6,2,4
20,382,1153,3,1,2
20,382,510,1,0,1
20,383,1182,2,1,1
20,384,602,2,1,1
20,385,2033,17,8,9
20,385,2069,9,5,4
20,385,726,121,65,56
20,386,1453,4,3,1
20,386,1818,14,6,8
20,386,2151,32,12,20
20,386,2866,61,32,29
20,386,2960,43,29,14
20,386,4001,98,47,51
20,386,7118,94,43,51
20,386,3127,212,108,104
20,386,13426,805,413,392
20,386,4546,103,50,53
20,386,13549,609,315,294
20,386,5897,221,105,116
20,386,3457,167,92,75
20,386,4940,313,163,150
20,386,6978,272,146,126
20,386,10368,203,101,102
20,386,10413,476,253,223
20,386,2809,31,18,13
20,387,2466,529,275,254
20,387,1457,3,1,2
20,387,2110,0,0,0
20,387,2998,12,8,4
20,387,3436,71,37,34
20,387,708,0,0,0
20,387,2515,628,308,320
20,387,3389,5,2,3
20,388,1379,4,3,1
20,388,1223,61,29,32
20,388,342,43,17,26
20,389,2553,37,17,20
20,390,908,14,8,6
20,391,761,0,0,0
20,391,95,0,0,0
20,391,598,7,3,4
20,392,1246,23,13,10
20,392,2996,102,22,80
20,392,711,46,27,19
20,392,715,24,13,11
20,392,1320,55,32,23
20,392,4045,66,33,33
20,392,1580,29,14,15
20,392,1503,12,5,7
20,392,1546,65,32,33
20,392,1679,133,65,68
20,392,1455,60,31,29
20,392,1475,20,11,9
20,392,1908,24,10,14
20,392,2094,13,5,8
20,392,3230,45,25,20
20,392,3529,101,53,48
20,392,8541,400,211,189
20,392,1533,8,4,4
20,392,1250,7,4,3
20,392,1566,5,3,2
20,392,1023,3,2,1
20,392,3985,105,54,51
20,392,1328,21,12,9
20,393,890,2,2,0
20,393,2240,20,8,12
20,394,1289,30,15,15
20,394,953,3,1,2
20,394,1391,3,3,0
20,394,1933,7,4,3
20,394,1134,77,37,40
20,395,4162,82,38,44
20,396,95,0,0,0
20,397,1764,11,6,5
20,397,1032,3,3,0
20,398,907,70,34,36
20,398,722,167,98,69
20,399,2580,9,7,2
20,399,673,2,2,0
20,400,18680,651,361,290
20,400,5681,123,66,57
20,401,879,5,3,2
20,401,817,0,0,0
20,402,807,1,0,1
20,403,422,65,32,33
20,403,1229,51,27,24
20,403,164,0,0,0
20,404,2817,4,4,0
20,404,2323,1,0,1
20,404,2629,7,4,3
20,404,1929,4,1,3
20,404,1336,0,0,0
20,404,1795,1,0,1
20,404,1032,0,0,0
20,404,1267,10,2,8
20,404,329,2,2,0
20,404,1741,1,0,1
20,404,524,1,1,0
20,404,576,1,0,1
20,404,1304,4,4,0
20,404,1081,1,1,0
20,404,355,0,0,0
20,404,3498,2,0,2
20,404,789,0,0,0
20,405,2703,42,19,23
20,405,1732,27,11,16
20,405,1717,1,0,1
20,405,1928,18,7,11
20,405,390,0,0,0
20,405,870,9,5,4
20,406,2117,128,60,68
20,406,5359,640,318,322
20,406,2580,172,84,88
20,406,1040,64,30,34
20,406,4699,370,204,166
20,406,1424,13,9,4
20,406,1857,14,8,6
20,406,2677,83,49,34
20,406,3450,149,65,84
20,406,2386,88,36,52
20,407,1074,1001,517,484
20,408,3581,62,30,32
20,409,468,2,2,0
20,410,2523,95,49,46
20,410,1161,33,14,19
20,410,1749,85,45,40
20,410,2166,30,12,18
20,410,1638,22,13,9
20,411,1023,70,35,35
20,411,103,1,1,0
20,411,752,221,104,117
20,411,1321,11,6,5
20,412,865,10,8,2
20,413,2352,63,29,34
20,413,816,48,20,28
20,414,4048,37,23,14
20,414,7727,86,43,43
20,414,233,0,0,0
20,414,3152,46,26,20
20,414,8436,559,287,272
20,414,15605,1016,507,509
20,414,1838,104,52,52
20,414,3397,63,31,32
20,414,1278,71,40,31
20,415,2964,419,208,211
20,415,2727,419,211,208
20,415,1725,1644,829,815
20,415,2559,2412,1214,1198
20,415,1974,1831,903,928
20,416,2150,590,313,277
20,416,1276,113,61,52
20,416,1452,388,196,192
20,417,461,0,0,0
20,418,3303,36,16,20
20,418,1335,6,4,2
20,418,1444,25,11,14
20,418,503,0,0,0
20,418,1525,103,55,48
20,418,1803,31,20,11
20,419,1759,58,35,23
20,419,1456,23,13,10
20,419,2071,33,23,10
20,419,1809,7,5,2
20,419,2286,11,5,6
20,419,915,1,1,0
20,419,1738,28,21,7
20,420,592,48,26,22
20,421,1506,13,7,6
20,422,973,9,6,3
20,422,1724,12,4,8
20,422,1453,49,20,29
20,423,160,3,2,1
20,423,443,2,1,1
20,424,227,0,0,0
20,424,226,0,0,0
20,425,1063,4,3,1
20,425,397,0,0,0
20,425,623,2,1,1
20,425,586,0,0,0
20,425,1112,2,1,1
20,426,2058,45,21,24
20,427,977,62,27,35
20,427,1414,248,125,123
20,427,3118,77,42,35
20,427,1388,13,8,5
20,427,1693,110,55,55
20,427,2521,39,24,15
20,427,1494,67,36,31
20,427,1738,3,2,1
20,427,907,5,1,4
20,427,830,6,1,5
20,428,2150,58,27,31
20,428,1959,3,2,1
20,428,1338,4,2,2
20,428,1743,232,121,111
20,428,1406,14,7,7
20,429,2224,10,5,5
20,430,1661,0,0,0
20,431,627,0,0,0
20,432,2416,49,21,28
20,433,903,2,1,1
20,434,2870,1028,571,457
20,435,2163,44,24,20
20,435,1747,6,3,3
20,436,2484,31,15,16
20,436,1932,1,0,1
20,437,896,5,2,3
20,438,2684,3,1,2
20,438,2232,18,7,11
20,438,1684,1,1,0
20,438,2429,1,1,0
20,439,1796,120,60,60
20,440,3755,149,85,64
20,440,1636,18,10,8
20,440,1333,38,17,21
20,440,4183,30,13,17
20,440,2378,21,12,9
20,440,3038,50,24,26
20,440,3386,35,15,20
20,440,1959,32,17,15
20,441,812,16,8,8
20,442,2411,48,27,21
20,442,3082,541,271,270
20,442,1994,8,6,2
20,442,1665,69,34,35
20,443,250,1,0,1
20,444,434,0,0,0
20,445,735,7,5,2
20,446,1699,19,11,8
20,447,1981,450,235,215
20,447,2667,65,31,34
20,447,1316,1,1,0
20,448,2328,93,41,52
20,448,2531,227,121,106
20,448,2957,465,252,213
20,448,1472,8,5,3
20,448,1697,15,9,6
20,448,1058,13,8,5
20,448,1761,33,15,18
20,448,1365,107,53,54
20,448,1172,26,12,14
20,448,813,21,16,5
20,449,2867,8,3,5
20,450,1255,0,0,0
20,450,1205,0,0,0
20,450,1520,1,0,1
20,450,157,0,0,0
20,451,4828,12,4,8
20,451,2615,3,3,0
20,451,2840,6,4,2
20,451,1556,1,0,1
20,451,2775,64,34,30
20,452,657,8,5,3
20,452,362,1,1,0
20,453,1084,3,2,1
20,453,2073,8,6,2
20,453,1264,2,0,2
20,454,1364,39,20,19
20,454,1025,15,5,10
20,454,301,1,1,0
20,454,751,10,3,7
20,455,2874,7,4,3
20,455,981,15,9,6
20,456,2166,39,21,18
20,456,823,0,0,0
20,457,499,22,12,10
20,457,522,146,83,63
20,457,656,52,29,23
20,458,1252,3,1,2
20,458,2072,4,1,3
20,459,1451,27,16,11
20,459,1385,66,34,32
20,459,433,16,9,7
20,459,252,0,0,0
20,459,353,9,5,4
20,459,248,0,0,0
20,459,131,0,0,0
20,459,305,0,0,0
20,459,305,0,0,0
20,460,2022,21,14,7
20,460,1303,2,1,1
20,460,457,0,0,0
20,460,1810,3,1,2
20,461,905,4,3,1
20,461,252,4,2,2
20,462,368,1,0,1
20,462,159,0,0,0
20,463,3221,76,27,49
20,463,495,11,7,4
20,463,760,36,24,12
20,463,946,35,22,13
20,464,327,1,1,0
20,464,81,0,0,0
20,464,116,1,1,0
20,465,209,0,0,0
20,465,132,0,0,0
20,466,1627,5,4,1
20,467,4480,10,4,6
20,467,355,5,2,3
20,467,1818,1,0,1
20,467,546,39,18,21
20,467,2753,339,188,151
20,467,2965,107,47,60
20,467,810,191,97,94
20,468,1538,184,95,89
20,468,2151,189,106,83
20,468,1663,239,122,117
20,468,1616,376,199,177
20,468,1129,196,107,89
20,468,2282,286,158,128
20,468,1867,189,95,94
20,468,859,6,2,4
20,468,602,51,23,28
20,468,1121,624,327,297
20,468,1895,1241,632,609
20,468,944,815,401,414
20,468,1020,574,280,294
20,469,2871,17,7,10
20,469,1268,1,1,0
20,469,555,2,1,1
20,469,514,3,0,3
20,469,1926,7,4,3
20,469,2030,13,5,8
20,469,2657,7,2,5
20,469,2445,6,3,3
20,470,2935,118,60,58
20,470,2702,72,32,40
20,470,3075,33,15,18
20,470,2959,99,55,44
20,470,1382,37,20,17
20,470,822,1,0,1
20,470,2243,11,6,5
20,470,854,1,1,0
20,470,1080,115,56,59
20,470,2815,15,6,9
20,470,1850,2,1,1
20,470,1404,27,12,15
20,470,1724,6,5,1
20,470,1783,54,32,22
20,470,3388,16,9,7
20,470,2645,8,5,3
20,470,1378,6,4,2
20,471,1253,2,0,2
20,471,837,2,1,1
20,471,821,19,10,9
20,471,484,0,0,0
20,515,707,0,0,0
20,471,1119,2,1,1
20,472,431,0,0,0
20,473,1272,43,21,22
20,473,1761,71,37,34
20,473,328,268,140,128
20,474,617,0,0,0
20,474,674,0,0,0
20,475,1940,1776,898,878
20,475,609,577,292,285
20,475,867,782,375,407
20,476,1498,21,13,8
20,476,808,1,1,0
20,476,1144,0,0,0
20,476,1775,4,2,2
20,476,4940,28,18,10
20,477,421,3,2,1
20,478,1499,44,24,20
20,479,665,21,16,5
20,479,194,1,1,0
20,479,403,0,0,0
20,479,330,1,0,1
20,480,174,0,0,0
20,481,750,1,0,1
20,481,859,6,2,4
20,481,1212,8,4,4
20,481,975,15,12,3
20,481,437,0,0,0
20,481,201,0,0,0
20,481,747,7,4,3
20,482,985,2,1,1
20,482,275,0,0,0
20,483,953,9,4,5
20,483,926,28,17,11
20,484,2731,745,369,376
20,484,2468,938,485,453
20,484,1805,595,328,267
20,484,2601,535,265,270
20,484,1914,645,352,293
20,484,1788,644,331,313
20,484,2815,1084,577,507
20,484,1650,607,315,292
20,484,1612,254,147,107
20,484,2937,586,301,285
20,484,3966,1051,533,518
20,484,3446,1560,816,744
20,484,6002,1420,737,683
20,484,1174,1079,547,532
20,484,1222,1066,513,553
20,484,2153,1581,781,800
20,484,2173,1549,812,737
20,484,2078,297,163,134
20,484,2440,2177,1075,1102
20,484,1625,942,460,482
20,484,1735,154,77,77
20,484,1528,601,287,314
20,484,1640,1409,697,712
20,484,2361,2214,1135,1079
20,485,1980,2,1,1
20,485,2023,73,36,37
20,485,1968,35,16,19
20,485,3528,33,18,15
20,485,1417,42,27,15
20,486,1081,2,1,1
20,486,1181,23,13,10
20,486,503,4,2,2
20,486,420,1,0,1
20,486,458,0,0,0
20,486,547,1,0,1
20,487,1647,1492,747,745
20,487,1487,1418,691,727
20,488,801,2,2,0
20,488,1080,36,17,19
20,489,130,0,0,0
20,490,1720,178,100,78
20,490,1775,155,78,77
20,490,1506,74,37,37
20,491,1081,0,0,0
20,491,1968,0,0,0
20,492,4013,8,4,4
20,492,859,0,0,0
20,493,1028,9,5,4
20,493,480,2,0,2
20,493,413,1,1,0
20,493,142,0,0,0
20,494,545,3,2,1
20,495,1077,17,7,10
20,495,670,1,1,0
20,495,1275,0,0,0
20,495,769,0,0,0
20,496,965,35,18,17
20,496,461,3,0,3
20,496,760,1,0,1
20,496,915,107,55,52
20,497,812,1,1,0
20,497,1041,5,3,2
20,498,4257,276,161,115
20,499,955,24,11,13
20,499,907,3,1,2
20,499,3079,36,15,21
20,499,1442,4,1,3
20,499,1176,0,0,0
20,500,1195,9,6,3
20,500,751,53,30,23
20,501,2105,24,14,10
20,501,809,0,0,0
20,501,1043,0,0,0
20,501,171,0,0,0
20,501,681,16,7,9
20,501,860,3,2,1
20,501,1441,5,2,3
20,502,448,0,0,0
20,502,547,0,0,0
20,503,1799,25,15,10
20,503,672,7,4,3
20,503,1510,9,6,3
20,503,1108,3,2,1
20,504,425,0,0,0
20,505,2119,50,28,22
20,506,1598,1424,698,726
20,506,1557,1477,734,743
20,507,1632,11,3,8
20,508,2344,61,34,27
20,508,3265,20,12,8
20,508,2418,306,158,148
20,508,2657,61,34,27
20,509,967,14,7,7
20,509,2552,14,6,8
20,509,2089,36,17,19
20,509,689,12,8,4
20,509,1360,11,7,4
20,510,730,0,0,0
20,511,862,65,30,35
20,511,643,0,0,0
20,511,1404,21,10,11
20,512,1101,10,2,8
20,513,1294,27,9,18
20,513,1645,52,28,24
20,513,1906,65,34,31
20,513,1465,17,8,9
20,513,980,5,2,3
20,513,878,1,0,1
20,513,449,0,0,0
20,513,236,0,0,0
20,513,311,7,4,3
20,514,941,15,11,4
20,515,4873,28,11,17
20,515,4175,77,39,38
20,515,888,42,19,23
20,515,603,11,7,4
20,515,609,10,7,3
20,515,1775,11,3,8
20,515,1843,49,27,22
20,515,1300,2,1,1
20,515,1955,31,22,9
20,515,1488,90,40,50
20,515,1475,116,54,62
20,515,866,8,2,6
20,515,947,3,2,1
20,515,2646,41,17,24
20,515,2165,11,7,4
20,515,2922,18,6,12
20,515,1837,10,5,5
20,515,2597,18,11,7
20,515,5421,20,7,13
20,515,7105,211,106,105
20,515,2432,100,53,47
20,515,2515,4,1,3
20,515,1350,3,1,2
20,515,1133,27,16,11
20,515,3849,76,30,46
20,515,587,2,1,1
20,515,2428,5,3,2
20,515,2123,4,2,2
20,515,2412,1,0,1
20,516,2939,18,10,8
20,516,1925,5,2,3
20,517,2458,21,15,6
20,517,1113,3,2,1
20,517,805,7,4,3
20,518,113,0,0,0
20,519,1415,11,8,3
20,519,1821,13,6,7
20,520,1013,7,5,2
20,520,1132,9,4,5
20,520,838,6,3,3
20,520,950,54,25,29
20,520,128,0,0,0
20,520,1988,4,2,2
20,520,1279,1,1,0
20,521,252,0,0,0
20,522,1205,1,0,1
20,523,1537,158,89,69
20,523,55,7,6,1
20,524,327,0,0,0
20,525,1404,14,5,9
20,525,2021,119,63,56
20,525,2017,26,15,11
20,525,1300,54,23,31
20,525,1834,13,5,8
20,525,761,9,3,6
20,525,1777,14,7,7
20,525,100,1,0,1
20,525,1652,0,0,0
20,526,704,2,2,0
20,526,737,0,0,0
20,526,2580,8,5,3
20,527,2692,25,14,11
20,528,2027,1,0,1
20,528,2106,21,11,10
20,529,2460,54,33,21
20,530,2944,558,299,259
20,530,1978,176,101,75
20,530,1488,184,102,82
20,530,2252,31,15,16
20,530,2707,21,10,11
20,530,2096,17,10,7
20,530,2636,29,14,15
20,531,2490,372,186,186
20,532,904,4,1,3
20,533,1643,1,1,0
20,534,1807,26,11,15
20,534,1606,4,1,3
20,534,390,0,0,0
20,534,453,0,0,0
20,534,402,1,0,1
20,534,74,0,0,0
20,534,359,0,0,0
20,534,222,8,3,5
20,534,198,1,1,0
20,534,325,0,0,0
20,534,0,0,0,0
20,534,284,2,0,2
20,534,205,0,0,0
20,534,89,0,0,0
20,534,187,0,0,0
20,535,713,5,3,2
20,536,672,3,1,2
20,536,1749,16,9,7
20,536,1582,2,0,2
20,536,1049,34,18,16
20,536,1008,3,2,1
20,536,1245,3,0,3
20,536,720,1,0,1
20,536,863,4,1,3
20,536,1050,2,1,1
20,536,1819,3,0,3
20,537,2958,56,23,33
20,537,1457,21,9,12
20,537,2033,14,9,5
20,538,980,9,4,5
20,539,2228,344,191,153
20,539,1705,205,96,109
20,539,1187,21,11,10
20,539,1334,66,32,34
20,539,1658,312,289,23
20,539,304,48,21,27
20,540,3459,12,7,5
20,540,970,17,7,10
20,540,639,1,0,1
20,540,773,1,0,1
20,540,655,0,0,0
20,541,957,9,3,6
20,541,601,0,0,0
20,542,2119,28,16,12
20,542,1203,34,14,20
20,542,3064,14,8,6
20,543,914,29,16,13
20,543,1089,165,86,79
20,543,437,4,3,1
20,544,934,41,24,17
20,545,1630,82,45,37
20,545,3150,197,114,83
20,545,1937,21,8,13
20,545,2372,54,27,27
20,545,448,0,0,0
20,545,504,1,0,1
20,546,1631,98,50,48
20,546,1585,60,34,26
20,546,1944,21,13,8
20,546,1201,28,16,12
20,547,1005,5,4,1
20,548,1229,7,5,2
20,548,552,0,0,0
20,548,298,0,0,0
20,549,1632,31,18,13
20,549,559,6,5,1
20,549,1077,2,0,2
20,549,478,0,0,0
20,549,561,3,0,3
20,549,822,3,2,1
20,549,1029,22,8,14
20,549,2764,12,4,8
20,549,280,0,0,0
20,549,889,2,1,1
20,549,223,1,1,0
20,549,657,14,9,5
20,549,534,8,4,4
20,550,7926,358,180,178
20,550,8771,339,163,176
20,550,4074,42,23,19
20,550,1411,17,9,8
20,550,2252,107,21,86
20,550,1501,10,4,6
20,550,2300,13,4,9
20,550,582,1,0,1
20,550,956,1,1,0
20,550,526,0,0,0
20,551,396,0,0,0
20,552,2569,28,14,14
20,552,3785,31,15,16
20,552,2899,57,32,25
20,552,2696,47,21,26
20,553,4378,59,34,25
20,553,2693,79,41,38
20,553,2098,34,17,17
20,553,1983,21,12,9
20,553,2248,76,45,31
20,553,1423,13,7,6
20,553,6996,388,198,190
20,553,4138,26,11,15
20,553,2972,29,14,15
20,553,1985,61,37,24
20,553,392,10,5,5
20,553,177,8,4,4
20,553,1076,50,29,21
20,553,1538,3,1,2
20,553,1221,2,2,0
20,553,2490,10,3,7
20,553,1583,36,22,14
20,553,106,0,0,0
20,553,301,0,0,0
20,554,2005,2,0,2
20,554,572,6,2,4
20,554,1525,4,1,3
20,554,1319,1,1,0
20,554,473,1,0,1
20,555,3989,235,131,104
20,555,1654,12,7,5
20,556,306,0,0,0
20,557,2214,19,9,10
20,557,1150,6,4,2
20,557,913,3,1,2
20,557,1083,8,4,4
20,557,1042,2,2,0
20,557,712,1,1,0
20,557,829,1,1,0
20,557,2170,11,5,6
20,557,2147,2,2,0
20,557,1363,7,3,4
20,557,1059,9,4,5
20,558,818,636,340,296
20,558,558,29,17,12
20,559,1670,193,96,97
20,560,2215,47,20,27
20,560,1704,12,5,7
20,560,3481,50,26,24
20,560,2881,98,50,48
20,561,1573,15,7,8
20,561,1336,3,1,2
20,561,1900,6,2,4
20,561,1343,2,1,1
20,561,363,1,0,1
20,562,892,84,43,41
20,562,1007,9,4,5
20,563,1398,10,8,2
20,563,1574,3,0,3
20,564,1245,1,0,1
20,565,1189,5,2,3
20,566,4330,43,26,17
20,566,3799,300,151,149
20,566,1851,109,51,58
20,566,3709,35,17,18
20,566,2641,58,34,24
20,566,26028,371,199,172
20,566,660,4,2,2
20,567,808,0,0,0
20,567,1832,14,6,8
20,568,1661,1,0,1
20,568,984,0,0,0
20,568,737,0,0,0
20,569,1509,2,2,0
20,570,2074,40,21,19
20,570,2594,60,34,26
20,570,1463,41,25,16
20,570,1599,15,10,5
20,570,2193,137,68,69
20,570,3074,57,29,28
20,570,3746,52,27,25
20,570,1514,130,68,62
20,570,466,1,0,1
20,570,1548,72,35,37
20,570,927,2,1,1
20,570,1285,132,64,68
20,570,509,0,0,0
20,570,218,3,1,2
20,265,2436,121,59,62
20,37,229,0,0,0
20,553,360,11,6,5
20,470,33,0,0,0
20,66,417,9,5,4
20,26,1114,26,18,8
20,495,1830,2,1,1
20,182,4102,42,23,19
20,182,1260,94,44,50
20,37,2314,16,9,7
20,37,2511,42,26,16
20,76,2358,80,44,36
20,76,4302,64,37,27
20,76,3564,66,25,41
20,76,4553,72,37,35
20,121,1035,0,0,0
20,121,893,0,0,0
20,121,3768,189,101,88
20,43,4717,142,76,66
20,43,1659,15,5,10
20,66,1507,58,26,32
20,66,1324,74,37,37
20,66,1559,170,88,82
20,66,900,66,33,33
20,66,2378,59,32,27
20,66,1018,22,14,8
20,66,1744,28,14,14
20,66,1991,56,28,28
20,66,2950,55,26,29
20,66,1917,19,9,10
20,66,3411,128,64,64
20,66,2903,62,33,29
20,154,3183,135,74,61
20,154,1938,47,24,23
20,154,2644,44,24,20
20,400,3396,58,34,24
20,400,3477,159,91,68
20,400,1480,30,13,17
20,400,2041,15,5,10
20,400,836,16,10,6
20,400,2044,38,19,19
20,400,1919,48,21,27
20,400,1813,43,21,22
20,414,793,8,5,3
20,414,1697,35,16,19
20,414,642,20,8,12
20,414,769,39,14,25
20,414,1386,249,117,132
20,440,2995,416,208,208
20,440,1462,51,20,31
21,1,3841,33,19,14
21,1,4250,29,17,12
21,1,2181,8,5,3
21,1,4362,19,11,8
21,1,3719,17,12,5
21,1,4370,13,6,7
21,1,5019,12,7,5
21,1,3013,2,1,1
21,1,7478,24,12,12
21,1,3818,25,13,12
21,1,3328,5,1,4
21,1,2175,18,9,9
21,1,2523,0,0,0
21,1,2986,3,3,0
21,1,3347,20,10,10
21,1,4064,9,4,5
21,1,4218,6,4,2
21,1,1416,1,0,1
21,2,2053,10,5,5
21,2,1879,4,0,4
21,2,759,1,1,0
21,2,671,10,4,6
21,2,645,5,3,2
21,2,166,1,0,1
21,2,1175,0,0,0
21,2,1308,12,7,5
21,3,4847,69,37,32
21,3,3926,114,66,48
21,3,1655,17,7,10
21,3,2922,8,2,6
21,3,2292,10,5,5
21,3,2117,35,13,22
21,3,3058,26,13,13
21,3,1371,1,1,0
21,3,2897,2,1,1
21,3,1284,41,24,17
21,3,1870,26,14,12
21,3,2757,212,104,108
21,3,505,0,0,0
21,3,214,0,0,0
21,3,386,7,4,3
21,3,1608,5,2,3
21,4,5114,22,9,13
21,4,9463,54,31,23
21,4,3473,41,22,19
21,4,3224,19,7,12
21,4,3292,29,19,10
21,4,6065,36,18,18
21,4,2836,4,1,3
21,4,2887,5,5,0
21,4,2528,7,3,4
21,4,3424,10,6,4
21,4,6039,12,5,7
21,4,646,12,6,6
21,4,4862,16,9,7
21,4,3623,33,14,19
21,4,4212,16,8,8
21,4,5113,34,14,20
21,5,1300,76,42,34
21,5,918,165,96,69
21,5,852,2,1,1
21,6,1750,91,48,43
21,6,2387,16,7,9
21,6,3126,381,196,185
21,6,2604,2,1,1
21,6,1320,766,409,357
21,6,1944,35,14,21
21,6,1347,16,10,6
21,7,1120,1,0,1
21,7,565,0,0,0
21,7,829,0,0,0
21,7,648,8,3,5
21,8,2305,6,2,4
21,8,3663,4,0,4
21,8,3566,3,3,0
21,8,1815,9,6,3
21,9,2249,46,26,20
21,10,6552,28,13,15
21,10,4655,10,3,7
21,10,6712,50,22,28
21,10,6321,49,22,27
21,10,3665,8,4,4
21,10,2768,518,266,252
21,10,4055,6,2,4
21,10,2789,10,6,4
21,10,2534,4,3,1
21,10,2338,1,0,1
21,10,4951,6,4,2
21,10,3699,1,0,1
21,10,197,1,0,1
21,10,130,0,0,0
21,10,3466,9,5,4
21,10,3260,5,4,1
21,10,3287,40,18,22
21,10,685,1,1,0
21,10,1927,2,1,1
21,10,3207,6,4,2
21,10,1301,3,1,2
21,11,1831,15,6,9
21,12,987,1,1,0
21,12,3095,8,4,4
21,12,1453,5,3,2
21,12,1005,0,0,0
21,13,4750,7,2,5
21,13,3206,84,42,42
21,13,2431,120,61,59
21,13,3201,6,1,5
21,13,5933,30,18,12
21,13,2408,16,6,10
21,14,2514,48,26,22
21,14,772,24,12,12
21,14,1572,0,0,0
21,15,8509,182,85,97
21,15,5301,59,26,33
21,15,5787,52,24,28
21,15,1839,53,26,27
21,15,2482,79,37,42
21,15,9967,408,216,192
21,15,8188,620,324,296
21,15,8990,622,331,291
21,15,5158,75,47,28
21,15,1814,27,14,13
21,15,5753,170,76,94
21,15,9654,180,84,96
21,15,2263,115,55,60
21,15,15884,382,174,208
21,15,3788,73,39,34
21,15,5206,58,29,29
21,15,12932,217,103,114
21,15,3325,23,15,8
21,16,3222,37,15,22
21,16,795,6,4,2
21,16,2008,8,4,4
21,16,2028,6,3,3
21,16,1012,24,8,16
21,17,4540,26,16,10
21,17,4717,36,17,19
21,17,169,0,0,0
21,17,0,0,0,0
21,17,4593,5,1,4
21,17,6837,7,3,4
21,17,2186,14,8,6
21,17,935,0,0,0
21,18,1210,74,37,37
21,18,516,41,26,15
21,18,226,4,2,2
21,18,387,6,3,3
21,18,1145,6,3,3
21,18,379,1,1,0
21,19,3099,12,5,7
21,19,267,2,2,0
21,19,161,5,2,3
21,19,819,6,3,3
21,19,2563,23,8,15
21,19,2804,20,11,9
21,19,9968,90,48,42
21,19,1087,10,6,4
21,19,1416,12,9,3
21,19,7041,98,50,48
21,19,3833,12,5,7
21,19,2387,31,18,13
21,19,1701,13,11,2
21,19,1260,8,6,2
21,19,2006,23,14,9
21,19,3457,64,34,30
21,19,2653,16,8,8
21,19,703,1,1,0
21,19,291,0,0,0
21,19,2751,12,5,7
21,19,4443,19,7,12
21,19,1811,30,17,13
21,19,1536,15,9,6
21,19,1680,56,28,28
21,19,1327,36,17,19
21,19,671,26,16,10
21,19,648,11,5,6
21,19,265,3,1,2
21,19,305,7,5,2
21,19,306,0,0,0
21,19,486,1,1,0
21,19,2710,75,42,33
21,19,2523,1,0,1
21,19,1482,5,4,1
21,19,588,5,2,3
21,19,1231,15,6,9
21,19,1169,1,0,1
21,19,1143,9,5,4
21,19,1122,3,1,2
21,19,1519,4,0,4
21,19,1670,3,0,3
21,19,1204,24,11,13
21,19,2040,8,5,3
21,19,1508,17,10,7
21,19,1360,1,1,0
21,19,1428,21,9,12
21,19,1033,8,4,4
21,19,3058,10,4,6
21,19,2717,18,10,8
21,19,2157,5,2,3
21,19,2015,3,2,1
21,19,1518,0,0,0
21,19,1909,1,0,1
21,19,3152,10,7,3
21,19,6694,54,26,28
21,19,2959,11,5,6
21,19,533,0,0,0
21,19,1066,0,0,0
21,19,3242,6,2,4
21,19,4304,11,7,4
21,19,2970,190,96,94
21,19,3486,17,10,7
21,19,3599,35,20,15
21,19,2538,8,0,8
21,19,1653,4,1,3
21,19,2676,39,24,15
21,19,1251,15,8,7
21,19,1670,7,2,5
21,20,3276,363,195,168
21,20,4401,526,281,245
21,21,1544,69,31,38
21,22,1028,33,19,14
21,22,2634,14,7,7
21,22,2339,25,12,13
21,22,1549,14,9,5
21,22,1219,6,4,2
21,22,1440,1,0,1
21,22,582,1,1,0
21,22,1370,9,4,5
21,22,652,0,0,0
21,23,2013,15,7,8
21,23,2025,15,6,9
21,23,894,1,0,1
21,23,2601,1,1,0
21,23,1350,0,0,0
21,24,631,4,2,2
21,24,351,0,0,0
21,25,2267,93,45,48
21,25,2505,30,16,14
21,25,1731,9,5,4
21,25,1711,31,17,14
21,26,1874,374,193,181
21,26,1885,157,78,79
21,26,1723,206,111,95
21,26,4260,128,68,60
21,26,1304,43,24,19
21,26,1321,141,84,57
21,26,1425,93,48,45
21,26,1479,178,98,80
21,27,742,3,1,2
21,27,1163,1,0,1
21,27,394,0,0,0
21,27,896,5,1,4
21,27,411,0,0,0
21,27,442,0,0,0
21,27,103,0,0,0
21,28,2069,2,2,0
21,28,689,0,0,0
21,29,2502,10,7,3
21,29,1885,27,13,14
21,29,1930,12,7,5
21,29,3871,6,4,2
21,29,1173,0,0,0
21,29,1698,2,1,1
21,29,2282,9,4,5
21,29,531,3,2,1
21,29,4841,25,8,17
21,30,2403,27,17,10
21,30,1391,2,1,1
21,31,772,0,0,0
21,32,1188,5,3,2
21,32,1131,1,0,1
21,32,501,0,0,0
21,33,1168,8,4,4
21,33,250,0,0,0
21,34,2101,76,37,39
21,34,2227,16,10,6
21,34,1075,0,0,0
21,35,1716,14,8,6
21,35,6266,53,26,27
21,35,4691,15,5,10
21,35,4037,4,0,4
21,35,3052,4,4,0
21,35,2301,3,1,2
21,35,2497,8,3,5
21,35,3243,60,27,33
21,35,3625,62,34,28
21,35,36423,1089,556,533
21,35,3953,20,9,11
21,35,3890,38,20,18
21,36,387,2,1,1
21,36,1875,19,11,8
21,36,935,2,1,1
21,36,2825,5,1,4
21,36,2395,4,4,0
21,36,2311,14,8,6
21,36,2880,23,13,10
21,36,1518,8,4,4
21,36,2285,2,1,1
21,36,675,2,1,1
21,36,457,1,1,0
21,36,2045,12,9,3
21,37,4241,13,9,4
21,37,2602,1,0,1
21,37,1112,1,1,0
21,37,598,1,0,1
21,37,2504,7,4,3
21,37,1967,0,0,0
21,37,307,0,0,0
21,37,1128,0,0,0
21,38,1288,40,16,24
21,38,447,5,3,2
21,38,599,29,17,12
21,39,4442,13,4,9
21,40,3551,29,13,16
21,40,2754,26,10,16
21,40,2295,34,18,16
21,40,1259,1,1,0
21,41,5165,49,23,26
21,42,26120,723,351,372
21,42,6184,178,80,98
21,42,5185,124,67,57
21,42,2804,58,23,35
21,42,5837,143,69,74
21,42,6928,64,30,34
21,42,11436,328,158,170
21,42,7176,141,67,74
21,42,4626,11,5,6
21,42,7624,157,62,95
21,42,2800,95,47,48
21,42,6961,73,36,37
21,42,3518,173,80,93
21,42,6556,168,77,91
21,42,16161,550,288,262
21,43,1798,6,3,3
21,43,743,2,2,0
21,43,414,1,0,1
21,43,282,0,0,0
21,44,1431,136,73,63
21,44,1141,11,5,6
21,44,1830,195,104,91
21,44,1817,62,34,28
21,44,2607,1,1,0
21,44,2631,22,11,11
21,44,2610,4,3,1
21,44,2387,8,3,5
21,44,3799,2,2,0
21,44,2739,15,8,7
21,44,3179,45,27,18
21,44,3775,2,1,1
21,44,1156,0,0,0
21,44,1337,9,3,6
21,44,3207,5,3,2
21,44,6091,11,3,8
21,44,2346,57,31,26
21,44,1200,0,0,0
21,44,1687,108,63,45
21,44,2922,9,3,6
21,45,2442,163,88,75
21,45,2899,118,56,62
21,45,1565,36,17,19
21,45,2612,3,1,2
21,45,1828,9,6,3
21,45,2733,31,17,14
21,45,2680,12,5,7
21,46,4290,2,1,1
21,46,3761,11,8,3
21,46,2987,36,23,13
21,46,2292,7,2,5
21,46,2168,8,5,3
21,46,1130,2,2,0
21,46,2093,3,1,2
21,46,1692,16,7,9
21,46,3636,25,15,10
21,46,3361,12,9,3
21,46,2035,29,12,17
21,46,1510,3,1,2
21,46,747,0,0,0
21,46,1088,0,0,0
21,46,1681,2,2,0
21,46,2908,9,4,5
21,46,694,1,1,0
21,46,1687,6,3,3
21,46,1319,2,0,2
21,46,2026,4,3,1
21,46,1801,5,3,2
21,46,733,9,4,5
21,46,1405,2,0,2
21,46,426,0,0,0
21,47,4611,13,5,8
21,47,2823,10,3,7
21,47,589,0,0,0
21,48,2692,236,113,123
21,48,1663,155,78,77
21,48,1623,30,17,13
21,48,2202,202,96,106
21,48,2574,323,164,159
21,48,1743,431,226,205
21,48,1424,6,2,4
21,48,3317,14,6,8
21,48,738,3,3,0
21,48,184,0,0,0
21,48,1008,12,8,4
21,48,225,1,0,1
21,48,157,2,2,0
21,48,125,0,0,0
21,48,1535,6,3,3
21,48,172,0,0,0
21,48,245,10,9,1
21,49,3745,26,16,10
21,49,2402,0,0,0
21,49,2270,9,7,2
21,49,3699,10,6,4
21,49,2358,6,3,3
21,49,3355,1,0,1
21,49,1655,0,0,0
21,49,2101,2,1,1
21,50,4176,22,10,12
21,50,2915,44,23,21
21,50,990,1,1,0
21,50,1679,0,0,0
21,50,2836,8,4,4
21,50,4082,162,83,79
21,50,1295,1,0,1
21,51,4563,580,295,285
21,51,948,2,1,1
21,51,3108,19,11,8
21,51,4097,16,7,9
21,51,1463,149,80,69
21,51,3319,50,26,24
21,51,2180,37,20,17
21,51,2386,44,27,17
21,51,4678,633,322,311
21,52,1342,24,13,11
21,52,1210,28,11,17
21,52,2738,8,3,5
21,52,1570,9,2,7
21,52,1606,2,2,0
21,52,2650,386,212,174
21,52,2536,26,10,16
21,52,1507,70,28,42
21,52,1882,18,6,12
21,52,1431,9,3,6
21,52,1807,16,7,9
21,52,2875,18,12,6
21,52,1271,25,9,16
21,52,2024,6,2,4
21,52,2709,5,3,2
21,52,1010,0,0,0
21,52,1218,7,4,3
21,52,1441,1,0,1
21,52,1269,0,0,0
21,52,2813,4,1,3
21,53,750,2,1,1
21,53,465,1,0,1
21,54,2306,26,18,8
21,54,3677,23,8,15
21,54,3605,33,14,19
21,54,2621,12,7,5
21,54,1628,6,5,1
21,54,4568,13,10,3
21,54,2092,10,4,6
21,54,2389,4,1,3
21,54,2489,5,4,1
21,54,1638,7,6,1
21,54,986,6,2,4
21,54,839,1,0,1
21,54,1205,2,0,2
21,54,1823,78,40,38
21,54,2363,5,4,1
21,54,810,0,0,0
21,54,1047,0,0,0
21,54,2116,9,5,4
21,54,1524,26,9,17
21,54,1389,3,3,0
21,54,4167,19,10,9
21,54,3780,12,7,5
21,54,2498,28,15,13
21,54,2455,8,5,3
21,54,2685,8,5,3
21,54,1551,10,3,7
21,54,2882,25,12,13
21,55,5162,77,49,28
21,55,3971,28,18,10
21,55,6357,56,26,30
21,55,5480,38,17,21
21,55,4705,11,5,6
21,56,2362,24,13,11
21,56,1034,8,4,4
21,56,1160,6,3,3
21,56,526,0,0,0
21,57,838,0,0,0
21,57,479,0,0,0
21,58,2222,9,6,3
21,58,1701,9,2,7
21,58,2764,2,1,1
21,59,3462,3,0,3
21,59,3295,6,4,2
21,59,1960,1,1,0
21,59,1867,761,387,374
21,59,3325,3,2,1
21,59,4213,114,56,58
21,59,2861,71,39,32
21,60,1973,356,173,183
21,60,505,1,1,0
21,60,419,2,1,1
21,61,1798,20,10,10
21,61,3662,84,36,48
21,61,2324,6,2,4
21,62,2457,16,6,10
21,62,4643,16,8,8
21,62,1375,98,51,47
21,62,2877,11,8,3
21,62,1974,4,1,3
21,62,1418,4,2,2
21,63,2187,8,4,4
21,63,2501,30,13,17
21,64,1864,28,14,14
21,64,1975,12,6,6
21,64,1053,3,0,3
21,64,3591,2,1,1
21,64,867,0,0,0
21,64,3308,16,8,8
21,64,1214,1,1,0
21,64,304,1,0,1
21,64,699,3,2,1
21,65,2981,3,2,1
21,65,2340,14,6,8
21,65,2029,4,3,1
21,65,2789,4,2,2
21,65,1226,2,0,2
21,65,1331,8,5,3
21,65,2164,0,0,0
21,65,1909,2,1,1
21,65,1052,9,6,3
21,66,4883,20,8,12
21,66,2305,21,8,13
21,66,2042,38,24,14
21,66,3597,49,32,17
21,66,3637,6,4,2
21,66,2186,0,0,0
21,66,3934,2,2,0
21,67,2513,10,3,7
21,67,806,0,0,0
21,67,1799,0,0,0
21,67,1496,0,0,0
21,68,3579,19,10,9
21,68,5063,69,34,35
21,68,2534,35,21,14
21,68,1509,2,0,2
21,68,2197,3,2,1
21,68,744,11,5,6
21,68,786,6,4,2
21,68,467,2,0,2
21,68,1327,4,0,4
21,68,616,13,8,5
21,69,2371,201,100,101
21,69,1901,19,11,8
21,69,966,0,0,0
21,69,2208,166,87,79
21,70,2511,18,8,10
21,70,1142,1,0,1
21,70,1085,4,4,0
21,70,699,0,0,0
21,70,1222,7,5,2
21,70,2532,5,0,5
21,70,2000,24,23,1
21,70,2258,1,0,1
21,70,1260,5,1,4
21,70,1620,0,0,0
21,70,2013,14,7,7
21,70,1801,17,7,10
21,70,809,3,2,1
21,70,1710,13,6,7
21,70,1855,8,1,7
21,70,894,1,1,0
21,70,2218,3,2,1
21,70,1151,2,2,0
21,70,397,1,0,1
21,71,759,3,2,1
21,71,597,12,6,6
21,71,1364,5,2,3
21,71,1279,4,3,1
21,71,1654,1,1,0
21,71,470,1,1,0
21,72,524,3,0,3
21,72,1509,1,1,0
21,72,1099,5,4,1
21,72,2046,12,6,6
21,72,3244,26,15,11
21,72,1985,16,8,8
21,72,2337,13,10,3
21,72,1305,2,0,2
21,72,1829,8,4,4
21,72,7475,65,29,36
21,72,5052,50,25,25
21,72,2552,2,1,1
21,72,1300,12,7,5
21,72,2088,4,3,1
21,72,2472,15,7,8
21,72,7594,23,12,11
21,72,1862,2,1,1
21,72,3201,22,12,10
21,72,8472,20,13,7
21,72,2403,7,3,4
21,72,2614,1,0,1
21,72,3673,11,6,5
21,72,3715,11,5,6
21,72,1767,4,3,1
21,72,3141,1,0,1
21,72,2933,7,3,4
21,72,2464,11,5,6
21,72,2965,25,15,10
21,72,2332,4,2,2
21,72,3376,15,8,7
21,72,2851,5,4,1
21,72,765,2,2,0
21,72,1878,6,3,3
21,72,2727,5,1,4
21,72,2446,5,1,4
21,72,3931,24,13,11
21,72,171,1,1,0
21,73,2078,49,26,23
21,73,2798,26,9,17
21,73,1939,6,6,0
21,73,2217,4,2,2
21,73,27,1,1,0
21,73,3320,13,8,5
21,73,1955,23,11,12
21,73,1467,27,14,13
21,73,1209,9,4,5
21,74,2182,13,6,7
21,74,3176,3,0,3
21,74,1690,2,1,1
21,74,1973,1,0,1
21,74,292,7,2,5
21,74,562,2,2,0
21,75,631,9,6,3
21,75,2622,11,5,6
21,75,2019,524,272,252
21,75,555,17,9,8
21,75,265,0,0,0
21,76,3904,43,21,22
21,76,3175,108,61,47
21,76,20340,852,418,434
21,76,2403,10,5,5
21,76,1741,16,14,2
21,76,2288,14,7,7
21,76,9979,390,189,201
21,76,1979,153,83,70
21,76,3106,114,64,50
21,76,3390,42,21,21
21,76,4658,116,54,62
21,76,3004,14,5,9
21,76,4495,82,43,39
21,76,3876,18,10,8
21,76,3612,31,17,14
21,76,3040,64,35,29
21,76,2647,141,68,73
21,76,3845,32,17,15
21,76,842,9,8,1
21,76,3796,42,17,25
21,76,1695,11,6,5
21,76,4161,314,157,157
21,77,2392,1,0,1
21,77,5121,22,10,12
21,77,320,0,0,0
21,77,2334,2,2,0
21,77,2969,5,2,3
21,78,2870,12,6,6
21,78,1889,4,2,2
21,78,418,6,2,4
21,78,1883,28,10,18
21,78,2877,1,1,0
21,78,2000,2,1,1
21,78,1472,4,4,0
21,78,2191,3,1,2
21,78,1813,14,8,6
21,78,2421,4,2,2
21,78,1676,0,0,0
21,78,275,0,0,0
21,78,3299,12,7,5
21,78,1479,0,0,0
21,78,1649,2,1,1
21,79,1554,21,7,14
21,79,1078,3,1,2
21,79,3128,3,3,0
21,80,4498,2268,1108,1160
21,80,2421,181,88,93
21,80,5267,540,264,276
21,80,2048,586,281,305
21,80,2088,18,9,9
21,81,1886,3,2,1
21,81,2263,29,15,14
21,81,1667,30,16,14
21,82,1599,2,0,2
21,82,1034,10,5,5
21,83,1683,3,2,1
21,83,1288,4,4,0
21,83,1148,15,8,7
21,84,3884,175,105,70
21,84,2921,47,19,28
21,84,1999,4,2,2
21,85,1098,49,23,26
21,85,1345,5,2,3
21,85,1019,33,13,20
21,85,2523,3,2,1
21,85,3910,41,26,15
21,85,1832,0,0,0
21,85,1756,2,0,2
21,85,1961,9,5,4
21,85,1617,21,11,10
21,85,768,0,0,0
21,85,764,8,3,5
21,85,3641,15,9,6
21,85,570,3,0,3
21,85,1498,1,0,1
21,85,1476,7,2,5
21,86,3335,82,43,39
21,86,3006,311,153,158
21,86,817,1,0,1
21,87,2231,16,9,7
21,87,1648,77,43,34
21,87,6154,58,35,23
21,87,1127,10,3,7
21,87,1505,41,27,14
21,87,1123,15,7,8
21,87,1867,15,12,3
21,87,1452,24,13,11
21,87,1161,127,58,69
21,87,4152,41,22,19
21,87,3065,11,8,3
21,87,1998,57,28,29
21,87,1537,9,4,5
21,87,3638,17,9,8
21,87,4231,13,7,6
21,87,2648,24,10,14
21,87,7382,27,15,12
21,87,1787,3,1,2
21,87,1428,2,1,1
21,87,3339,47,21,26
21,87,1690,31,13,18
21,87,1387,2,2,0
21,87,3085,99,51,48
21,87,3698,41,19,22
21,87,2199,4,1,3
21,87,2006,5,0,5
21,87,2026,1,0,1
21,87,1565,3,2,1
21,87,3243,9,6,3
21,87,1467,3,1,2
21,87,1425,3,2,1
21,87,1351,2,2,0
21,87,3031,7,4,3
21,87,1539,14,8,6
21,88,2499,21,9,12
21,88,2864,8,2,6
21,88,918,1,1,0
21,88,2594,50,27,23
21,88,1972,17,10,7
21,88,2846,9,6,3
21,89,3999,8,4,4
21,89,2953,14,8,6
21,89,1888,4,1,3
21,89,2372,8,4,4
21,89,1178,4,2,2
21,89,918,7,4,3
21,90,1223,15,7,8
21,90,837,0,0,0
21,90,2174,10,4,6
21,91,2641,7,3,4
21,91,1048,1,0,1
21,91,2284,5,2,3
21,91,1264,2,2,0
21,91,2357,4,3,1
21,91,910,3,2,1
21,91,1596,18,9,9
21,92,4238,30,14,16
21,92,5410,186,91,95
21,92,2811,13,6,7
21,92,3548,12,3,9
21,92,6294,133,77,56
21,92,3799,70,30,40
21,93,1916,2,1,1
21,93,1537,35,15,20
21,93,2133,7,4,3
21,93,2438,7,4,3
21,93,1149,0,0,0
21,94,1310,154,77,77
21,94,537,1,0,1
21,94,1302,2,1,1
21,94,2192,36,18,18
21,95,830,7,5,2
21,95,1879,0,0,0
21,95,296,4,3,1
21,95,545,2,0,2
21,95,562,24,11,13
21,95,939,11,6,5
21,95,1029,2,2,0
21,95,1532,25,8,17
21,96,5377,78,39,39
21,96,4840,87,45,42
21,96,4079,164,80,84
21,96,1911,73,39,34
21,96,2578,41,21,20
21,96,2564,8,4,4
21,96,3867,3,1,2
21,96,3250,14,6,8
21,96,2710,231,118,113
21,96,1926,6,4,2
21,96,3620,60,29,31
21,97,650,23,7,16
21,98,1938,22,11,11
21,98,1436,1,1,0
21,99,1590,11,8,3
21,99,1078,2,1,1
21,100,1953,3,2,1
21,100,1747,12,6,6
21,100,764,4,3,1
21,100,897,1,0,1
21,100,1307,1,1,0
21,101,1866,1,1,0
21,101,2528,6,2,4
21,101,2207,6,5,1
21,101,1074,1,1,0
21,101,1626,4,2,2
21,102,2032,6,3,3
21,102,852,0,0,0
21,102,509,4,3,1
21,103,3899,113,57,56
21,103,2843,55,30,25
21,103,2925,56,30,26
21,103,4163,126,58,68
21,104,378,0,0,0
21,104,1154,7,4,3
21,104,4715,60,39,21
21,104,546,5,1,4
21,105,3156,14,8,6
21,105,5109,16,8,8
21,105,2432,0,0,0
21,105,4261,642,331,311
21,105,4793,657,321,336
21,105,8072,34,16,18
21,105,1804,42,18,24
21,106,1970,13,8,5
21,106,2524,2,2,0
21,106,1040,13,8,5
21,107,3260,83,41,42
21,107,17629,326,149,177
21,107,6338,154,75,79
21,107,2974,6,2,4
21,107,4181,30,17,13
21,107,2591,113,57,56
21,107,2359,11,5,6
21,107,4926,75,36,39
21,107,4416,14,7,7
21,107,1754,31,16,15
21,108,1432,3,2,1
21,108,1900,2,1,1
21,108,977,5,3,2
21,108,2379,51,27,24
21,108,1881,53,31,22
21,108,1579,43,17,26
21,108,514,0,0,0
21,108,1403,0,0,0
21,109,2413,44,25,19
21,109,3330,48,24,24
21,109,4193,83,47,36
21,109,1436,1,0,1
21,109,2645,46,27,19
21,109,1220,33,17,16
21,109,1616,0,0,0
21,109,2154,0,0,0
21,110,2650,26,15,11
21,110,1124,17,8,9
21,110,1129,7,5,2
21,110,462,1,0,1
21,110,1534,3,1,2
21,110,850,0,0,0
21,110,1203,6,1,5
21,110,3649,4,4,0
21,110,1011,7,3,4
21,110,372,0,0,0
21,110,1526,12,6,6
21,110,1268,1,1,0
21,110,456,0,0,0
21,110,3040,15,8,7
21,111,2363,9,5,4
21,111,1919,9,6,3
21,111,4799,11,3,8
21,111,3393,18,8,10
21,111,7174,30,13,17
21,111,3464,19,10,9
21,111,2911,18,12,6
21,111,3728,12,6,6
21,111,4021,5,2,3
21,111,815,2,1,1
21,111,4264,44,21,23
21,111,1919,8,3,5
21,111,1571,1,0,1
21,111,4013,12,7,5
21,111,2998,3,2,1
21,112,1391,9,5,4
21,112,2501,6,5,1
21,112,1084,7,2,5
21,112,2257,3,0,3
21,112,699,1,1,0
21,112,2506,2,0,2
21,112,1954,3,2,1
21,112,2024,14,8,6
21,112,1759,4,1,3
21,112,2096,78,43,35
21,113,2133,18,8,10
21,113,1314,7,5,2
21,113,1497,44,24,20
21,113,1477,3,1,2
21,113,1361,2,0,2
21,113,1267,1,1,0
21,114,1641,6,3,3
21,114,457,5,2,3
21,114,899,17,15,2
21,114,315,0,0,0
21,114,1704,11,8,3
21,115,161,2,0,2
21,115,321,1,1,0
21,115,293,0,0,0
21,115,331,2,0,2
21,115,282,10,8,2
21,115,194,9,3,6
21,115,315,2,1,1
21,115,869,10,4,6
21,115,685,3,1,2
21,115,1530,26,17,9
21,115,1152,66,33,33
21,115,1547,105,56,49
21,115,958,22,11,11
21,115,704,3,1,2
21,115,1822,27,14,13
21,115,2320,10,6,4
21,115,2016,157,84,73
21,115,5878,267,154,113
21,115,5135,27,12,15
21,115,2409,23,11,12
21,115,1313,22,11,11
21,115,1019,4,2,2
21,115,887,3,1,2
21,115,1330,7,3,4
21,115,1247,9,5,4
21,115,1325,22,10,12
21,115,1025,17,10,7
21,115,1016,15,5,10
21,115,1243,25,11,14
21,115,1057,4,1,3
21,115,626,20,11,9
21,115,445,5,2,3
21,115,369,4,4,0
21,115,249,3,2,1
21,115,317,9,4,5
21,115,393,4,3,1
21,115,160,6,5,1
21,115,511,19,8,11
21,115,290,11,6,5
21,115,888,3,3,0
21,115,1684,12,5,7
21,115,1040,17,11,6
21,115,857,7,2,5
21,115,2000,10,5,5
21,115,3246,30,17,13
21,115,1368,4,2,2
21,115,1212,22,10,12
21,115,1720,18,7,11
21,115,1578,19,10,9
21,115,1672,3,1,2
21,115,1806,29,14,15
21,115,768,21,8,13
21,115,864,13,6,7
21,115,843,26,13,13
21,115,381,1,0,1
21,115,352,6,3,3
21,115,281,15,6,9
21,115,337,2,1,1
21,115,569,0,0,0
21,115,691,24,8,16
21,115,1052,14,3,11
21,115,551,155,74,81
21,115,785,26,12,14
21,115,1374,7,3,4
21,115,795,1,0,1
21,115,1151,19,9,10
21,115,900,7,3,4
21,115,1548,22,8,14
21,115,1231,11,4,7
21,115,2138,21,16,5
21,115,1966,2,1,1
21,115,1863,7,4,3
21,115,2524,54,32,22
21,115,1318,28,16,12
21,115,1740,13,6,7
21,115,4367,223,112,111
21,115,1943,13,9,4
21,115,1800,3,2,1
21,115,2539,35,17,18
21,115,2426,23,13,10
21,115,1448,20,11,9
21,115,730,13,8,5
21,115,820,0,0,0
21,115,1098,1,1,0
21,115,1110,10,4,6
21,115,900,183,116,67
21,115,867,87,53,34
21,115,589,2,1,1
21,115,480,6,2,4
21,115,937,29,16,13
21,115,774,5,2,3
21,115,640,1,1,0
21,115,1406,10,6,4
21,115,1619,36,19,17
21,115,1671,52,27,25
21,115,2139,36,22,14
21,115,1031,15,7,8
21,115,1438,4,4,0
21,115,1782,14,8,6
21,115,1377,7,4,3
21,115,4579,42,15,27
21,115,1749,19,12,7
21,115,3527,27,14,13
21,115,2298,23,13,10
21,115,1053,21,10,11
21,115,974,13,4,9
21,115,929,13,8,5
21,115,433,0,0,0
21,115,1157,4,2,2
21,115,2338,30,19,11
21,115,2060,23,13,10
21,115,1974,8,5,3
21,115,1468,3,3,0
21,115,1644,10,5,5
21,115,1372,7,3,4
21,115,969,11,4,7
21,115,2128,24,13,11
21,115,4241,8,6,2
21,115,2239,19,12,7
21,115,1602,13,8,5
21,115,1582,14,7,7
21,115,2192,25,13,12
21,115,5414,54,25,29
21,115,1131,12,9,3
21,115,1233,31,16,15
21,115,4423,71,27,44
21,115,3395,54,25,29
21,115,8614,95,50,45
21,115,4954,36,15,21
21,115,4486,54,26,28
21,115,1855,180,101,79
21,115,2579,28,15,13
21,115,16059,275,135,140
21,115,740,0,0,0
21,115,1282,6,2,4
21,115,3110,38,20,18
21,115,2467,34,19,15
21,115,6673,99,46,53
21,115,3101,27,13,14
21,115,9179,290,140,150
21,115,3838,20,14,6
21,115,1558,6,2,4
21,115,2472,1,0,1
21,115,13780,148,70,78
21,115,5389,976,486,490
21,115,7679,394,193,201
21,115,3958,20,13,7
21,115,132,5,2,3
21,115,174,7,4,3
21,115,72,0,0,0
21,115,128,2,1,1
21,115,344,1,0,1
21,115,434,13,5,8
21,115,964,43,25,18
21,115,663,10,5,5
21,115,696,5,4,1
21,115,810,17,11,6
21,115,1786,32,19,13
21,115,2366,24,8,16
21,115,2355,10,7,3
21,115,3807,23,13,10
21,115,1404,20,10,10
21,115,1898,14,5,9
21,115,2363,22,13,9
21,115,1730,21,11,10
21,115,1027,19,6,13
21,115,1761,41,24,17
21,115,832,21,10,11
21,115,1815,106,47,59
21,115,1365,153,82,71
21,115,428,2,1,1
21,115,225,5,4,1
21,115,565,15,9,6
21,115,338,4,1,3
21,115,212,1,1,0
21,115,262,6,3,3
21,115,112,1,1,0
21,115,181,9,4,5
21,115,903,60,32,28
21,115,189,10,4,6
21,115,301,23,16,7
21,115,306,8,5,3
21,115,280,9,5,4
21,115,428,14,5,9
21,115,595,7,2,5
21,115,893,50,27,23
21,115,332,7,4,3
21,115,628,4,3,1
21,115,813,19,6,13
21,115,887,3,2,1
21,115,896,7,3,4
21,115,1437,12,11,1
21,115,1098,17,10,7
21,115,1148,10,6,4
21,115,4237,39,19,20
21,115,6391,143,70,73
21,115,3713,85,41,44
21,115,1905,29,18,11
21,115,1374,57,29,28
21,115,1052,3,2,1
21,115,1064,85,45,40
21,115,1215,50,19,31
21,115,812,15,8,7
21,115,930,32,17,15
21,115,987,5,4,1
21,115,553,9,2,7
21,115,388,7,5,2
21,115,835,10,4,6
21,115,807,31,16,15
21,115,1117,61,31,30
21,115,566,12,7,5
21,115,654,9,5,4
21,115,700,32,19,13
21,115,840,13,7,6
21,115,857,21,9,12
21,115,1180,38,19,19
21,115,956,14,7,7
21,115,1476,13,6,7
21,115,1504,7,7,0
21,115,765,3,2,1
21,115,2191,23,12,11
21,115,1221,16,10,6
21,115,1987,11,5,6
21,115,1477,11,7,4
21,115,887,11,8,3
21,115,1051,7,5,2
21,115,875,9,2,7
21,115,590,6,4,2
21,115,541,6,5,1
21,115,661,12,7,5
21,115,1247,41,20,21
21,115,869,16,7,9
21,115,1074,32,16,16
21,115,665,20,10,10
21,115,999,17,9,8
21,115,1095,36,19,17
21,115,1787,29,13,16
21,115,1020,27,17,10
21,115,1239,36,22,14
21,115,1602,8,3,5
21,115,1679,26,16,10
21,115,1768,133,75,58
21,115,2004,68,33,35
21,115,1746,28,15,13
21,115,1225,10,6,4
21,115,1607,20,11,9
21,115,1355,13,10,3
21,115,1344,15,9,6
21,115,2156,47,25,22
21,115,2531,37,22,15
21,115,1269,18,10,8
21,115,1093,79,51,28
21,115,2389,58,30,28
21,115,1624,10,7,3
21,115,2025,13,9,4
21,115,3863,116,58,58
21,115,1009,33,16,17
21,115,2098,116,53,63
21,115,2276,21,10,11
21,115,1363,7,4,3
21,115,3826,104,50,54
21,115,3138,30,16,14
21,115,2345,33,20,13
21,115,3363,28,9,19
21,115,3386,35,17,18
21,115,2222,41,21,20
21,115,3245,14,8,6
21,115,3458,809,431,378
21,115,3966,56,35,21
21,115,2178,13,5,8
21,115,2097,5,2,3
21,115,3799,40,16,24
21,115,18842,693,331,362
21,115,6491,117,62,55
21,115,1261,8,5,3
21,115,1025,4,2,2
21,115,2036,29,14,15
21,115,1151,7,1,6
21,115,2886,35,18,17
21,115,4280,496,236,260
21,115,5298,339,172,167
21,115,11324,363,185,178
21,115,2233,14,6,8
21,115,1549,30,17,13
21,115,1753,28,15,13
21,115,1628,32,19,13
21,115,2425,16,9,7
21,115,1530,8,4,4
21,115,4811,201,109,92
21,115,1464,21,12,9
21,115,749,3,1,2
21,115,1786,19,12,7
21,115,1717,11,7,4
21,115,1148,5,3,2
21,115,1455,12,5,7
21,115,1337,6,3,3
21,115,1537,25,11,14
21,115,1092,22,13,9
21,115,832,12,7,5
21,115,2335,19,9,10
21,115,2240,35,24,11
21,115,3758,29,19,10
21,115,2106,49,27,22
21,115,2391,19,12,7
21,115,3524,32,19,13
21,115,839,14,8,6
21,115,787,11,7,4
21,115,989,7,3,4
21,115,8065,247,131,116
21,115,4342,24,12,12
21,115,4529,35,17,18
21,115,4292,40,24,16
21,115,23221,816,390,426
21,115,9255,623,325,298
21,115,18943,217,103,114
21,115,5108,74,41,33
21,115,14609,480,252,228
21,115,5469,23,11,12
21,115,3066,11,4,7
21,115,1529,2,0,2
21,115,1640,15,7,8
21,115,3400,14,9,5
21,115,12444,170,74,96
21,115,122,1,0,1
21,115,185,1,0,1
21,115,174,6,4,2
21,115,306,9,4,5
21,115,247,2,1,1
21,115,566,16,9,7
21,115,787,16,8,8
21,115,559,7,5,2
21,115,328,4,2,2
21,115,600,4,1,3
21,115,192,3,2,1
21,115,184,39,21,18
21,115,479,2,0,2
21,115,105,5,3,2
21,115,531,17,10,7
21,115,659,6,3,3
21,115,573,16,6,10
21,115,735,8,5,3
21,115,665,20,11,9
21,115,853,5,3,2
21,115,801,18,11,7
21,115,390,1,1,0
21,115,105,14,5,9
21,115,201,1,1,0
21,115,774,19,11,8
21,115,906,24,14,10
21,115,1108,22,13,9
21,115,1028,11,6,5
21,115,1003,7,2,5
21,115,1326,14,7,7
21,115,1874,23,10,13
21,115,1324,1,1,0
21,115,887,11,6,5
21,115,1720,16,9,7
21,115,1331,215,121,94
21,115,859,43,23,20
21,115,558,3,1,2
21,115,1331,3,2,1
21,115,1253,110,54,56
21,115,843,126,71,55
21,115,689,3,2,1
21,115,1554,20,11,9
21,115,1905,108,57,51
21,115,1450,14,6,8
21,115,1237,2,1,1
21,115,1679,17,9,8
21,115,1365,47,22,25
21,115,1032,130,68,62
21,115,1006,15,7,8
21,115,959,30,16,14
21,115,821,3,1,2
21,115,2460,27,15,12
21,115,1619,15,8,7
21,115,1089,0,0,0
21,115,1396,11,6,5
21,115,1083,73,39,34
21,115,1783,16,11,5
21,115,2900,74,34,40
21,115,1444,15,6,9
21,115,1584,19,9,10
21,115,843,1,1,0
21,115,1812,377,190,187
21,115,1172,8,6,2
21,115,964,18,8,10
21,115,1748,4,2,2
21,115,1554,2,2,0
21,115,1926,10,3,7
21,115,786,7,2,5
21,115,1213,35,17,18
21,115,914,7,5,2
21,115,1070,24,10,14
21,115,793,4,4,0
21,115,1446,18,9,9
21,115,510,3,1,2
21,115,1100,27,14,13
21,115,1935,54,15,39
21,115,1577,46,21,25
21,115,1063,35,21,14
21,115,932,21,10,11
21,115,1014,8,5,3
21,115,639,11,5,6
21,115,463,1,1,0
21,115,941,29,16,13
21,115,883,64,39,25
21,115,1361,54,24,30
21,115,1511,12,7,5
21,115,1473,56,30,26
21,115,1726,23,12,11
21,115,1322,2,2,0
21,115,2113,9,6,3
21,115,1414,23,14,9
21,115,1588,3,2,1
21,115,2915,47,25,22
21,115,1513,5,2,3
21,115,1443,27,10,17
21,115,1632,36,16,20
21,115,4397,32,18,14
21,115,964,7,3,4
21,115,1364,18,7,11
21,115,1454,6,3,3
21,115,1235,11,5,6
21,115,1371,4,3,1
21,115,1873,14,7,7
21,115,1720,8,4,4
21,115,1218,16,7,9
21,115,693,8,5,3
21,115,2562,63,33,30
21,115,1851,13,9,4
21,115,1636,20,10,10
21,115,2097,21,11,10
21,115,1582,15,7,8
21,115,4694,40,20,20
21,115,4885,77,44,33
21,115,2044,89,46,43
21,115,2714,11,5,6
21,115,1884,23,10,13
21,115,1135,1,0,1
21,115,3938,44,23,21
21,115,921,3,1,2
21,115,1455,49,20,29
21,115,1426,15,6,9
21,115,1359,12,5,7
21,115,1298,12,9,3
21,115,3640,87,47,40
21,115,891,22,12,10
21,115,1027,5,3,2
21,115,1870,7,3,4
21,115,5388,51,28,23
21,115,2995,14,7,7
21,115,776,1,0,1
21,115,1202,1,1,0
21,115,1130,7,3,4
21,115,726,76,34,42
21,115,5206,18,13,5
21,115,8870,131,69,62
21,115,7507,147,69,78
21,115,1935,36,20,16
21,115,4048,98,51,47
21,115,1031,3,2,1
21,115,1235,37,23,14
21,115,1346,34,17,17
21,115,1297,20,11,9
21,115,12295,121,63,58
21,115,3541,37,21,16
21,115,5662,66,33,33
21,115,5411,888,460,428
21,115,9691,294,156,138
21,115,24711,190,105,85
21,115,3384,154,72,82
21,115,15962,305,154,151
21,115,4093,15,10,5
21,115,18541,343,159,184
21,115,10507,64,37,27
21,115,11566,119,62,57
21,115,6666,384,196,188
21,115,4434,197,99,98
21,115,4521,9,5,4
21,115,472,13,7,6
21,115,4873,32,17,15
21,115,223,7,5,2
21,115,84,76,36,40
21,115,350,6,2,4
21,115,407,141,73,68
21,115,403,249,123,126
21,115,528,4,3,1
21,115,258,4,0,4
21,115,970,35,14,21
21,115,645,6,2,4
21,115,443,0,0,0
21,115,1058,94,54,40
21,115,1251,63,34,29
21,115,841,15,8,7
21,115,715,10,5,5
21,115,1323,32,11,21
21,115,1092,26,14,12
21,115,670,6,4,2
21,115,749,8,6,2
21,115,953,9,4,5
21,115,1084,31,15,16
21,115,898,25,12,13
21,115,910,64,29,35
21,115,700,30,15,15
21,115,1262,1,1,0
21,115,1212,32,19,13
21,115,1259,16,9,7
21,115,1020,14,7,7
21,115,833,35,22,13
21,115,655,32,15,17
21,115,948,41,24,17
21,115,1686,29,14,15
21,115,1346,42,19,23
21,115,1196,4,4,0
21,115,1211,18,13,5
21,115,1450,25,13,12
21,115,1284,13,8,5
21,115,1831,3,2,1
21,115,1680,12,5,7
21,115,875,60,32,28
21,115,775,48,23,25
21,115,1032,9,3,6
21,115,1925,26,11,15
21,115,1747,95,57,38
21,115,926,29,14,15
21,115,1222,7,5,2
21,115,1066,23,12,11
21,115,1257,20,12,8
21,115,1014,19,12,7
21,115,1446,37,24,13
21,115,1571,60,31,29
21,115,1711,20,11,9
21,115,1331,17,6,11
21,115,1041,11,6,5
21,115,1253,18,11,7
21,115,1497,19,8,11
21,115,810,9,4,5
21,115,961,5,3,2
21,115,868,18,9,9
21,115,944,20,10,10
21,115,1674,21,10,11
21,115,1525,25,13,12
21,115,1659,15,7,8
21,115,1285,4,2,2
21,115,1073,5,3,2
21,115,1334,73,46,27
21,115,1074,40,21,19
21,115,1288,6,3,3
21,115,1379,12,6,6
21,115,1636,24,13,11
21,115,832,23,11,12
21,115,1243,10,3,7
21,115,902,25,16,9
21,115,582,11,6,5
21,115,417,3,2,1
21,115,2387,26,16,10
21,115,975,25,12,13
21,115,1149,21,12,9
21,115,1241,19,12,7
21,115,896,10,6,4
21,115,925,2,2,0
21,115,702,3,3,0
21,115,2055,16,6,10
21,115,930,0,0,0
21,115,940,8,5,3
21,115,960,12,7,5
21,115,1168,23,12,11
21,115,1183,29,16,13
21,115,1307,19,11,8
21,115,1370,17,8,9
21,115,1228,10,4,6
21,115,980,23,9,14
21,115,792,1,0,1
21,115,1566,3,2,1
21,115,787,55,27,28
21,115,932,11,5,6
21,115,1234,43,22,21
21,115,1697,55,28,27
21,115,1298,12,4,8
21,115,1731,4,2,2
21,115,1922,29,11,18
21,115,1708,128,71,57
21,115,2030,20,9,11
21,115,1121,9,3,6
21,115,899,5,3,2
21,115,872,31,16,15
21,115,1620,23,14,9
21,115,1628,34,18,16
21,115,1620,20,9,11
21,115,1313,41,22,19
21,115,2090,41,20,21
21,115,5187,45,19,26
21,115,2599,147,83,64
21,115,2348,42,16,26
21,115,4667,38,14,24
21,115,1325,54,26,28
21,115,1514,14,6,8
21,115,919,49,26,23
21,115,1366,3,1,2
21,115,2532,20,8,12
21,115,755,13,11,2
21,115,772,17,10,7
21,115,919,12,4,8
21,115,930,1,0,1
21,115,979,8,5,3
21,115,1761,20,11,9
21,115,1243,3,2,1
21,115,2446,5,2,3
21,115,2333,50,28,22
21,115,17712,701,366,335
21,115,1219,14,9,5
21,115,1375,4,2,2
21,115,4272,30,15,15
21,115,1212,7,7,0
21,115,1028,2,0,2
21,115,1853,66,32,34
21,115,1918,43,21,22
21,115,6026,306,163,143
21,115,12432,175,74,101
21,115,2191,25,15,10
21,115,6648,59,31,28
21,115,5185,42,19,23
21,115,2064,263,137,126
21,115,3194,108,58,50
21,115,1911,13,7,6
21,115,2163,5,3,2
21,115,1706,15,6,9
21,115,1587,23,12,11
21,115,1140,24,13,11
21,115,1192,12,6,6
21,115,1152,2,2,0
21,115,1238,3,2,1
21,115,1033,44,20,24
21,115,1092,23,10,13
21,115,2414,24,14,10
21,115,2784,33,19,14
21,115,2415,45,24,21
21,115,1315,15,5,10
21,115,3493,252,143,109
21,115,3361,41,23,18
21,115,3650,27,15,12
21,115,2766,42,17,25
21,115,24132,823,407,416
21,115,16792,367,193,174
21,115,4664,71,33,38
21,115,6787,196,102,94
21,115,3721,14,7,7
21,115,12772,356,172,184
21,115,4211,7,3,4
21,115,15675,122,59,63
21,115,3586,15,8,7
21,115,10563,400,208,192
21,115,22388,421,216,205
21,115,1136,6,2,4
21,115,1887,14,4,10
21,115,4366,179,83,96
21,115,1486,17,10,7
21,115,3399,12,5,7
21,115,859,22,14,8
21,115,4849,65,30,35
21,115,5372,121,61,60
21,115,8774,165,82,83
21,115,5553,231,123,108
21,115,3555,44,25,19
21,115,1790,58,27,31
21,115,2809,61,28,33
21,116,3742,17,6,11
21,116,3927,63,36,27
21,116,3029,741,371,370
21,116,4164,196,106,90
21,116,2952,6,2,4
21,116,2720,59,33,26
21,116,7050,203,109,94
21,116,4339,17,6,11
21,116,2559,7,3,4
21,116,8019,47,15,32
21,116,2116,2,1,1
21,116,2588,6,4,2
21,116,3817,7,5,2
21,116,4187,7,4,3
21,116,1502,0,0,0
21,116,2335,26,12,14
21,117,2203,186,100,86
21,117,1197,1,1,0
21,117,907,0,0,0
21,117,4971,24,12,12
21,117,1435,11,9,2
21,117,1390,4,3,1
21,117,3155,85,42,43
21,117,1718,10,5,5
21,117,2802,55,30,25
21,117,3282,70,30,40
21,118,3017,21,10,11
21,118,1967,8,4,4
21,118,3093,15,8,7
21,118,2828,30,11,19
21,118,1079,23,14,9
21,118,2649,11,5,6
21,118,5002,21,7,14
21,119,2685,3,1,2
21,119,1971,5,2,3
21,119,6691,22,10,12
21,119,3557,83,38,45
21,119,1050,11,5,6
21,119,1492,3,1,2
21,119,2787,4,1,3
21,120,2893,35,15,20
21,120,7288,234,121,113
21,120,3806,68,30,38
21,120,5307,94,45,49
21,120,2878,34,17,17
21,120,2448,14,7,7
21,120,3929,150,81,69
21,120,3645,34,20,14
21,120,2894,24,17,7
21,120,4800,24,13,11
21,120,2234,30,18,12
21,120,2893,33,16,17
21,120,15090,470,247,223
21,120,11878,324,168,156
21,120,4772,160,78,82
21,120,3981,131,67,64
21,120,5585,109,59,50
21,120,18515,279,116,163
21,120,3769,227,106,121
21,120,6303,67,37,30
21,121,3692,24,11,13
21,121,2077,28,15,13
21,122,774,7,4,3
21,122,259,0,0,0
21,122,255,2,1,1
21,123,2645,27,13,14
21,123,2726,13,10,3
21,123,1775,6,1,5
21,123,3199,3,2,1
21,123,918,1,1,0
21,124,1514,6,2,4
21,124,1072,3,3,0
21,124,772,12,6,6
21,125,2554,6,4,2
21,125,2344,6,2,4
21,125,5789,6,5,1
21,125,1671,40,18,22
21,125,1710,1,1,0
21,125,1923,0,0,0
21,126,1549,217,111,106
21,126,3465,42,20,22
21,126,2294,33,18,15
21,126,1433,19,10,9
21,127,2818,144,73,71
21,127,1805,69,43,26
21,127,1969,140,75,65
21,128,1010,103,49,54
21,128,998,125,56,69
21,128,815,24,14,10
21,128,712,33,19,14
21,129,1418,22,12,10
21,129,1077,5,1,4
21,129,2559,4,2,2
21,129,1261,2,0,2
21,129,2647,89,46,43
21,129,1369,0,0,0
21,130,2720,4,2,2
21,130,3536,113,52,61
21,130,2594,8,3,5
21,130,878,0,0,0
21,130,1164,12,4,8
21,130,1244,1,0,1
21,130,1882,3,1,2
21,131,918,0,0,0
21,131,1492,8,5,3
21,131,607,16,7,9
21,131,622,1,0,1
21,132,973,15,9,6
21,133,5629,400,206,194
21,133,4651,170,85,85
21,133,2467,15,6,9
21,133,1397,29,18,11
21,133,1583,5,3,2
21,133,1257,0,0,0
21,133,938,2,0,2
21,133,1776,23,10,13
21,133,1180,10,4,6
21,133,1458,22,11,11
21,133,1617,32,18,14
21,133,574,2,2,0
21,133,1550,37,21,16
21,133,1690,7,4,3
21,133,1526,2,1,1
21,133,1082,10,5,5
21,133,313,5,4,1
21,133,369,1,1,0
21,133,609,15,9,6
21,133,1154,12,6,6
21,133,1412,1,0,1
21,133,568,0,0,0
21,133,2859,330,165,165
21,133,1524,33,16,17
21,133,1168,7,4,3
21,133,1246,8,2,6
21,133,3579,22,9,13
21,133,3477,100,49,51
21,133,5093,175,88,87
21,133,2679,40,18,22
21,133,8300,34,16,18
21,133,6294,37,20,17
21,133,2960,11,6,5
21,133,4378,30,16,14
21,133,5247,38,23,15
21,133,3884,64,32,32
21,133,6552,457,226,231
21,133,5357,21,14,7
21,133,5725,28,14,14
21,133,3081,45,25,20
21,133,3032,506,256,250
21,133,2582,152,80,72
21,133,4000,9,3,6
21,133,4032,27,14,13
21,133,2549,25,14,11
21,133,2225,2,1,1
21,133,4802,30,14,16
21,133,2135,38,20,18
21,133,2313,4,4,0
21,133,2710,43,21,22
21,133,4650,60,29,31
21,133,5726,82,43,39
21,133,2440,19,9,10
21,133,3564,7,3,4
21,134,753,11,3,8
21,135,3323,8,5,3
21,135,2019,12,7,5
21,135,2433,20,10,10
21,135,3116,130,74,56
21,135,2808,22,12,10
21,135,1821,0,0,0
21,135,1679,7,3,4
21,135,2057,6,3,3
21,135,1602,0,0,0
21,136,526,0,0,0
21,137,3148,27,15,12
21,137,2765,13,5,8
21,137,3002,35,15,20
21,137,4240,54,27,27
21,138,1884,108,57,51
21,138,2160,129,56,73
21,138,4447,28,14,14
21,138,3064,32,14,18
21,139,1996,50,22,28
21,139,3336,9,4,5
21,139,1384,2,2,0
21,139,3237,29,16,13
21,139,2030,7,3,4
21,140,3381,20,10,10
21,140,706,0,0,0
21,141,4995,77,42,35
21,141,3035,51,29,22
21,141,4983,87,43,44
21,141,2974,47,17,30
21,141,1924,38,16,22
21,141,1899,103,45,58
21,141,1019,245,127,118
21,141,2312,4,1,3
21,141,947,12,6,6
21,141,803,11,6,5
21,141,1059,22,12,10
21,141,1066,20,10,10
21,141,4336,82,43,39
21,141,851,29,17,12
21,141,1034,13,4,9
21,141,1626,213,119,94
21,141,2699,44,24,20
21,141,2479,45,19,26
21,141,5926,46,24,22
21,141,1966,29,17,12
21,141,3754,105,58,47
21,141,5385,45,24,21
21,141,3169,6,4,2
21,141,2969,23,13,10
21,141,5632,201,108,93
21,141,1934,63,34,29
21,141,3684,37,20,17
21,141,2706,94,46,48
21,141,2329,9,2,7
21,141,2193,50,24,26
21,141,3984,74,35,39
21,141,4343,109,56,53
21,141,514,5,1,4
21,141,2221,8,3,5
21,141,1189,44,24,20
21,141,1308,26,13,13
21,141,1333,44,16,28
21,141,1890,28,12,16
21,141,2935,37,19,18
21,141,9118,122,54,68
21,141,17875,337,168,169
21,141,1972,6,5,1
21,141,2166,30,20,10
21,141,3049,9,5,4
21,141,2203,11,7,4
21,141,2756,17,7,10
21,142,1215,8,5,3
21,142,2122,1,0,1
21,143,5144,124,79,45
21,143,2077,24,16,8
21,143,2915,41,22,19
21,143,2721,33,16,17
21,143,3677,16,9,7
21,143,2062,10,6,4
21,143,2463,15,9,6
21,143,4327,49,25,24
21,143,2862,33,18,15
21,143,2386,24,8,16
21,144,3655,11,5,6
21,144,2198,29,14,15
21,144,2466,30,19,11
21,144,3138,6,2,4
21,144,1964,9,5,4
21,144,5810,14,7,7
21,144,2951,1,0,1
21,144,2928,2,2,0
21,144,3844,15,7,8
21,144,5919,16,9,7
21,145,5236,14,8,6
21,145,4224,17,8,9
21,145,3049,3,2,1
21,145,4206,16,8,8
21,146,751,1,0,1
21,147,1738,66,40,26
21,147,1101,20,13,7
21,147,1643,2,2,0
21,147,1767,1,1,0
21,148,2221,5,2,3
21,148,1791,48,27,21
21,148,876,9,7,2
21,148,3344,27,17,10
21,148,3761,4,1,3
21,149,3103,9,5,4
21,149,3423,11,2,9
21,149,7723,57,31,26
21,149,4266,20,10,10
21,149,565,1,0,1
21,149,9644,143,69,74
21,150,3245,7,3,4
21,150,2992,14,9,5
21,150,2719,8,5,3
21,151,1091,3,1,2
21,151,3535,24,13,11
21,151,1458,7,4,3
21,151,1945,6,2,4
21,151,2220,9,4,5
21,151,2107,35,13,22
21,152,5604,47,19,28
21,152,2164,7,4,3
21,152,1609,168,74,94
21,152,1626,4,2,2
21,152,3148,12,8,4
21,152,1942,8,3,5
21,152,2845,169,85,84
21,152,1896,16,10,6
21,152,2993,10,5,5
21,153,5506,141,70,71
21,153,3117,16,8,8
21,153,1994,6,3,3
21,153,1537,1,1,0
21,153,2537,8,4,4
21,153,4899,101,51,50
21,153,5569,88,49,39
21,153,3685,8,4,4
21,153,4156,1009,523,486
21,153,895,1,1,0
21,153,4602,10,7,3
21,153,5228,10,3,7
21,153,1750,11,5,6
21,153,4820,13,7,6
21,153,3968,14,4,10
21,153,2475,13,5,8
21,153,2581,6,3,3
21,153,2525,5,2,3
21,153,1981,10,5,5
21,153,5198,12,7,5
21,153,3861,4,1,3
21,153,2656,9,3,6
21,154,2123,6,5,1
21,154,1648,18,11,7
21,154,972,48,19,29
21,154,282,0,0,0
21,154,1307,24,11,13
21,155,23056,476,238,238
21,155,4308,215,107,108
21,155,17635,272,144,128
21,155,12497,172,91,81
21,155,9397,459,246,213
21,155,606,15,6,9
21,155,677,17,6,11
21,155,4818,81,39,42
21,155,4913,40,23,17
21,155,2674,39,17,22
21,155,2929,34,14,20
21,155,7062,34,15,19
21,155,3002,17,8,9
21,155,2179,1,0,1
21,155,1750,31,19,12
21,155,714,9,4,5
21,155,1905,40,20,20
21,155,2081,17,7,10
21,155,8796,109,59,50
21,155,1623,3,1,2
21,155,1004,24,13,11
21,155,1750,24,12,12
21,155,1088,3,2,1
21,155,1424,19,9,10
21,155,1541,11,9,2
21,155,1787,3,1,2
21,155,1586,11,3,8
21,155,2226,31,16,15
21,155,3723,37,19,18
21,155,1656,7,5,2
21,155,1251,22,12,10
21,155,511,0,0,0
21,155,982,26,14,12
21,155,540,9,6,3
21,155,907,30,14,16
21,155,722,5,3,2
21,155,1703,17,9,8
21,155,4188,66,33,33
21,155,1401,40,24,16
21,155,1567,23,12,11
21,155,692,5,3,2
21,155,1011,19,10,9
21,155,3308,58,24,34
21,155,1106,16,11,5
21,155,2723,22,15,7
21,155,2254,70,31,39
21,155,1062,9,4,5
21,155,1228,6,5,1
21,155,1141,10,5,5
21,155,779,1,0,1
21,155,1061,1,1,0
21,155,4441,22,12,10
21,155,19734,140,67,73
21,155,3711,37,15,22
21,155,1679,17,10,7
21,155,1463,6,3,3
21,155,2093,6,4,2
21,155,2753,43,16,27
21,155,2690,90,51,39
21,155,2503,17,8,9
21,155,3680,27,21,6
21,155,3961,44,21,23
21,155,4027,31,14,17
21,155,1366,71,37,34
21,155,1594,48,23,25
21,155,4558,25,12,13
21,155,20890,266,143,123
21,155,5179,22,12,10
21,155,3481,153,78,75
21,155,3926,239,124,115
21,155,1776,56,31,25
21,155,4872,59,29,30
21,155,16272,131,71,60
21,155,3498,65,37,28
21,155,5049,6,2,4
21,155,7127,16,10,6
21,155,1796,1,1,0
21,155,14298,316,152,164
21,155,6467,9,5,4
21,155,4662,18,8,10
21,155,2829,50,26,24
21,155,3477,18,13,5
21,155,2078,7,5,2
21,156,2487,151,74,77
21,156,2144,198,100,98
21,156,2797,26,13,13
21,156,1176,1,1,0
21,156,973,3,2,1
21,156,1005,14,8,6
21,156,1383,10,8,2
21,156,680,7,3,4
21,157,1350,24,14,10
21,157,2193,60,36,24
21,157,1188,1,0,1
21,157,254,0,0,0
21,157,408,0,0,0
21,157,330,5,3,2
21,157,764,1,1,0
21,157,261,0,0,0
21,158,1703,0,0,0
21,158,1196,0,0,0
21,158,655,6,1,5
21,158,117,3,2,1
21,158,176,0,0,0
21,159,1961,0,0,0
21,159,682,0,0,0
21,159,660,0,0,0
21,159,301,0,0,0
21,160,3451,307,166,141
21,160,2695,7,4,3
21,160,3924,36,21,15
21,160,2640,11,8,3
21,160,3778,59,35,24
21,160,1543,18,8,10
21,160,4835,22,8,14
21,161,2910,6,1,5
21,161,1263,4,2,2
21,162,3126,19,9,10
21,162,3322,81,40,41
21,162,2866,11,4,7
21,162,2170,10,6,4
21,162,4021,7,6,1
21,162,2222,0,0,0
21,162,1588,14,8,6
21,163,2351,46,23,23
21,163,4156,16,5,11
21,163,2309,7,3,4
21,163,4037,25,7,18
21,163,3909,24,10,14
21,163,4429,15,8,7
21,163,2095,8,2,6
21,163,4497,34,16,18
21,163,2921,18,13,5
21,163,3149,12,8,4
21,163,5227,30,16,14
21,163,2880,5,4,1
21,163,2262,50,24,26
21,163,3325,8,2,6
21,163,43,0,0,0
21,163,9286,16,8,8
21,163,2271,4,3,1
21,163,5301,7,4,3
21,163,2481,9,6,3
21,163,4582,19,10,9
21,163,2664,23,12,11
21,163,1910,18,12,6
21,163,4542,24,12,12
21,163,4013,12,7,5
21,164,1216,2,0,2
21,165,1392,5,4,1
21,165,3064,13,9,4
21,165,1981,41,21,20
21,165,988,2,1,1
21,165,863,1,1,0
21,165,596,5,2,3
21,166,1296,136,79,57
21,166,3454,58,34,24
21,166,1048,4,3,1
21,166,2195,1,1,0
21,166,1814,14,8,6
21,166,965,2,0,2
21,167,1785,3,2,1
21,167,3991,3,1,2
21,167,1747,10,4,6
21,168,3354,33,17,16
21,168,3838,12,6,6
21,168,306,1,1,0
21,168,1220,1,0,1
21,168,1582,1,0,1
21,168,1630,4,3,1
21,168,3161,23,13,10
21,168,1624,12,8,4
21,168,1483,7,3,4
21,168,1921,5,2,3
21,168,2168,2,1,1
21,169,3140,126,71,55
21,169,3143,182,90,92
21,169,2219,5,0,5
21,169,3026,33,14,19
21,169,2659,27,11,16
21,169,2620,7,2,5
21,169,2399,8,4,4
21,170,3833,201,114,87
21,171,4495,60,37,23
21,171,3485,22,11,11
21,171,1076,2,2,0
21,171,1399,11,6,5
21,171,418,5,0,5
21,171,2557,0,0,0
21,171,761,0,0,0
21,171,1390,76,42,34
21,171,2771,9,5,4
21,171,2446,8,5,3
21,171,2343,14,7,7
21,171,909,26,13,13
21,171,1183,93,57,36
21,171,530,0,0,0
21,171,790,71,39,32
21,172,3610,19,9,10
21,172,3028,37,22,15
21,173,3313,2,1,1
21,173,1593,1,0,1
21,173,4507,120,57,63
21,173,4272,39,23,16
21,173,549,5,3,2
21,173,3172,16,8,8
21,173,2726,11,3,8
21,173,1310,17,8,9
21,173,1947,10,4,6
21,173,330,3,3,0
21,173,449,6,3,3
21,173,230,2,0,2
21,173,1413,18,11,7
21,173,1718,14,8,6
21,173,1000,52,24,28
21,173,821,25,14,11
21,173,1839,21,8,13
21,173,1427,15,6,9
21,173,268,0,0,0
21,173,1060,4,2,2
21,173,1239,15,4,11
21,173,1771,2,1,1
21,173,2187,28,12,16
21,173,466,3,1,2
21,173,5642,64,30,34
21,173,1500,45,25,20
21,173,1491,130,73,57
21,173,1405,231,139,92
21,173,1790,136,64,72
21,173,4190,14,10,4
21,173,6535,34,17,17
21,173,734,0,0,0
21,173,2124,2,2,0
21,173,6120,4,2,2
21,173,3329,21,11,10
21,173,6137,33,20,13
21,173,3425,8,4,4
21,173,1059,3,2,1
21,173,3673,12,7,5
21,173,8705,69,32,37
21,173,4078,194,100,94
21,174,1145,43,25,18
21,174,3550,26,10,16
21,174,1934,3,2,1
21,174,1257,4,2,2
21,174,1436,4,3,1
21,174,3969,20,8,12
21,175,3513,18,9,9
21,175,2604,46,19,27
21,175,3547,18,10,8
21,176,880,8,5,3
21,176,1344,8,4,4
21,176,1441,30,15,15
21,176,1366,2,0,2
21,176,5340,36,18,18
21,176,4627,43,23,20
21,176,2138,70,44,26
21,176,4076,17,8,9
21,176,2754,26,17,9
21,176,2750,5,1,4
21,176,3420,16,8,8
21,176,2608,14,6,8
21,176,2761,7,5,2
21,176,4046,13,7,6
21,176,3766,3,1,2
21,177,3806,19,11,8
21,177,743,0,0,0
21,177,2423,2,2,0
21,177,1530,24,12,12
21,177,1507,1,0,1
21,177,1931,1,0,1
21,177,1162,1,1,0
21,177,776,3,3,0
21,178,2529,14,7,7
21,178,872,2,1,1
21,178,1615,0,0,0
21,178,1605,0,0,0
21,178,1296,1,1,0
21,178,960,0,0,0
21,178,1702,65,35,30
21,178,946,2,1,1
21,178,1584,3,1,2
21,178,2041,9,6,3
21,179,2924,10,5,5
21,179,2747,11,5,6
21,179,2457,6,2,4
21,179,1708,3,3,0
21,179,2328,14,9,5
21,179,2865,17,10,7
21,179,1706,0,0,0
21,179,1523,3,1,2
21,179,2603,27,13,14
21,179,2360,7,4,3
21,179,954,5,0,5
21,179,1292,2,2,0
21,179,3074,29,12,17
21,179,2884,3,1,2
21,180,4876,4,2,2
21,180,3822,11,6,5
21,180,2221,2,1,1
21,180,1346,2,1,1
21,180,887,0,0,0
21,180,2081,3,2,1
21,180,2669,11,3,8
21,180,3636,29,19,10
21,180,1299,17,11,6
21,180,1429,51,26,25
21,180,1127,1,0,1
21,180,3078,22,12,10
21,180,3844,12,5,7
21,180,4255,16,8,8
21,180,5045,16,9,7
21,181,2174,25,13,12
21,181,2618,153,74,79
21,181,2633,66,36,30
21,182,2730,6,2,4
21,182,2633,18,10,8
21,183,1829,18,12,6
21,183,3156,6,4,2
21,183,931,3,2,1
21,183,422,0,0,0
21,183,5490,9,6,3
21,183,2002,2,1,1
21,183,2739,3,2,1
21,183,3058,21,9,12
21,183,1474,1,0,1
21,184,1581,1,0,1
21,184,1054,2,2,0
21,184,2206,5,3,2
21,184,862,1,0,1
21,184,663,0,0,0
21,185,1842,2,0,2
21,185,1844,11,8,3
21,185,2332,2,1,1
21,185,2656,1,1,0
21,185,1670,2,1,1
21,186,2089,10,3,7
21,186,3026,36,16,20
21,186,1425,18,11,7
21,186,2193,34,21,13
21,186,1945,1,0,1
21,186,633,4,3,1
21,186,1017,30,16,14
21,186,2319,2,1,1
21,186,2449,6,3,3
21,186,1018,0,0,0
21,186,3649,7,1,6
21,186,2722,78,41,37
21,186,2164,16,7,9
21,186,2218,89,49,40
21,186,3962,18,11,7
21,186,3294,14,5,9
21,186,2867,1,0,1
21,186,1440,3,3,0
21,186,4138,20,9,11
21,186,1380,2,1,1
21,186,2488,4,3,1
21,186,1985,1,1,0
21,187,1317,5,2,3
21,187,1575,24,14,10
21,187,1134,8,5,3
21,187,908,1,0,1
21,188,3085,8,4,4
21,188,1990,9,6,3
21,188,2364,3,1,2
21,188,1255,5,2,3
21,188,1469,0,0,0
21,188,937,0,0,0
21,188,1649,1,1,0
21,188,3267,162,91,71
21,188,1005,0,0,0
21,188,1093,13,7,6
21,188,1201,32,18,14
21,189,4309,15,9,6
21,189,4222,6,4,2
21,189,3337,1,0,1
21,189,3698,4,2,2
21,189,2818,16,9,7
21,189,1883,12,5,7
21,189,2584,6,2,4
21,190,989,11,8,3
21,190,198,11,5,6
21,191,2817,28,15,13
21,191,1240,29,18,11
21,191,2207,36,19,17
21,191,1008,1,1,0
21,191,625,14,9,5
21,191,1016,46,21,25
21,191,1057,1,1,0
21,192,1792,5,3,2
21,192,2074,23,12,11
21,192,2058,144,68,76
21,193,1306,3,1,2
21,193,1922,267,133,134
21,193,1365,7,4,3
21,193,1875,16,3,13
21,194,2140,7,4,3
21,194,1307,1,0,1
21,194,1313,10,7,3
21,194,1570,28,17,11
21,194,289,0,0,0
21,194,1574,12,6,6
21,194,775,13,3,10
21,194,805,2,2,0
21,194,372,15,7,8
21,194,3579,28,13,15
21,194,3401,19,14,5
21,194,2659,25,13,12
21,194,4476,39,24,15
21,194,2020,2,0,2
21,194,1209,23,14,9
21,194,988,14,10,4
21,195,1059,2,2,0
21,195,2756,9,3,6
21,195,1352,55,29,26
21,195,1422,6,2,4
21,195,2044,4,2,2
21,195,727,3,1,2
21,195,3502,26,12,14
21,195,4497,15,12,3
21,195,6154,315,159,156
21,195,593,0,0,0
21,195,2305,12,7,5
21,196,736,2,1,1
21,196,819,2,0,2
21,197,4113,7,6,1
21,197,3298,2,0,2
21,197,4031,24,10,14
21,197,2199,10,5,5
21,197,5039,33,12,21
21,197,3296,17,8,9
21,197,1103,5,1,4
21,197,2026,40,22,18
21,197,2316,9,4,5
21,197,1949,8,3,5
21,197,3593,6,4,2
21,197,3540,7,3,4
21,197,1632,10,1,9
21,197,2543,2,0,2
21,197,4407,24,14,10
21,197,3024,7,5,2
21,197,2596,15,7,8
21,197,1145,5,4,1
21,197,3401,14,11,3
21,197,2300,4,2,2
21,197,2212,2,1,1
21,197,2653,12,9,3
21,197,2063,34,19,15
21,197,1736,1,0,1
21,197,1643,3,1,2
21,197,1741,1,0,1
21,197,3634,25,19,6
21,197,3044,13,6,7
21,197,3264,13,7,6
21,198,752,2,1,1
21,198,560,0,0,0
21,199,4320,45,30,15
21,199,4052,33,16,17
21,199,4556,13,4,9
21,199,2539,8,2,6
21,199,3493,14,7,7
21,199,3123,4,2,2
21,199,3910,8,4,4
21,199,3073,245,135,110
21,199,4510,32,19,13
21,199,3137,14,5,9
21,199,3358,16,9,7
21,199,2705,15,5,10
21,200,2120,30,21,9
21,200,1340,7,1,6
21,201,1867,26,12,14
21,201,1509,1,0,1
21,202,2867,78,37,41
21,202,2240,265,153,112
21,202,4555,10,5,5
21,202,2804,1,1,0
21,203,3250,12,7,5
21,203,3313,27,19,8
21,203,622,3,1,2
21,204,1796,2,0,2
21,204,1694,3,2,1
21,204,606,2,1,1
21,204,3082,6,3,3
21,205,3274,3,3,0
21,205,4816,11,5,6
21,205,1909,8,2,6
21,205,3132,4,3,1
21,205,2179,8,4,4
21,205,3601,10,3,7
21,205,3867,8,5,3
21,205,977,4,3,1
21,205,2740,11,4,7
21,206,1301,9,5,4
21,206,516,0,0,0
21,206,2356,13,6,7
21,206,486,2,0,2
21,207,1512,5,2,3
21,207,2003,21,13,8
21,207,3694,28,15,13
21,207,3576,58,28,30
21,207,2283,7,3,4
21,207,2484,1,0,1
21,207,1334,3,2,1
21,207,5536,4,3,1
21,207,1952,9,3,6
21,207,925,1,0,1
21,207,1520,9,5,4
21,207,849,2,1,1
21,207,4830,35,17,18
21,207,3103,57,28,29
21,207,4010,21,12,9
21,207,1011,3,1,2
21,207,2149,35,19,16
21,207,1210,144,83,61
21,207,1104,0,0,0
21,207,2754,5,3,2
21,207,582,0,0,0
21,207,1755,6,2,4
21,207,889,0,0,0
21,207,586,7,3,4
21,207,1503,0,0,0
21,207,3623,44,20,24
21,207,839,21,15,6
21,208,2494,5,3,2
21,208,2050,13,8,5
21,208,2247,9,7,2
21,208,2073,12,8,4
21,208,692,5,4,1
21,208,2805,7,6,1
21,208,1341,11,9,2
21,208,1792,3,2,1
21,208,9264,18,7,11
21,208,925,4,1,3
21,208,3533,20,12,8
21,208,2283,85,46,39
21,208,3495,232,114,118
21,208,3580,60,29,31
21,208,1806,9,4,5
21,208,2508,6,2,4
21,208,1006,0,0,0
21,208,1371,5,4,1
21,208,8384,36,18,18
21,208,2403,43,22,21
21,208,4997,18,5,13
21,208,7685,112,57,55
21,208,2341,13,4,9
21,208,1714,0,0,0
21,208,5696,4,3,1
21,208,1353,0,0,0
21,208,2514,24,18,6
21,208,2226,12,6,6
21,208,942,4,2,2
21,208,1001,0,0,0
21,209,3570,1,0,1
21,209,1546,26,14,12
21,209,613,4,2,2
21,209,144,1,0,1
21,209,1357,17,11,6
21,209,79,0,0,0
21,209,674,0,0,0
21,209,340,0,0,0
21,209,254,0,0,0
21,210,1988,47,30,17
21,210,1222,69,32,37
21,210,2465,40,24,16
21,211,2035,51,25,26
21,211,2966,23,9,14
21,211,4572,8,5,3
21,211,3727,30,15,15
21,211,2725,36,24,12
21,211,1065,3,3,0
21,212,1357,3,2,1
21,212,700,1,1,0
21,212,670,0,0,0
21,212,1762,27,12,15
21,212,1790,2,0,2
21,212,2385,28,17,11
21,212,535,0,0,0
21,212,4919,59,28,31
21,212,3323,32,20,12
21,212,598,6,2,4
21,212,1178,5,2,3
21,212,1944,8,6,2
21,213,2940,1,1,0
21,213,770,1,0,1
21,213,1680,0,0,0
21,213,1047,1,0,1
21,213,2367,7,1,6
21,213,748,1,1,0
21,213,2740,27,15,12
21,214,3910,13,5,8
21,214,3067,7,5,2
21,214,2024,325,168,157
21,214,3382,418,231,187
21,214,2425,48,22,26
21,214,3551,195,97,98
21,215,2542,58,29,29
21,215,1997,45,17,28
21,216,2272,12,6,6
21,216,235,1,0,1
21,217,1625,50,26,24
21,217,2107,98,52,46
21,217,3028,11,4,7
21,217,34,0,0,0
21,217,2307,6,4,2
21,217,1115,396,194,202
21,217,813,1,1,0
21,217,1394,2,2,0
21,217,2754,95,48,47
21,217,396,2,0,2
21,217,2296,2,1,1
21,217,2489,12,6,6
21,42,417,2,2,0
21,115,1825,131,74,57
21,115,964,25,17,8
21,115,1503,9,4,5
21,115,1277,15,7,8
21,115,1414,24,10,14
21,115,1319,69,35,34
21,115,1369,23,13,10
21,115,1324,36,18,18
21,115,1495,18,9,9
21,115,1239,6,3,3
21,115,1591,25,15,10
21,115,1059,57,29,28
21,115,1885,99,53,46
21,115,1877,16,10,6
21,115,1352,47,25,22
21,115,2584,56,24,32
21,115,1824,56,29,27
21,115,1898,47,24,23
21,115,2002,183,94,89
21,115,1906,59,39,20
21,115,4986,28,11,17
21,115,3696,17,11,6
21,115,2514,38,22,16
21,115,1857,105,46,59
21,115,1947,187,85,102
21,115,2615,50,27,23
21,115,2391,59,30,29
21,115,2393,13,6,7
21,115,1553,40,19,21
21,115,2027,18,10,8
21,115,1917,15,9,6
21,115,1746,15,6,9
21,115,1965,15,6,9
21,115,1549,85,45,40
21,115,635,26,13,13
21,115,1198,37,19,18
21,115,790,32,16,16
21,115,441,21,10,11
21,115,623,4,3,1
21,115,677,90,49,41
21,115,797,110,50,60
21,115,1819,75,42,33
21,115,380,0,0,0
21,115,2019,49,23,26
21,115,1454,47,24,23
21,115,2705,32,27,5
21,115,483,10,5,5
21,115,1671,76,35,41
21,115,0,0,0,0
21,115,349,5,3,2
21,115,585,13,6,7
21,115,2678,149,75,74
21,115,1825,82,41,41
21,115,2132,58,29,29
21,115,3637,436,230,206
21,115,0,0,0,0
21,115,1940,34,19,15
21,115,998,17,7,10
21,115,1339,46,21,25
21,115,0,0,0,0
21,115,1354,20,10,10
21,115,1415,56,34,22
21,115,0,0,0,0
21,115,1703,72,36,36
21,115,2783,230,124,106
21,115,407,197,95,102
21,115,885,15,8,7
21,115,1746,83,51,32
21,115,1910,28,17,11
21,115,1086,9,4,5
21,115,1274,22,11,11
21,115,815,7,1,6
21,115,5411,64,30,34
21,115,2228,48,24,24
21,115,1528,4,2,2
21,115,4110,78,34,44
21,115,1828,595,302,293
21,115,2156,269,140,129
21,115,1919,9,1,8
21,115,1848,10,7,3
21,115,1428,4,2,2
21,115,3159,24,16,8
21,115,1611,7,2,5
21,120,2624,24,13,11
21,120,2041,134,64,70
21,120,1700,44,23,21
21,120,1545,44,18,26
21,120,1246,11,4,7
21,120,1539,112,68,44
21,120,1892,25,13,12
21,120,2452,76,42,34
21,120,2187,77,41,36
21,120,1355,79,40,39
21,115,793,19,11,8
21,120,2960,19,8,11
21,120,1560,53,18,35
21,120,3031,40,18,22
21,120,3719,104,50,54
21,115,2543,29,14,15
21,115,3629,41,18,23
21,115,2242,4,3,1
21,115,2865,109,50,59
21,115,2124,22,14,8
21,115,3574,15,8,7
21,115,2905,12,4,8
21,115,2980,90,46,44
21,115,3273,27,17,10
21,115,2519,12,5,7
21,115,2658,8,3,5
21,120,746,13,8,5
21,120,898,60,29,31
21,120,92,9,4,5
21,120,209,6,2,4
21,115,3074,32,17,15
21,115,4024,150,84,66
21,115,3290,196,107,89
21,115,2424,68,32,36
21,115,2240,225,119,106
21,115,9096,134,63,71
21,115,2427,139,65,74
21,115,2117,10,4,6
21,115,2657,58,33,25
21,54,4278,16,11,5
21,54,1364,14,4,10
21,17,1722,0,0,0
21,17,4474,1,0,1
21,55,4522,4,3,1
21,55,1220,0,0,0
21,55,540,2,1,1
21,55,1281,10,5,5
21,55,4231,2,1,1
21,186,2427,4,2,2
21,186,2407,5,4,1
21,186,391,0,0,0
21,10,407,0,0,0
21,10,3462,44,19,25
21,10,2257,0,0,0
21,10,327,0,0,0
21,1,3433,6,5,1
21,1,2471,5,3,2
21,39,2739,4,1,3
21,39,4563,35,13,22
21,41,973,7,3,4
21,41,3173,6,4,2
21,41,2423,20,8,12
21,41,430,0,0,0
21,119,495,6,3,3
21,119,4911,25,17,8
21,115,2730,5,2,3
21,115,1202,4,3,1
21,115,848,3,1,2
21,3,2577,8,3,5
21,3,1744,1,1,0
21,153,3344,8,4,4
21,153,1737,4,3,1
21,176,174,1,1,0
21,176,2585,75,43,32
21,176,2599,3,3,0
21,176,610,10,5,5
21,176,1580,1,1,0
21,176,3798,354,182,172
22,1,1253,57,30,27
22,1,1098,0,0,0
22,1,2002,22,14,8
22,1,2115,18,8,10
22,1,2471,3,1,2
22,1,1178,9,4,5
22,1,1316,2,0,2
22,1,1635,4,2,2
22,1,2001,4,2,2
22,1,1510,12,7,5
22,1,2517,25,8,17
22,1,1473,3,1,2
22,1,1399,5,2,3
22,1,3997,16,8,8
22,1,3507,8,5,3
22,1,1565,29,14,15
22,1,2095,3,2,1
22,1,1629,60,28,32
22,1,879,0,0,0
22,1,1109,3,1,2
22,1,2986,3,1,2
22,1,1602,3,2,1
22,1,3099,39,18,21
22,1,2210,3,3,0
22,1,2155,7,3,4
22,1,1788,47,27,20
22,1,1500,5,3,2
22,1,1355,2,1,1
22,1,1442,2,0,2
22,1,1318,5,1,4
22,1,1480,12,7,5
22,1,3082,0,0,0
22,1,815,9,4,5
22,2,2094,2,1,1
22,2,803,0,0,0
22,2,265,0,0,0
22,2,201,0,0,0
22,2,2736,3,0,3
22,2,273,5,2,3
22,2,1102,3,2,1
22,2,1146,10,5,5
22,2,1051,5,2,3
22,2,412,0,0,0
22,2,3299,11,4,7
22,3,4364,11,6,5
22,3,2957,25,11,14
22,3,2422,275,140,135
22,3,3136,119,64,55
22,3,1514,4,3,1
22,3,1825,3,1,2
22,3,1072,1,0,1
22,3,1136,3,2,1
22,3,1508,3,1,2
22,3,1141,0,0,0
22,3,915,4,1,3
22,3,1482,0,0,0
22,3,876,2,1,1
22,3,2310,1,0,1
22,3,3080,10,4,6
22,3,949,1,0,1
22,3,1730,7,3,4
22,3,1455,13,9,4
22,3,3268,21,13,8
22,3,5298,47,23,24
22,3,1156,78,47,31
22,3,1408,78,42,36
22,3,3055,3,2,1
22,3,3546,28,12,16
22,3,2631,9,5,4
22,3,3114,17,8,9
22,3,2634,18,10,8
22,3,1496,0,0,0
22,3,2882,9,3,6
22,4,1906,43,23,20
22,4,2386,233,116,117
22,4,1785,22,12,10
22,4,5468,39,17,22
22,4,559,3,1,2
22,4,1802,6,2,4
22,4,1634,246,123,123
22,4,5018,34,20,14
22,4,2340,11,6,5
22,4,1663,15,9,6
22,4,2203,8,4,4
22,4,3177,18,9,9
22,4,3583,58,27,31
22,4,2801,2,1,1
22,4,2661,4,2,2
22,4,6335,84,43,41
22,4,4397,29,10,19
22,4,3707,7,3,4
22,4,4379,9,2,7
22,5,8666,201,101,100
22,5,4866,129,61,68
22,5,24571,487,244,243
22,5,2145,32,13,19
22,5,5515,131,63,68
22,5,1789,25,11,14
22,5,6867,91,42,49
22,5,2099,21,15,6
22,5,14608,282,136,146
22,5,2456,27,13,14
22,5,2086,19,8,11
22,5,1864,15,6,9
22,5,2085,20,14,6
22,5,3057,23,14,9
22,5,2613,18,7,11
22,5,10992,175,81,94
22,5,12995,163,82,81
22,5,14373,181,76,105
22,5,6825,103,51,52
22,5,9619,208,109,99
22,5,3849,32,13,19
22,5,2142,0,0,0
22,5,4238,10,5,5
22,5,3918,3,3,0
22,6,2994,5,2,3
22,6,2134,23,13,10
22,6,2913,46,28,18
22,6,1465,7,3,4
22,6,2110,17,9,8
22,6,4695,29,14,15
22,6,5622,68,33,35
22,6,1456,248,128,120
22,6,2691,338,173,165
22,6,3030,41,18,23
22,6,2111,26,12,14
22,6,3804,20,11,9
22,6,2277,7,4,3
22,6,2162,41,22,19
22,6,2290,18,12,6
22,6,2171,8,5,3
22,6,693,0,0,0
22,7,3213,57,29,28
22,7,1684,11,5,6
22,7,3002,18,10,8
22,7,1473,13,6,7
22,7,2548,3,1,2
22,7,5654,47,29,18
22,7,2817,9,3,6
22,7,1368,22,9,13
22,7,4277,20,9,11
22,7,1952,12,5,7
22,7,1825,2,2,0
22,7,2498,20,8,12
22,7,1414,8,4,4
22,7,3225,9,6,3
22,8,5347,15,6,9
22,8,3233,17,10,7
22,8,5386,73,35,38
22,8,2617,2,0,2
22,8,1509,3,2,1
22,8,1217,3,2,1
22,8,385,3,2,1
22,8,669,8,6,2
22,8,1362,13,7,6
22,8,618,1,1,0
22,8,605,0,0,0
22,8,1118,0,0,0
22,8,657,10,4,6
22,8,786,3,1,2
22,8,2191,5,2,3
22,9,2886,4,4,0
22,9,902,2,0,2
22,9,1580,2,0,2
22,9,1799,4,2,2
22,9,1128,21,8,13
22,9,970,5,2,3
22,9,1999,11,7,4
22,9,1315,6,3,3
22,9,2077,8,6,2
22,9,905,2,0,2
22,9,449,0,0,0
22,9,561,3,1,2
22,9,1741,12,7,5
22,9,482,1,0,1
22,10,3653,150,77,73
22,10,2812,23,11,12
22,10,5305,325,170,155
22,10,3816,113,55,58
22,10,1131,1,0,1
22,10,1153,29,14,15
22,10,4118,25,14,11
22,10,3970,15,9,6
22,10,4113,18,13,5
22,10,4287,73,37,36
22,10,4153,39,15,24
22,10,2576,12,7,5
22,10,2190,6,3,3
22,10,40592,986,471,515
22,10,5810,20,13,7
22,10,2435,10,7,3
22,10,4643,9,2,7
22,10,3583,81,42,39
22,10,5851,23,10,13
22,10,24026,438,213,225
22,10,16832,412,192,220
22,10,14443,747,354,393
22,10,28736,1403,655,748
22,10,2141,68,41,27
22,10,3066,27,12,15
22,10,3227,23,10,13
22,10,3433,26,13,13
22,11,2387,20,10,10
22,11,1477,5,2,3
22,11,5170,12,6,6
22,11,2113,30,11,19
22,11,4347,18,11,7
22,11,2784,11,6,5
22,11,3721,13,9,4
22,11,3215,34,24,10
22,11,2266,11,6,5
22,11,2439,6,3,3
22,11,2613,6,1,5
22,11,3210,9,2,7
22,11,4281,17,11,6
22,11,2893,97,50,47
22,11,2833,6,3,3
22,11,2155,23,11,12
22,11,3902,2,0,2
22,11,3601,38,18,20
22,11,4876,90,45,45
22,11,1967,11,6,5
22,11,5993,30,11,19
22,11,3775,11,7,4
22,11,893,0,0,0
22,11,4538,21,13,8
22,12,2420,27,13,14
22,12,408,0,0,0
22,12,406,2,0,2
22,12,3171,3,2,1
22,12,664,8,5,3
22,12,551,1,1,0
22,12,1493,5,4,1
22,12,1639,6,5,1
22,12,1194,15,6,9
22,12,477,2,0,2
22,12,978,1,1,0
22,12,3411,8,5,3
22,12,149,2,2,0
22,12,2146,5,2,3
22,13,2552,6,4,2
22,13,1440,4,4,0
22,13,1890,8,5,3
22,13,2191,3,1,2
22,13,1284,11,3,8
22,13,2644,532,273,259
22,13,1617,151,71,80
22,13,447,0,0,0
22,13,1557,8,5,3
22,13,767,3,2,1
22,13,1694,33,14,19
22,13,1393,23,10,13
22,13,1768,2,2,0
22,13,1842,1,0,1
22,13,1818,1,1,0
22,13,687,6,4,2
22,13,871,1,1,0
22,13,334,7,5,2
22,14,6357,244,119,125
22,14,4218,62,25,37
22,14,3629,153,84,69
22,14,2776,51,26,25
22,14,18487,930,441,489
22,14,4288,17,9,8
22,14,2142,13,5,8
22,14,2546,13,7,6
22,14,7987,65,28,37
22,14,26554,514,233,281
22,14,1114,7,3,4
22,14,1444,13,6,7
22,14,3000,26,16,10
22,14,8326,82,41,41
22,14,1131,7,4,3
22,14,1063,6,4,2
22,14,1733,40,21,19
22,14,4840,97,42,55
22,14,1899,20,10,10
22,14,3333,52,27,25
22,14,1077,9,5,4
22,14,1564,20,10,10
22,14,1990,39,13,26
22,14,1168,14,7,7
22,14,1035,7,4,3
22,14,4493,28,12,16
22,14,1622,7,1,6
22,14,1490,3,2,1
22,14,1189,6,4,2
22,14,1245,29,14,15
22,14,4789,29,9,20
22,14,1403,17,3,14
22,14,1535,10,5,5
22,14,6767,115,58,57
22,14,3519,23,7,16
22,14,5198,75,33,42
22,14,1236,50,27,23
22,14,1127,10,6,4
22,14,5403,65,32,33
22,14,1267,7,5,2
22,14,1395,7,2,5
22,14,1147,3,2,1
22,14,1312,11,3,8
22,14,3512,114,57,57
22,14,1216,17,10,7
22,14,1156,12,7,5
22,14,3011,64,33,31
22,14,1095,10,6,4
22,14,5032,53,28,25
22,14,4758,127,65,62
22,14,2679,64,30,34
22,14,1934,15,11,4
22,14,1058,10,6,4
22,14,11670,479,238,241
22,14,1063,22,10,12
22,14,1010,7,2,5
22,14,2574,30,12,18
22,14,4784,255,129,126
22,14,3877,86,51,35
22,14,2661,126,75,51
22,14,1460,31,19,12
22,14,3365,45,21,24
22,14,1857,13,6,7
22,14,1419,9,3,6
22,14,1855,27,11,16
22,14,1544,17,9,8
22,14,2791,28,12,16
22,14,2871,62,25,37
22,14,3345,118,56,62
22,14,1186,112,58,54
22,14,3082,39,15,24
22,14,1407,29,15,14
22,14,961,33,19,14
22,14,4003,92,53,39
22,14,5090,290,163,127
22,14,2648,37,16,21
22,14,2137,68,33,35
22,14,1533,48,18,30
22,14,1206,17,8,9
22,14,2581,67,25,42
22,14,1265,23,9,14
22,14,909,11,6,5
22,14,1679,32,18,14
22,14,9656,180,93,87
22,14,1119,10,5,5
22,14,1635,7,4,3
22,14,2249,142,75,67
22,14,2724,79,33,46
22,14,879,49,24,25
22,14,3879,256,126,130
22,14,2087,118,54,64
22,14,1028,18,7,11
22,14,1163,15,4,11
22,14,1235,61,34,27
22,14,1828,9,3,6
22,14,815,6,3,3
22,14,605,4,2,2
22,14,681,8,5,3
22,14,1154,14,9,5
22,14,838,6,2,4
22,14,879,23,12,11
22,14,976,14,9,5
22,14,2453,25,17,8
22,14,2292,13,7,6
22,14,1293,16,8,8
22,14,1649,19,10,9
22,14,1213,13,9,4
22,14,1216,6,2,4
22,14,563,14,7,7
22,14,895,30,16,14
22,14,1561,8,3,5
22,14,4511,75,32,43
22,14,1455,53,31,22
22,14,1086,21,9,12
22,14,798,17,7,10
22,14,945,47,22,25
22,14,1715,45,31,14
22,14,1402,34,15,19
22,14,1308,83,43,40
22,14,1261,68,37,31
22,14,806,69,34,35
22,14,579,15,4,11
22,14,951,49,21,28
22,14,1396,82,43,39
22,14,1529,116,62,54
22,14,2604,88,47,41
22,14,1282,74,39,35
22,14,2000,71,28,43
22,14,628,9,3,6
22,14,1030,12,7,5
22,14,695,34,16,18
22,14,854,10,3,7
22,14,922,10,6,4
22,14,1034,12,3,9
22,14,12230,265,110,155
22,14,914,2,2,0
22,14,510,6,2,4
22,14,1251,10,2,8
22,14,1231,26,13,13
22,14,435,7,3,4
22,14,889,60,33,27
22,14,500,11,5,6
22,14,600,24,15,9
22,14,787,32,20,12
22,14,709,17,9,8
22,14,882,20,9,11
22,14,3300,131,62,69
22,14,727,8,4,4
22,14,954,22,12,10
22,14,483,7,6,1
22,14,1011,15,9,6
22,14,1169,15,5,10
22,14,968,6,5,1
22,14,772,10,4,6
22,14,817,2,0,2
22,14,796,16,8,8
22,14,1187,44,19,25
22,14,5292,198,103,95
22,14,827,7,2,5
22,14,705,31,16,15
22,14,1064,43,25,18
22,14,816,14,8,6
22,14,752,19,6,13
22,14,768,4,3,1
22,14,1063,13,6,7
22,14,9689,392,206,186
22,14,885,14,7,7
22,14,1061,18,9,9
22,14,624,64,37,27
22,14,1096,30,11,19
22,14,1158,33,20,13
22,14,1466,9,7,2
22,14,1236,9,6,3
22,14,1138,7,5,2
22,14,1216,3,2,1
22,14,1432,24,10,14
22,14,1953,40,22,18
22,14,1173,11,7,4
22,14,1281,24,12,12
22,14,1135,57,29,28
22,14,1138,15,7,8
22,14,873,17,12,5
22,14,1157,46,22,24
22,14,768,44,26,18
22,14,982,36,20,16
22,14,1271,19,9,10
22,14,1264,81,43,38
22,14,1171,15,8,7
22,14,1274,5,5,0
22,14,983,7,3,4
22,14,1142,40,19,21
22,14,1073,9,3,6
22,14,978,28,18,10
22,14,1411,27,13,14
22,14,1017,44,23,21
22,14,1119,8,6,2
22,14,2279,32,20,12
22,14,1171,41,22,19
22,14,1275,20,8,12
22,14,786,20,9,11
22,14,1214,16,9,7
22,14,1027,3,1,2
22,14,1297,19,7,12
22,14,1128,57,33,24
22,14,993,5,3,2
22,14,5720,97,43,54
22,14,1025,25,12,13
22,14,1570,28,16,12
22,14,1105,9,3,6
22,14,1400,42,26,16
22,14,1522,12,7,5
22,14,2567,236,131,105
22,14,1065,151,74,77
22,14,5732,475,241,234
22,14,1085,26,14,12
22,14,905,4,2,2
22,14,1672,21,10,11
22,14,1408,29,16,13
22,14,2100,14,7,7
22,14,1218,14,9,5
22,14,1093,30,16,14
22,14,10139,201,100,101
22,14,3024,63,30,33
22,14,1540,9,4,5
22,14,1574,14,5,9
22,14,5356,84,42,42
22,14,1450,6,3,3
22,14,1421,12,8,4
22,14,1347,19,10,9
22,14,1373,3,1,2
22,14,1888,14,8,6
22,14,1664,5,2,3
22,14,1661,28,14,14
22,14,1647,1,1,0
22,14,1649,8,2,6
22,14,1431,0,0,0
22,14,1608,55,31,24
22,14,1644,59,34,25
22,14,2341,51,31,20
22,14,1197,10,4,6
22,14,2523,33,16,17
22,14,2423,32,16,16
22,14,1792,34,17,17
22,14,10969,120,53,67
22,14,7135,77,43,34
22,14,4882,75,35,40
22,14,3470,22,12,10
22,14,5300,22,11,11
22,14,3872,17,12,5
22,14,2374,8,2,6
22,14,1750,9,5,4
22,14,4685,18,10,8
22,14,2383,9,6,3
22,14,3058,13,7,6
22,14,3029,0,0,0
22,14,3160,4,2,2
22,14,8010,25,12,13
22,14,2434,10,6,4
22,14,15480,143,62,81
22,14,1693,40,18,22
22,14,3636,29,12,17
22,14,2886,11,3,8
22,14,2606,54,26,28
22,14,1916,6,3,3
22,14,1070,19,8,11
22,14,3431,56,26,30
22,14,4116,10,5,5
22,14,2228,26,17,9
22,14,4868,45,28,17
22,14,3387,7,3,4
22,14,2138,3,1,2
22,14,2196,5,2,3
22,14,3367,38,20,18
22,14,19390,705,336,369
22,14,3001,12,8,4
22,14,3530,14,8,6
22,14,6379,88,36,52
22,14,8354,180,88,92
22,14,8743,157,75,82
22,14,7829,111,56,55
22,14,29249,1065,496,569
22,14,1249,18,8,10
22,10,2208,23,14,9
22,15,1094,14,6,8
22,15,3406,5,3,2
22,15,1565,8,6,2
22,15,411,1,0,1
22,15,1002,1,0,1
22,15,279,0,0,0
22,15,299,0,0,0
22,16,2484,7,7,0
22,16,4164,21,8,13
22,16,16950,274,149,125
22,16,2360,33,19,14
22,16,3064,91,45,46
22,16,1150,10,4,6
22,16,3039,31,14,17
22,16,3464,48,24,24
22,16,1393,16,8,8
22,16,1481,23,11,12
22,16,2440,68,29,39
22,16,1472,41,21,20
22,16,1709,84,52,32
22,16,1051,61,29,32
22,16,887,3,1,2
22,16,1041,20,10,10
22,16,1652,39,21,18
22,16,882,11,5,6
22,16,1056,29,18,11
22,16,2160,8,6,2
22,16,6158,47,20,27
22,16,8784,98,40,58
22,16,11052,119,50,69
22,16,1497,22,12,10
22,16,976,7,1,6
22,16,1265,36,18,18
22,16,1357,5,3,2
22,16,1602,20,5,15
22,16,1090,7,4,3
22,16,1158,6,2,4
22,16,1182,2,1,1
22,16,6493,93,43,50
22,16,1050,7,4,3
22,16,900,28,12,16
22,16,1359,10,5,5
22,16,8658,120,59,61
22,16,2530,51,24,27
22,16,1047,9,6,3
22,16,1201,4,1,3
22,16,1213,11,5,6
22,16,1157,19,10,9
22,16,3421,42,21,21
22,16,1988,35,16,19
22,16,4359,21,6,15
22,16,3895,20,9,11
22,16,2724,18,7,11
22,16,1718,3,2,1
22,16,3569,32,16,16
22,16,3197,9,4,5
22,16,3692,39,20,19
22,16,7978,25,9,16
22,16,4110,42,19,23
22,16,4181,25,10,15
22,16,2474,12,5,7
22,16,4958,25,13,12
22,16,4249,1464,761,703
22,16,2497,11,5,6
22,16,3672,15,7,8
22,16,9559,68,29,39
22,16,2593,22,15,7
22,16,2560,8,3,5
22,16,18591,245,139,106
22,16,498,84,43,41
22,16,2725,7,5,2
22,16,2190,4,4,0
22,16,1820,1,0,1
22,16,6617,22,11,11
22,16,2431,11,5,6
22,16,2944,87,46,41
22,16,2937,6,3,3
22,16,1897,12,4,8
22,16,2968,6,6,0
22,16,2581,4,0,4
22,16,3483,3,3,0
22,16,3608,217,117,100
22,16,3248,14,6,8
22,16,3791,10,3,7
22,16,1506,3,0,3
22,17,848,2,0,2
22,17,2204,27,9,18
22,17,2681,37,20,17
22,17,2940,11,6,5
22,17,3917,23,13,10
22,17,1378,18,11,7
22,17,1529,15,9,6
22,17,1517,15,6,9
22,17,294,4,3,1
22,17,2053,0,0,0
22,17,1608,9,5,4
22,17,768,7,5,2
22,17,2508,163,97,66
22,17,1522,3,2,1
22,17,2770,7,4,3
22,17,4792,60,32,28
22,17,2855,12,7,5
22,17,2049,4,1,3
22,17,1659,1,0,1
22,17,1311,0,0,0
22,17,1056,4,3,1
22,17,3163,8,6,2
22,17,4258,11,5,6
22,17,3772,70,32,38
22,17,3522,3,2,1
22,17,2213,7,4,3
22,17,2184,7,4,3
22,17,3249,27,18,9
22,17,3388,52,21,31
22,17,4357,32,11,21
22,18,2288,16,12,4
22,18,1782,19,10,9
22,18,276,0,0,0
22,18,2553,10,4,6
22,18,1042,1,1,0
22,18,3383,11,7,4
22,18,1182,1,0,1
22,18,1313,4,1,3
22,18,3075,46,24,22
22,18,2808,187,96,91
22,18,3775,129,63,66
22,18,67,0,0,0
22,18,1114,7,3,4
22,18,3252,63,37,26
22,5,5740,201,113,88
22,5,634,10,5,5
22,5,1358,5,2,3
22,14,837,0,0,0
22,14,950,540,287,253
22,14,1166,132,74,58
22,5,1737,8,3,5
22,5,3262,15,5,10
22,14,1537,34,17,17
22,14,1639,13,6,7
22,14,1830,31,18,13
22,14,1818,26,10,16
22,14,1612,9,4,5
22,14,1387,53,28,25
22,14,2107,95,42,53
22,14,1864,50,22,28
22,14,1252,35,20,15
22,14,1446,23,13,10
22,14,1358,59,37,22
22,14,1246,5,2,3
22,14,1201,17,6,11
22,14,1242,15,7,8
22,14,1608,20,11,9
22,14,1224,0,0,0
22,14,1608,67,39,28
22,14,2070,41,16,25
22,14,1575,44,16,28
22,14,2680,48,22,26
22,14,1635,26,13,13
22,14,1471,6,2,4
22,14,2024,17,11,6
22,14,1715,17,8,9
22,14,1141,5,0,5
22,14,1111,8,3,5
22,14,3026,42,21,21
22,14,2944,85,37,48
22,14,1611,27,10,17
22,14,4639,121,64,57
22,14,1397,3,2,1
22,14,5053,111,47,64
22,14,1305,19,8,11
22,14,1393,9,5,4
22,14,822,11,7,4
22,14,1279,63,27,36
22,14,2245,37,18,19
22,14,3005,157,82,75
22,14,548,5,3,2
22,14,559,2,2,0
22,14,1205,17,6,11
22,14,1212,8,2,6
22,14,1174,21,11,10
22,14,1498,4,1,3
22,14,1501,18,12,6
22,14,1928,0,0,0
22,14,0,0,0,0
22,14,1882,19,12,7
22,14,1438,101,58,43
22,14,1934,253,129,124
22,14,422,44,20,24
22,14,1734,19,8,11
22,14,742,13,4,9
22,14,961,4,0,4
22,14,1635,9,6,3
22,14,4789,59,34,25
22,14,2007,12,4,8
22,14,11701,280,116,164
22,14,31334,929,449,480
22,14,1684,18,11,7
22,14,1277,15,6,9
22,14,779,0,0,0
22,14,2486,64,35,29
22,14,4992,65,29,36
22,10,1461,13,9,4
22,10,16172,264,123,141
22,10,2174,7,1,6
22,10,2395,34,14,20
22,5,1131,17,10,7
22,5,1348,9,4,5
22,5,1778,50,32,18
22,5,1700,130,70,60
22,5,886,21,6,15
22,5,995,30,16,14
22,5,2609,53,30,23
22,5,788,20,12,8
22,5,1487,9,5,4
22,5,1161,17,7,10
22,5,999,37,16,21
22,5,1467,19,9,10
22,5,1282,17,12,5
22,5,1165,17,8,9
22,5,1291,90,49,41
22,5,1507,23,11,12
22,5,641,3,2,1
22,5,607,2,2,0
22,5,1519,5,1,4
22,5,1105,1,1,0
22,5,1751,51,23,28
22,5,1672,141,75,66
22,5,1319,27,16,11
22,5,500,6,3,3
22,5,3716,53,28,25
22,5,1670,54,31,23
22,5,1139,0,0,0
22,5,1285,8,5,3
22,5,1487,4,1,3
22,5,2122,27,12,15
22,5,998,12,7,5
22,5,1740,32,17,15
22,5,729,40,16,24
22,16,1157,25,13,12
22,16,1792,56,29,27
22,16,1796,11,6,5
22,16,845,1,0,1
22,16,1519,27,9,18
22,16,2212,27,11,16
22,16,1248,18,7,11
22,16,2798,20,8,12
22,16,1374,13,6,7
22,16,945,14,5,9
22,16,1506,7,3,4
22,16,1962,34,19,15
22,16,1910,36,16,20
22,16,1872,33,12,21
22,16,909,7,1,6
22,16,701,26,11,15
22,16,787,6,2,4
22,16,1370,3,0,3
22,16,878,16,5,11
22,16,1034,1,1,0
22,16,977,11,5,6
22,16,1323,4,2,2
22,14,1256,19,8,11
22,14,1615,23,9,14
22,14,762,4,2,2
22,14,1553,13,9,4
22,14,936,16,9,7
22,14,166,9,3,6
22,14,1871,65,31,34
22,14,1624,120,56,64
22,14,1514,8,3,5
22,14,933,3,1,2
22,14,1350,10,6,4
22,14,1749,16,7,9
22,14,754,32,20,12
22,14,1124,35,20,15
22,14,1217,33,15,18
22,14,843,22,11,11
22,14,965,38,17,21
22,14,1751,34,15,19
22,14,1458,18,8,10
22,14,1335,52,26,26
22,14,957,33,19,14
22,14,1694,21,8,13
22,14,757,5,4,1
22,14,1238,77,38,39
22,14,1186,12,6,6
22,14,873,6,4,2
22,14,757,16,7,9
22,14,4627,158,79,79
22,14,798,12,4,8
22,14,926,5,2,3
22,14,810,9,5,4
22,14,1320,30,10,20
22,14,985,5,0,5
22,14,755,6,4,2
22,14,1147,23,14,9
22,14,2573,102,46,56
22,14,1999,29,13,16
22,14,2876,22,8,14
22,14,3670,69,40,29
22,14,2686,64,31,33
22,14,3716,44,23,21
22,14,3091,9,3,6
22,14,2949,16,5,11
22,14,4116,60,25,35
22,14,1638,36,20,16
22,14,2712,7,5,2
22,14,2423,4,2,2
22,14,2998,67,33,34
22,14,4451,430,208,222
22,14,3180,323,161,162
22,14,4425,72,30,42
22,14,3425,44,25,19
22,14,2842,62,30,32
22,14,2455,45,25,20
22,14,4693,80,41,39
22,14,611,1,1,0
22,14,2096,21,8,13
22,14,4070,42,16,26
22,14,2932,35,16,19
22,14,2549,22,15,7
22,14,3586,30,17,13
22,14,1328,23,9,14
22,14,2014,36,19,17
22,14,1794,18,9,9
22,14,944,35,19,16
22,14,1862,26,14,12
22,14,3908,121,58,63
22,14,2208,16,5,11
22,14,4049,204,121,83
22,14,2874,22,10,12
22,14,4627,142,82,60
22,14,5552,72,38,34
22,14,3555,59,27,32
22,3,4121,4,2,2
22,3,802,5,4,1
22,4,3204,12,2,10
22,4,1884,15,7,8
22,4,3387,4,2,2
22,4,1405,0,0,0
22,16,3147,7,2,5
22,16,1515,4,2,2
22,16,3193,36,16,20
22,16,1685,23,12,11
22,14,3472,17,8,9
22,14,1341,14,8,6
22,1,1632,7,3,4
22,1,3938,42,21,21
22,10,2633,20,7,13
22,10,2465,9,5,4
23,1,8278,138,75,63
23,1,2543,31,14,17
23,1,5505,195,99,96
23,1,1432,44,16,28
23,1,1816,108,52,56
23,1,1081,31,15,16
23,1,909,27,15,12
23,1,930,10,6,4
23,1,3703,172,78,94
23,1,7512,248,115,133
23,1,4352,120,63,57
23,1,13886,190,99,91
23,1,1513,17,10,7
23,1,1619,31,11,20
23,1,1872,89,47,42
23,1,1030,45,25,20
23,1,1113,28,12,16
23,1,804,67,28,39
23,1,1461,2,1,1
23,1,828,2,0,2
23,1,752,3,0,3
23,1,1073,0,0,0
23,1,1165,88,39,49
23,1,1068,15,9,6
23,1,825,10,8,2
23,1,836,22,10,12
23,1,1199,13,7,6
23,1,712,4,2,2
23,1,1171,8,3,5
23,1,1166,34,12,22
23,1,1284,42,22,20
23,1,755,25,13,12
23,1,1122,27,11,16
23,1,775,26,11,15
23,1,1499,13,5,8
23,1,654,7,3,4
23,1,796,11,5,6
23,1,952,7,4,3
23,1,1406,47,22,25
23,1,1302,124,67,57
23,1,1484,36,23,13
23,1,1752,12,6,6
23,1,1506,18,8,10
23,1,1695,23,9,14
23,1,2415,92,40,52
23,1,1345,9,5,4
23,1,1674,22,4,18
23,1,2874,12,7,5
23,1,2685,23,5,18
23,1,1095,8,2,6
23,1,1100,41,22,19
23,1,2193,19,7,12
23,1,631,45,24,21
23,1,1505,169,92,77
23,1,1642,21,6,15
23,1,986,11,5,6
23,1,994,7,4,3
23,1,721,11,5,6
23,1,885,37,19,18
23,1,1198,173,77,96
23,1,690,0,0,0
23,1,753,5,1,4
23,1,609,2,2,0
23,1,587,7,0,7
23,1,1131,2,2,0
23,1,1620,14,5,9
23,1,2533,10,4,6
23,1,2332,27,11,16
23,1,1633,22,8,14
23,1,1198,11,7,4
23,1,1882,26,14,12
23,1,1043,84,45,39
23,1,1059,1,0,1
23,1,829,3,1,2
23,1,530,15,7,8
23,1,700,1,0,1
23,1,680,11,5,6
23,1,768,14,5,9
23,1,535,20,10,10
23,1,1105,93,42,51
23,1,1125,77,35,42
23,1,861,4,1,3
23,1,661,3,0,3
23,1,565,17,7,10
23,1,1154,19,12,7
23,1,1589,90,40,50
23,1,969,53,16,37
23,1,1837,60,31,29
23,1,1191,48,28,20
23,1,512,10,8,2
23,1,970,21,8,13
23,1,537,16,10,6
23,1,635,4,2,2
23,1,340,2,0,2
23,1,924,83,50,33
23,1,851,26,13,13
23,1,2431,54,19,35
23,1,554,0,0,0
23,1,1210,11,4,7
23,1,1142,18,9,9
23,1,829,11,2,9
23,1,1051,8,3,5
23,1,827,23,13,10
23,1,911,27,11,16
23,1,557,24,11,13
23,1,381,23,9,14
23,1,615,10,3,7
23,1,882,5,4,1
23,1,546,4,0,4
23,1,1046,15,3,12
23,1,997,7,2,5
23,1,1123,119,59,60
23,1,724,15,7,8
23,1,531,11,3,8
23,1,653,28,17,11
23,1,715,20,11,9
23,1,713,20,8,12
23,1,435,42,22,20
23,1,732,37,19,18
23,1,701,22,13,9
23,1,5445,134,72,62
23,1,2406,141,68,73
23,1,1590,55,25,30
23,1,433,10,5,5
23,1,381,6,2,4
23,1,617,22,10,12
23,1,515,25,13,12
23,1,531,35,16,19
23,1,617,25,10,15
23,1,500,19,7,12
23,1,474,22,6,16
23,1,526,23,10,13
23,1,531,21,7,14
23,1,424,39,15,24
23,1,365,4,3,1
23,1,439,29,12,17
23,1,452,19,9,10
23,1,563,20,6,14
23,1,726,23,13,10
23,1,519,23,11,12
23,1,5638,177,92,85
23,1,7885,170,86,84
23,1,1126,12,5,7
23,1,2857,141,68,73
23,1,5310,129,75,54
23,1,1719,23,11,12
23,1,1699,49,27,22
23,1,1228,6,1,5
23,1,1681,140,68,72
23,1,1440,21,9,12
23,1,1176,42,25,17
23,1,1551,4,2,2
23,1,3042,72,35,37
23,1,459,10,6,4
23,1,2171,94,45,49
23,1,5441,122,67,55
23,1,1120,34,13,21
23,1,4036,53,30,23
23,1,1488,143,72,71
23,1,13539,365,185,180
23,1,3790,129,69,60
23,1,2772,35,14,21
23,1,62,1,0,1
23,1,2241,80,29,51
23,1,4962,55,16,39
23,1,6308,98,47,51
23,1,32194,567,282,285
23,11,4336,56,26,30
23,11,3084,42,21,21
23,11,18636,665,320,345
23,1,33,5,0,5
23,1,6125,120,52,68
23,2,2062,40,19,21
23,2,2614,37,19,18
23,2,2250,14,8,6
23,2,2894,22,9,13
23,2,1086,15,5,10
23,2,2405,23,12,11
23,2,2543,23,11,12
23,2,2381,30,19,11
23,2,1831,52,30,22
23,2,821,24,10,14
23,2,1121,14,6,8
23,2,1355,17,6,11
23,2,2295,34,19,15
23,2,25060,337,151,186
23,2,6471,94,50,44
23,2,2066,72,44,28
23,2,2082,22,7,15
23,2,2842,49,22,27
23,2,4268,167,84,83
23,2,2421,6,2,4
23,2,2449,36,18,18
23,2,15310,286,132,154
23,8,7600,267,122,145
23,9,5387,16,13,3
23,9,3176,624,312,312
23,9,421,4,2,2
23,3,4275,153,83,70
23,3,1905,85,48,37
23,3,3783,208,103,105
23,3,1651,33,14,19
23,3,2643,34,17,17
23,3,1591,85,33,52
23,3,1029,56,27,29
23,3,2170,46,25,21
23,3,3995,231,125,106
23,3,2381,95,42,53
23,3,2318,50,27,23
23,3,3306,21,9,12
23,3,2828,11,5,6
23,3,2400,3,1,2
23,3,3662,399,188,211
23,3,3628,30,13,17
23,3,3066,7,4,3
23,3,2324,2,1,1
23,3,1799,5,3,2
23,3,3601,2,1,1
23,3,2769,8,3,5
23,3,1742,2,1,1
23,3,2144,6,2,4
23,3,2257,59,29,30
23,3,1150,0,0,0
23,3,2562,12,5,7
23,3,1815,2,1,1
23,3,595,0,0,0
23,3,1899,6,2,4
23,3,1046,3,1,2
23,3,3177,135,62,73
23,3,961,5,2,3
23,3,2847,730,352,378
23,3,1668,6,4,2
23,3,2707,7,3,4
23,4,658,9,4,5
23,4,292,39,20,19
23,4,291,0,0,0
23,4,3466,439,223,216
23,4,1293,2,1,1
23,4,1818,45,21,24
23,4,3555,34,18,16
23,4,1801,3,1,2
23,4,325,4,2,2
23,4,9206,58,32,26
23,5,3744,11,5,6
23,5,3246,14,5,9
23,5,2688,91,41,50
23,5,3838,85,41,44
23,5,1119,1,0,1
23,5,1208,8,5,3
23,5,3862,23,9,14
23,5,1293,6,2,4
23,5,1733,3,2,1
23,5,1424,0,0,0
23,5,1043,2,1,1
23,5,2231,276,136,140
23,5,2020,14,6,8
23,5,1781,4,1,3
23,5,1707,72,35,37
23,5,646,1,0,1
23,5,1260,10,3,7
23,5,943,4,2,2
23,5,934,16,3,13
23,5,406,8,3,5
23,5,1090,12,7,5
23,5,949,190,91,99
23,6,2188,50,28,22
23,6,2040,78,38,40
23,6,3923,89,36,53
23,6,1841,7,5,2
23,6,3158,110,46,64
23,6,1282,82,39,43
23,6,2875,1344,663,681
23,6,1576,33,18,15
23,6,2025,553,258,295
23,6,2391,175,97,78
23,6,1358,53,29,24
23,6,1577,167,87,80
23,6,1859,1,0,1
23,6,943,53,20,33
23,7,1855,99,48,51
23,7,1496,27,16,11
23,7,3811,235,120,115
23,7,807,24,11,13
23,7,2553,104,58,46
23,7,1212,6,4,2
23,7,1259,72,28,44
23,7,1329,59,29,30
23,7,1161,18,9,9
23,7,7246,101,55,46
23,7,1461,111,53,58
23,7,1752,74,36,38
23,7,1416,110,60,50
23,7,1377,96,41,55
23,7,1194,26,12,14
23,7,783,79,43,36
23,7,607,66,35,31
23,7,1356,22,9,13
23,7,2116,83,39,44
23,7,1401,162,90,72
23,7,1484,15,9,6
23,7,1215,61,34,27
23,7,952,67,30,37
23,7,2127,119,66,53
23,7,959,22,11,11
23,7,399,26,15,11
23,7,959,13,6,7
23,7,1093,7,2,5
23,7,666,30,16,14
23,7,968,27,15,12
23,7,818,15,6,9
23,7,1201,61,22,39
23,7,813,49,21,28
23,7,1076,12,5,7
23,7,1211,32,12,20
23,7,3600,651,352,299
23,7,1291,57,27,30
23,7,891,56,27,29
23,7,6277,88,42,46
23,7,1200,7,3,4
23,7,1059,8,2,6
23,7,470,13,7,6
23,7,804,18,7,11
23,7,1470,62,31,31
23,7,1199,102,50,52
23,7,1185,20,11,9
23,7,553,25,11,14
23,7,841,60,29,31
23,7,1031,60,31,29
23,7,716,48,33,15
23,7,714,14,8,6
23,7,820,33,16,17
23,7,480,19,9,10
23,7,1140,11,5,6
23,7,790,4,1,3
23,7,818,76,40,36
23,7,617,21,12,9
23,7,731,64,26,38
23,7,1135,21,11,10
23,7,975,10,7,3
23,7,1194,4,1,3
23,7,719,3,1,2
23,7,1313,19,9,10
23,7,1174,27,11,16
23,7,1372,24,15,9
23,7,719,15,11,4
23,7,1226,177,93,84
23,7,668,75,38,37
23,7,724,110,61,49
23,7,959,36,20,16
23,7,554,17,8,9
23,7,681,12,6,6
23,7,1328,20,13,7
23,7,321,15,9,6
23,7,692,89,53,36
23,7,1049,40,22,18
23,7,1383,57,25,32
23,7,3944,11,7,4
23,7,680,12,8,4
23,7,724,9,7,2
23,7,362,14,6,8
23,7,804,33,16,17
23,7,512,11,4,7
23,10,1235,14,6,8
23,10,1701,10,3,7
23,10,466,3,1,2
23,10,957,0,0,0
23,10,1024,4,2,2
23,10,1368,6,5,1
23,10,1111,14,4,10
23,10,993,11,3,8
23,10,2845,90,48,42
23,7,1851,68,30,38
23,10,1438,9,5,4
23,10,432,0,0,0
23,10,855,0,0,0
23,10,892,3,0,3
23,10,170,2,1,1
23,10,834,0,0,0
23,10,694,4,4,0
23,10,1062,3,2,1
23,10,2156,12,6,6
23,10,1542,8,2,6
23,10,5101,97,50,47
23,10,1475,28,16,12
23,10,2074,51,29,22
23,10,3372,13,6,7
23,10,2083,9,4,5
23,7,1978,52,23,29
23,7,894,4,1,3
23,7,1044,6,3,3
23,7,2644,68,29,39
23,7,1509,4,3,1
23,7,2322,2,0,2
23,7,1076,3,1,2
23,7,1537,16,8,8
23,7,1789,92,40,52
23,7,2174,71,31,40
23,7,2581,30,16,14
23,7,1069,1,1,0
23,7,1965,16,10,6
23,7,3127,35,14,21
23,7,2036,5,2,3
23,7,2695,96,45,51
23,7,1892,62,26,36
23,7,2061,67,35,32
23,7,11668,338,174,164
23,7,3243,155,80,75
23,7,939,4,0,4
23,7,1533,22,16,6
23,7,1176,23,16,7
23,7,1679,13,6,7
23,7,135,0,0,0
23,7,722,23,11,12
23,7,1706,38,18,20
23,7,1558,32,16,16
23,7,2008,56,30,26
23,7,2095,126,53,73
23,7,1057,17,8,9
23,7,1817,14,6,8
23,7,278,4,0,4
23,7,770,13,6,7
23,7,171,0,0,0
23,7,245,1,1,0
23,7,1213,32,14,18
23,7,373,1,0,1
23,7,1099,1,1,0
23,7,0,0,0,0
23,1,2788,34,13,21
23,1,2429,14,7,7
23,1,1105,5,2,3
23,1,1347,24,13,11
23,1,1017,21,11,10
23,1,1116,33,12,21
23,1,1604,12,4,8
23,1,1148,18,7,11
23,1,936,4,1,3
23,1,1214,18,10,8
23,1,480,0,0,0
23,1,574,0,0,0
23,1,849,11,4,7
23,1,612,0,0,0
23,1,794,10,5,5
23,1,776,6,4,2
23,1,504,1,1,0
23,1,558,17,10,7
23,1,591,2,0,2
23,1,632,0,0,0
23,1,837,21,8,13
23,1,2764,15,8,7
23,1,2031,120,55,65
23,1,2466,101,46,55
23,1,1183,2,0,2
23,1,1279,24,9,15
23,1,1415,35,17,18
23,1,1309,14,10,4
23,1,1161,5,1,4
23,1,1274,15,5,10
23,1,1547,7,5,2
23,1,924,21,12,9
23,1,1148,41,20,21
23,1,1190,9,2,7
23,1,1147,11,4,7
23,1,904,11,5,6
23,1,977,5,3,2
23,1,800,2,1,1
23,1,775,2,1,1
23,1,921,1,0,1
23,1,4030,19,6,13
23,1,2371,10,3,7
23,1,1104,3,2,1
23,1,635,40,20,20
23,1,671,42,20,22
23,1,2372,12,8,4
23,1,4656,48,26,22
23,1,869,6,2,4
23,1,1346,2,0,2
23,1,744,11,7,4
23,1,1543,12,7,5
23,1,1298,2,1,1
23,1,1424,3,2,1
23,1,1041,6,1,5
23,1,940,16,4,12
23,1,732,3,2,1
23,1,1056,1,0,1
23,1,467,1,1,0
23,1,3518,137,69,68
23,1,2885,24,13,11
23,1,1989,38,12,26
23,1,1252,7,4,3
23,1,525,4,4,0
23,1,834,11,6,5
23,1,1519,4,2,2
23,1,338,17,8,9
23,1,1351,16,9,7
23,1,592,0,0,0
23,1,888,3,2,1
23,1,1621,17,7,10
23,1,1954,62,32,30
23,1,935,23,10,13
23,1,743,3,2,1
23,1,1146,48,24,24
23,1,721,6,1,5
23,1,964,17,6,11
23,1,1104,7,3,4
23,1,710,35,9,26
23,1,1141,25,10,15
23,1,1276,21,12,9
23,1,747,8,5,3
23,1,1275,28,10,18
23,1,919,13,10,3
23,1,2005,39,18,21
23,1,2942,77,39,38
23,1,1595,21,10,11
23,1,1845,13,10,3
23,1,1554,18,9,9
23,1,580,6,2,4
23,1,829,7,4,3
23,1,855,5,1,4
23,1,893,10,8,2
23,1,860,12,4,8
23,1,835,6,2,4
23,1,953,2,0,2
23,1,849,3,1,2
23,1,1156,9,3,6
23,1,822,61,32,29
23,1,927,64,24,40
23,1,1249,58,27,31
23,1,871,5,2,3
23,1,853,1,1,0
23,1,683,2,2,0
23,1,587,4,2,2
23,1,977,1,0,1
23,1,701,6,4,2
23,1,1111,0,0,0
23,1,1215,6,5,1
23,1,876,43,21,22
23,1,934,231,112,119
23,1,876,126,67,59
23,1,972,4,2,2
23,1,1057,2,1,1
23,1,996,14,5,9
23,1,930,6,3,3
23,1,861,4,2,2
23,1,1025,28,21,7
23,1,978,20,7,13
23,1,1034,12,10,2
23,1,1204,35,16,19
23,1,664,40,24,16
23,1,944,7,3,4
23,1,576,9,2,7
23,1,823,3,0,3
23,1,736,3,0,3
23,1,740,27,13,14
23,1,2430,190,100,90
23,1,658,14,5,9
23,1,406,10,4,6
23,1,406,17,8,9
23,1,375,44,21,23
23,1,194,50,23,27
23,1,2196,56,28,28
23,1,302,7,3,4
23,1,297,4,1,3
23,1,299,43,21,22
23,1,501,21,9,12
23,1,394,3,1,2
23,1,16546,447,203,244
23,1,2714,71,32,39
23,1,547,24,14,10
23,1,534,32,20,12
23,1,502,18,7,11
23,1,924,16,3,13
23,1,500,6,4,2
23,1,1321,60,21,39
23,1,887,10,5,5
23,1,481,9,5,4
23,1,874,54,30,24
23,1,438,12,4,8
23,1,1608,2,0,2
23,1,909,31,12,19
23,1,697,95,48,47
23,1,936,20,13,7
23,1,818,6,2,4
23,1,722,36,20,16
23,1,1016,34,15,19
23,1,689,53,24,29
23,1,948,19,10,9
23,1,1066,5,2,3
23,1,707,9,6,3
23,1,780,21,11,10
23,1,828,7,4,3
23,1,727,0,0,0
23,1,786,2,1,1
23,1,1055,4,2,2
23,1,2431,18,9,9
23,1,1344,30,17,13
23,1,953,30,16,14
23,1,1082,8,5,3
23,1,1165,65,32,33
23,1,586,2,1,1
23,1,886,8,6,2
23,1,22640,653,318,335
23,1,2915,59,24,35
23,1,2178,49,20,29
23,1,4464,72,28,44
23,1,1581,32,16,16
23,1,5507,19,8,11
23,1,16029,214,103,111
23,1,3200,22,13,9
23,1,2790,83,46,37
23,1,2212,25,13,12
23,1,505,3,2,1
23,1,403,0,0,0
23,1,1656,3,0,3
23,1,1824,39,21,18
23,1,4571,52,32,20
23,1,1814,7,5,2
23,1,759,29,19,10
23,1,576,13,9,4
23,1,733,7,4,3
23,1,816,44,23,21
23,1,552,15,10,5
23,1,735,25,11,14
23,1,667,13,5,8
23,1,1387,80,43,37
23,1,822,31,20,11
23,1,797,12,6,6
23,1,984,11,7,4
23,1,1624,21,10,11
23,1,719,12,5,7
23,1,1025,45,24,21
23,1,604,15,8,7
23,1,647,48,21,27
23,1,1236,70,33,37
23,1,685,17,7,10
23,1,1171,69,31,38
23,1,882,27,14,13
23,1,1331,89,47,42
23,1,1253,101,50,51
23,1,2205,70,35,35
23,1,882,56,28,28
23,1,629,28,18,10
23,1,2177,64,29,35
23,8,2539,26,17,9
23,8,1602,29,12,17
23,8,1096,2,1,1
23,8,926,7,2,5
23,8,1859,107,53,54
23,8,1932,34,14,20
23,8,2162,28,13,15
23,8,3929,20,10,10
23,8,1275,5,1,4
23,8,950,7,3,4
23,8,1389,1067,514,553
23,8,1244,152,72,80
23,8,5347,270,128,142
23,8,10037,601,299,302
23,8,1863,8,3,5
23,8,1633,4,2,2
23,8,734,0,0,0
23,8,924,39,15,24
23,8,944,13,5,8
23,8,1068,2,0,2
23,8,793,4,2,2
23,8,1034,46,18,28
23,8,358,9,3,6
23,8,1086,13,2,11
23,8,1102,2,1,1
23,8,1043,3,0,3
23,8,4608,215,96,119
23,8,1733,255,124,131
23,8,1327,36,19,17
23,8,1098,9,2,7
23,8,1808,23,11,12
23,8,556,107,55,52
23,8,1005,362,200,162
23,8,1334,38,18,20
23,8,3877,141,69,72
23,8,1338,66,30,36
23,8,1024,23,13,10
23,8,1025,18,8,10
23,8,263,18,9,9
23,8,1685,143,77,66
23,8,1335,27,13,14
23,8,2993,57,30,27
23,8,1083,8,4,4
23,8,1227,9,3,6
23,8,1608,138,71,67
23,8,1056,46,16,30
23,8,1609,63,32,31
23,8,1525,54,29,25
23,8,541,3,1,2
23,8,1329,25,12,13
23,8,1330,463,218,245
23,8,625,141,65,76
23,8,1448,215,104,111
23,8,1048,136,69,67
23,8,1322,19,5,14
23,8,457,0,0,0
23,8,771,1,1,0
23,8,1637,22,10,12
23,8,617,12,4,8
23,8,1135,14,5,9
23,8,705,17,5,12
23,8,1780,38,12,26
23,8,807,32,15,17
23,8,1209,27,11,16
23,8,512,6,2,4
23,8,1368,34,16,18
23,8,2079,86,50,36
23,8,224,3,1,2
23,8,1318,17,6,11
23,8,888,14,3,11
23,8,282,4,3,1
23,8,437,4,2,2
23,8,293,0,0,0
23,8,411,3,2,1
23,8,3747,15,8,7
23,8,497,8,4,4
23,8,467,6,2,4
23,8,159,1,1,0
23,8,919,9,3,6
23,8,279,6,3,3
23,8,1786,53,28,25
23,8,791,83,33,50
23,8,941,0,0,0
23,8,420,13,6,7
23,8,723,290,137,153
23,8,1308,74,29,45
23,8,539,42,19,23
23,8,705,80,38,42
23,8,351,4,3,1
23,8,515,1,0,1
23,8,932,38,18,20
23,8,2564,65,38,27
23,8,222,9,2,7
23,8,154,2,1,1
23,8,249,5,3,2
23,8,1687,6,4,2
23,8,970,14,9,5
23,8,1384,30,17,13
23,8,6800,102,40,62
23,8,2456,53,28,25
23,8,12909,229,104,125
23,8,2475,12,5,7
23,8,1634,43,12,31
23,8,1227,11,4,7
23,8,816,22,9,13
23,8,2635,20,7,13
23,8,1063,22,11,11
23,7,8488,249,117,132
23,7,851,12,5,7
23,7,1263,23,10,13
23,7,893,19,11,8
23,7,886,15,4,11
23,7,1086,21,12,9
23,7,1252,41,24,17
23,7,1094,19,10,9
23,7,2289,112,63,49
23,7,1098,42,20,22
23,7,1148,11,9,2
23,7,1051,21,10,11
23,7,1210,25,6,19
23,7,816,8,3,5
23,7,780,11,3,8
23,7,1353,906,462,444
23,7,921,50,25,25
23,7,1195,12,6,6
23,7,2505,54,28,26
23,7,9907,341,161,180
23,7,1105,43,19,24
23,7,873,10,5,5
23,7,1289,56,32,24
23,7,1080,47,27,20
23,7,1022,41,23,18
23,7,1051,20,8,12
23,7,992,48,25,23
23,7,1338,35,18,17
23,7,534,22,12,10
23,7,1257,2,0,2
23,7,1262,107,55,52
23,7,851,45,26,19
23,7,998,10,4,6
23,7,716,3,0,3
23,7,787,7,3,4
23,7,636,27,7,20
23,1,2695,61,30,31
23,1,2427,18,13,5
23,1,1914,15,7,8
23,1,1968,34,16,18
23,1,1659,64,29,35
23,1,2116,22,9,13
23,1,1643,105,48,57
23,1,1951,18,11,7
23,1,1210,116,58,58
23,1,1421,46,23,23
23,1,1026,183,83,100
23,1,2600,32,13,19
23,1,1103,36,15,21
23,1,1050,52,20,32
23,1,1408,9,4,5
23,1,13785,260,120,140
23,1,876,18,9,9
23,1,1658,56,25,31
23,1,999,5,3,2
23,1,1343,40,15,25
23,1,795,13,6,7
23,1,1054,56,27,29
23,1,1059,6,1,5
23,1,665,9,4,5
23,1,692,15,6,9
23,1,755,2,0,2
23,1,924,3,0,3
23,1,513,20,11,9
23,1,2507,26,11,15
23,1,627,2,2,0
23,1,1014,2,0,2
23,1,1267,9,3,6
23,1,691,11,6,5
23,1,734,15,7,8
23,1,1025,7,2,5
23,1,1612,10,2,8
23,1,1927,35,21,14
23,1,1813,24,16,8
23,1,2183,120,58,62
23,1,2158,20,6,14
23,1,1885,2,2,0
23,1,4493,51,24,27
23,1,1315,5,0,5
23,1,1417,19,6,13
23,1,1481,5,2,3
23,1,911,10,5,5
23,1,2268,39,19,20
23,1,827,13,3,10
23,1,858,24,11,13
23,1,1187,15,11,4
23,1,1907,40,16,24
23,1,1237,16,7,9
23,1,1929,35,16,19
23,1,1022,3,1,2
23,1,879,17,6,11
23,1,2226,80,42,38
23,1,1213,20,9,11
23,1,1352,6,2,4
23,1,138,4,1,3
23,1,1113,22,9,13
23,1,376,14,6,8
23,1,775,47,24,23
23,1,587,26,15,11
23,8,33016,574,291,283
23,8,7148,378,194,184
23,8,1972,20,7,13
23,8,1344,7,3,4
23,8,1630,7,1,6
23,8,1567,9,3,6
23,8,2033,67,40,27
23,8,1181,4,1,3
23,8,1994,53,25,28
23,8,1373,18,9,9
23,8,1146,14,9,5
23,8,1057,8,4,4
23,8,924,14,7,7
23,8,5050,43,23,20
23,8,1667,60,29,31
23,8,1329,34,20,14
23,8,1592,10,3,7
23,8,2449,14,5,9
23,8,90,0,0,0
23,8,126,2,1,1
23,8,40,0,0,0
23,8,415,4,1,3
23,8,10,0,0,0
23,8,68,3,2,1
23,8,398,2,2,0
23,8,129,1,0,1
23,8,67,0,0,0
23,8,201,0,0,0
23,8,159,0,0,0
23,8,197,2,0,2
23,8,207,2,1,1
23,8,328,4,3,1
23,8,79,0,0,0
23,8,317,2,1,1
23,8,378,6,2,4
23,8,53,1,0,1
23,8,301,4,1,3
23,8,449,3,2,1
23,8,246,37,22,15
23,8,395,10,5,5
23,8,417,1,1,0
23,8,209,27,9,18
23,8,333,150,65,85
23,8,285,0,0,0
23,8,403,14,8,6
23,8,435,0,0,0
23,8,212,0,0,0
23,8,132,2,1,1
23,9,4623,112,51,61
23,9,6226,566,263,303
23,9,501,3,3,0
23,9,1686,36,19,17
23,9,424,1,1,0
23,9,926,39,16,23
23,9,389,2,2,0
23,9,399,36,16,20
23,9,792,10,4,6
23,9,210,2,0,2
23,9,616,87,45,42
23,9,436,57,29,28
23,9,226,5,2,3
23,9,1019,31,15,16
23,9,314,5,2,3
23,9,62,1,1,0
23,9,523,3,1,2
23,9,290,72,23,49
23,9,83,0,0,0
23,9,352,47,21,26
23,9,293,0,0,0
23,9,199,6,2,4
23,9,217,4,3,1
23,9,368,1,0,1
23,9,224,10,3,7
23,9,4521,34,15,19
23,9,690,13,9,4
23,9,505,3,2,1
23,9,459,14,7,7
23,9,375,16,6,10
23,9,374,0,0,0
23,9,250,6,2,4
23,9,647,0,0,0
23,9,507,0,0,0
23,9,727,4,1,3
23,9,865,15,6,9
23,9,3217,31,10,21
23,1,4381,159,71,88
23,11,852,37,17,20
23,11,0,0,0,0
23,11,13,0,0,0
23,6,135,4,1,3
23,8,1453,4,0,4
23,8,5940,90,39,51
23,8,2867,25,11,14
23,8,3660,73,28,45
23,8,3082,9,3,6
23,8,11227,296,154,142
23,8,4292,27,9,18
23,8,1900,28,17,11
23,8,3963,61,26,35
23,8,1312,40,22,18
23,8,4064,46,26,20
23,8,3771,70,45,25
23,8,930,7,3,4
23,8,2708,20,9,11
23,8,1191,9,7,2
23,8,4952,123,64,59
23,8,2398,51,23,28
23,8,986,13,8,5
23,8,2122,70,34,36
23,8,4462,312,146,166
23,8,2053,24,8,16
23,8,2078,10,2,8
23,8,3154,26,9,17
23,8,2766,102,46,56
23,8,2973,47,23,24
23,8,1637,81,38,43
23,8,447,3,2,1
23,8,1278,70,37,33
23,8,4099,121,61,60
23,1,2707,21,6,15
23,1,1402,0,0,0
23,1,1659,29,12,17
23,1,1073,1,1,0
23,1,3330,78,31,47
23,1,2171,9,2,7
23,1,3278,125,59,66
23,1,1069,1,0,1
23,1,1011,2,1,1
23,1,934,8,3,5
23,1,1915,16,10,6
23,1,3117,33,11,22
23,1,1005,2,2,0
23,1,4150,43,25,18
23,1,2010,50,20,30
23,1,1692,9,3,6
23,1,3678,149,68,81
23,1,1916,35,19,16
23,1,2994,70,31,39
23,1,7790,440,215,225
23,1,1708,37,16,21
23,1,4021,46,20,26
23,1,6784,139,68,71
23,1,4372,137,71,66
23,1,2872,44,21,23
23,1,2706,116,53,63
23,1,2088,49,25,24
23,1,3665,22,11,11
23,1,6247,187,95,92
23,1,6606,66,27,39
23,1,6793,143,66,77
23,1,940,15,9,6
23,1,2471,285,150,135
23,1,4211,370,178,192
23,1,2891,90,39,51
23,1,4910,38,13,25
23,1,2380,25,13,12
23,1,4420,30,16,14
23,1,2214,35,21,14
23,1,3254,53,21,32
23,1,2292,6,3,3
23,1,1922,20,10,10
23,1,1076,10,6,4
23,1,3546,50,24,26
23,1,2777,33,16,17
23,1,2688,46,21,25
23,1,1789,71,38,33
23,1,1101,22,9,13
23,1,1967,80,42,38
23,1,1428,58,18,40
23,1,3519,39,15,24
23,1,1091,7,2,5
23,1,2295,160,85,75
23,1,5181,116,49,67
23,1,2671,20,13,7
23,1,4802,77,35,42
23,1,2174,73,30,43
23,1,2482,21,11,10
23,1,4773,57,23,34
23,1,1891,25,11,14
23,1,2370,58,28,30
23,1,2036,61,34,27
23,1,4964,161,71,90
23,1,846,12,7,5
23,1,2238,30,17,13
23,9,2241,27,12,15
23,9,961,43,26,17
23,10,1156,0,0,0
23,10,3057,4,2,2
23,10,873,61,23,38
23,10,1084,156,73,83
24,1,1953,22,12,10
24,1,3131,98,54,44
24,1,317,0,0,0
24,1,493,1,1,0
24,1,290,1,0,1
24,1,1538,22,10,12
24,1,1434,39,22,17
24,1,1986,8,6,2
24,1,398,0,0,0
24,1,186,27,14,13
24,1,1839,160,81,79
24,1,830,1,1,0
24,1,1552,11,7,4
24,1,3265,10,6,4
24,2,344,1,1,0
24,2,230,0,0,0
24,2,599,4,2,2
24,2,136,0,0,0
24,2,345,0,0,0
24,2,274,0,0,0
24,2,259,1,0,1
24,2,172,0,0,0
24,2,585,0,0,0
24,2,334,0,0,0
24,2,133,0,0,0
24,2,1295,2,1,1
24,2,265,3,2,1
24,2,756,0,0,0
24,2,241,0,0,0
24,2,432,0,0,0
24,2,340,0,0,0
24,2,520,0,0,0
24,2,525,0,0,0
24,3,3393,125,65,60
24,3,2185,39,20,19
24,3,1387,15,7,8
24,3,642,1,1,0
24,3,1243,2,1,1
24,3,2036,61,30,31
24,3,294,1,0,1
24,3,2115,317,152,165
24,3,1693,13,7,6
24,3,2502,33,15,18
24,3,2430,65,29,36
24,3,2745,3,1,2
24,3,2954,1,1,0
24,3,1984,3,1,2
24,3,1674,34,19,15
24,3,1869,15,7,8
24,3,735,0,0,0
24,3,2405,196,96,100
24,3,1914,436,218,218
24,3,2843,96,40,56
24,3,1726,31,14,17
24,3,1502,26,10,16
24,3,1591,630,312,318
24,3,1891,25,12,13
24,3,1061,5,2,3
24,3,1406,15,6,9
24,4,237,2,0,2
24,4,84,0,0,0
24,4,216,0,0,0
24,4,916,1,0,1
24,4,440,3,0,3
24,4,536,0,0,0
24,4,269,1,1,0
24,4,593,1,1,0
24,4,226,1,1,0
24,4,188,0,0,0
24,4,74,0,0,0
24,4,239,0,0,0
24,5,1326,1,0,1
24,5,2829,12,8,4
24,5,1482,2,1,1
24,5,1073,16,7,9
24,5,448,2,2,0
24,5,635,0,0,0
24,5,1073,0,0,0
24,5,2169,6,4,2
24,5,1055,3,2,1
24,5,510,6,2,4
24,5,771,2,2,0
24,5,662,2,0,2
24,5,1126,2,0,2
24,5,501,0,0,0
24,5,246,0,0,0
24,5,658,4,2,2
24,5,303,2,1,1
24,5,652,0,0,0
24,5,540,0,0,0
24,5,244,4,2,2
24,6,1588,4,1,3
24,6,191,0,0,0
24,6,505,5,2,3
24,6,355,3,2,1
24,6,469,1,0,1
24,6,359,3,2,1
24,6,1446,17,6,11
24,6,227,0,0,0
24,6,521,1,1,0
24,6,373,4,2,2
24,6,319,0,0,0
24,6,412,0,0,0
24,6,640,0,0,0
24,6,309,0,0,0
24,6,110,1,0,1
24,6,421,3,1,2
24,6,439,1,0,1
24,6,279,0,0,0
24,6,617,9,5,4
24,7,3539,31,18,13
24,7,2968,17,9,8
24,7,2568,17,8,9
24,7,3866,709,364,345
24,7,209,1,0,1
24,7,398,3,1,2
24,7,517,4,3,1
24,7,512,0,0,0
24,7,379,1,0,1
24,7,454,0,0,0
24,7,109,0,0,0
24,7,310,0,0,0
24,7,2010,4,2,2
24,7,257,5,2,3
24,7,450,0,0,0
24,7,514,1,0,1
24,7,909,351,166,185
24,8,1678,7,4,3
24,8,1350,7,4,3
24,8,811,1,0,1
24,8,2059,7,4,3
24,8,1549,0,0,0
24,8,2075,10,7,3
24,8,1480,6,1,5
24,8,2118,3,0,3
24,8,2306,58,21,37
24,8,108,0,0,0
24,8,522,8,4,4
24,8,377,3,1,2
24,8,156,5,3,2
24,8,233,0,0,0
24,8,88,0,0,0
24,8,1243,3,1,2
24,8,275,1,0,1
24,8,479,0,0,0
24,8,407,4,2,2
24,8,689,4,1,3
24,8,79,0,0,0
24,8,283,9,4,5
24,8,237,0,0,0
24,8,494,0,0,0
24,8,152,0,0,0
24,8,601,0,0,0
24,8,63,0,0,0
24,9,300,1,0,1
24,9,253,0,0,0
24,9,166,0,0,0
24,9,177,1,0,1
24,9,3076,8,3,5
24,9,1118,13,5,8
24,10,2198,8,5,3
24,10,1142,11,5,6
24,10,2326,50,28,22
24,10,3204,3,2,1
24,10,1226,1,0,1
24,10,608,0,0,0
24,10,1605,0,0,0
24,57,270,0,0,0
24,10,416,1,0,1
24,10,1538,2,0,2
24,10,367,2,2,0
24,10,906,5,1,4
24,10,895,7,2,5
24,57,1152,1,0,1
24,57,946,20,9,11
24,57,2645,42,23,19
24,57,2052,52,27,25
24,57,1288,9,3,6
24,57,1247,0,0,0
24,57,2090,2,1,1
24,57,3004,5,1,4
24,57,1542,4,3,1
24,57,849,2,2,0
24,10,342,0,0,0
24,10,715,7,2,5
24,10,1723,0,0,0
24,10,512,1,0,1
24,10,293,0,0,0
24,10,2616,3,0,3
24,10,1542,9,4,5
24,57,212,1,1,0
24,57,459,0,0,0
24,57,782,6,4,2
24,10,818,4,4,0
24,10,134,0,0,0
24,10,614,0,0,0
24,10,690,3,1,2
24,10,538,1,1,0
24,10,628,0,0,0
24,57,1249,1,1,0
24,57,333,0,0,0
24,10,688,14,9,5
24,10,372,0,0,0
24,10,393,0,0,0
24,10,1024,11,3,8
24,10,227,0,0,0
24,57,851,6,2,4
24,11,2830,7,4,3
24,11,2022,7,4,3
24,11,4231,53,27,26
24,11,1102,55,30,25
24,11,1397,7,3,4
24,11,6626,137,63,74
24,11,2235,110,42,68
24,11,4828,37,19,18
24,11,2803,4,3,1
24,11,912,13,7,6
24,11,2241,8,4,4
24,11,684,1,1,0
24,11,1479,6,3,3
24,11,1111,1,0,1
24,11,2234,7,5,2
24,11,148,0,0,0
24,11,364,0,0,0
24,11,266,0,0,0
24,11,212,1,0,1
24,11,100,0,0,0
24,11,142,0,0,0
24,11,820,0,0,0
24,11,602,0,0,0
24,11,1729,21,9,12
24,11,386,3,1,2
24,11,656,9,2,7
24,11,1741,1,1,0
24,11,1586,4,3,1
24,11,1358,6,4,2
24,11,553,8,5,3
24,11,301,0,0,0
24,12,1022,17,10,7
24,12,1834,1,1,0
24,12,1266,34,16,18
24,12,649,0,0,0
24,12,749,0,0,0
24,12,2053,1,0,1
24,12,1935,4,2,2
24,12,970,0,0,0
24,12,2678,4,2,2
24,12,2972,2,1,1
24,12,481,1,0,1
24,12,515,4,0,4
24,12,333,1,1,0
24,12,929,3,2,1
24,12,2581,2,1,1
24,13,13319,167,84,83
24,13,3446,4,2,2
24,13,210,4,3,1
24,13,178,6,3,3
24,13,225,0,0,0
24,13,6756,69,38,31
24,13,5700,36,19,17
24,13,5618,79,42,37
24,13,6322,63,34,29
24,13,2331,17,9,8
24,13,930,2,1,1
24,13,5484,64,36,28
24,13,1678,7,2,5
24,13,1818,2,0,2
24,13,2159,2,0,2
24,13,1166,5,2,3
24,13,2753,3,2,1
24,13,1860,4,1,3
24,13,1275,7,3,4
24,13,1177,24,11,13
24,13,1364,2,1,1
24,13,1777,0,0,0
24,13,1140,2,1,1
24,13,4438,36,21,15
24,13,1151,35,17,18
24,13,778,3,0,3
24,13,1396,1,0,1
24,13,1302,0,0,0
24,13,978,0,0,0
24,13,1109,0,0,0
24,13,849,12,7,5
24,13,2782,34,20,14
24,13,2341,17,11,6
24,13,1687,9,5,4
24,13,3956,21,13,8
24,13,521,0,0,0
24,13,415,1,0,1
24,13,443,1,0,1
24,13,1090,2,2,0
24,13,567,0,0,0
24,13,333,1,0,1
24,13,405,6,4,2
24,13,1186,10,4,6
24,13,2174,20,10,10
24,13,2392,89,58,31
24,13,2811,72,37,35
24,13,788,3,2,1
24,13,1688,33,20,13
24,13,276,2,0,2
24,13,125,0,0,0
24,13,2587,57,23,34
24,13,782,7,3,4
24,13,452,15,7,8
24,13,1552,42,20,22
24,13,6498,27,13,14
24,13,712,20,9,11
24,13,1572,15,6,9
24,13,7396,123,70,53
24,13,3383,18,12,6
24,13,4,0,0,0
24,13,2893,119,66,53
24,13,243,1,1,0
24,13,409,4,0,4
24,13,448,1,1,0
24,13,233,0,0,0
24,13,772,13,9,4
24,13,2244,20,11,9
24,13,1814,27,14,13
24,13,376,25,13,12
24,13,752,2,2,0
24,13,386,0,0,0
24,13,477,22,13,9
24,13,1692,407,202,205
24,13,426,2,1,1
24,13,512,0,0,0
24,13,1014,0,0,0
24,13,792,15,7,8
24,13,492,431,191,240
24,13,909,4,3,1
24,13,805,6,2,4
24,13,3932,24,12,12
24,13,1098,1,0,1
24,13,1030,67,34,33
24,13,2161,8,6,2
24,13,2226,20,11,9
24,13,486,1,0,1
24,13,1162,12,7,5
24,13,1227,86,48,38
24,13,1866,2,1,1
24,13,1093,1,0,1
24,13,1843,1,1,0
24,13,742,0,0,0
24,13,1630,1,1,0
24,13,1293,2,1,1
24,13,965,2,1,1
24,13,1811,41,20,21
24,13,529,4,2,2
24,13,325,0,0,0
24,13,1505,1,0,1
24,13,372,5,3,2
24,13,430,1,0,1
24,13,1291,2,0,2
24,13,211,0,0,0
24,13,491,1,1,0
24,13,739,7,2,5
24,14,1217,5,0,5
24,14,1283,3,1,2
24,14,965,7,4,3
24,14,855,1,0,1
24,14,1226,7,0,7
24,14,744,0,0,0
24,14,1285,142,74,68
24,14,1061,1,1,0
24,14,1602,9,7,2
24,14,304,1,0,1
24,14,2231,12,6,6
24,14,982,0,0,0
24,14,1563,13,8,5
24,15,918,2,2,0
24,15,537,22,11,11
24,15,1815,9,2,7
24,15,1769,24,11,13
24,15,1287,5,1,4
24,15,1326,60,36,24
24,15,849,1,1,0
24,15,1009,6,3,3
24,15,4761,83,41,42
24,15,189,1,1,0
24,15,902,9,6,3
24,15,266,2,0,2
24,15,1692,4,2,2
24,15,469,0,0,0
24,15,385,0,0,0
24,15,198,0,0,0
24,15,152,1,1,0
24,15,666,0,0,0
24,15,1160,12,9,3
24,15,881,1,1,0
24,15,516,1,1,0
24,16,1149,7,3,4
24,16,1076,3,0,3
24,16,2570,11,8,3
24,16,1031,11,5,6
24,16,2118,9,5,4
24,16,3408,11,5,6
24,16,1065,7,4,3
24,16,1300,24,14,10
24,16,866,8,4,4
24,16,1024,1,0,1
24,16,854,4,1,3
24,16,847,5,4,1
24,16,1205,5,3,2
24,16,1525,4,3,1
24,16,1112,1,0,1
24,16,254,1,1,0
24,16,879,8,4,4
24,16,882,0,0,0
24,16,1218,1,1,0
24,16,2205,4,2,2
24,16,2231,2,1,1
24,16,1852,7,4,3
24,16,1811,3,1,2
24,16,804,0,0,0
24,16,523,0,0,0
24,16,2308,4,3,1
24,16,1511,1,1,0
24,16,193,2,0,2
24,16,1585,8,4,4
24,16,764,3,2,1
24,16,356,0,0,0
24,16,184,1,1,0
24,17,633,1,0,1
24,17,276,0,0,0
24,17,632,0,0,0
24,17,651,0,0,0
24,17,1691,3,1,2
24,17,362,4,3,1
24,17,1423,15,9,6
24,17,196,0,0,0
24,17,595,3,1,2
24,17,1177,35,18,17
24,17,3009,43,24,19
24,17,968,12,5,7
24,17,914,2,1,1
24,17,1042,8,4,4
24,17,3089,5,2,3
24,17,407,0,0,0
24,17,229,0,0,0
24,17,1062,9,4,5
24,17,174,0,0,0
24,17,620,8,3,5
24,17,1012,3,1,2
24,17,141,1,0,1
24,17,133,0,0,0
24,17,204,0,0,0
24,17,820,26,12,14
24,17,777,6,3,3
24,17,768,0,0,0
24,17,815,4,2,2
24,17,1149,15,7,8
24,17,244,0,0,0
24,18,401,17,9,8
24,18,603,0,0,0
24,18,268,2,1,1
24,18,2135,529,280,249
24,18,1470,2,1,1
24,18,1114,4,1,3
24,18,2600,5,2,3
24,18,2336,50,26,24
24,18,2005,0,0,0
24,18,2357,0,0,0
24,19,160,0,0,0
24,19,226,0,0,0
24,19,117,1,0,1
24,19,669,3,1,2
24,19,1152,1,1,0
24,19,430,0,0,0
24,19,58,1,0,1
24,19,1212,2,1,1
24,19,590,2,1,1
24,19,323,2,1,1
24,19,349,0,0,0
24,19,253,0,0,0
24,20,1814,18,8,10
24,20,1162,4,2,2
24,20,334,0,0,0
24,20,2206,39,17,22
24,20,1375,129,69,60
24,20,1586,17,9,8
24,20,4911,79,38,41
24,20,2604,19,8,11
24,20,2122,25,13,12
24,20,861,31,14,17
24,20,3269,19,10,9
24,20,2149,18,9,9
24,20,4977,80,34,46
24,20,3436,12,7,5
24,20,2152,29,12,17
24,20,1503,12,4,8
24,20,1237,9,4,5
24,20,1400,18,8,10
24,20,1647,52,30,22
24,20,2847,39,23,16
24,20,2432,18,8,10
24,20,1184,9,2,7
24,20,884,7,2,5
24,20,3705,26,14,12
24,20,2465,9,3,6
24,20,4158,15,6,9
24,20,897,1,0,1
24,20,1286,12,7,5
24,20,5205,89,48,41
24,20,1098,10,5,5
24,20,1299,13,7,6
24,20,2343,14,5,9
24,20,797,3,1,2
24,20,1070,7,4,3
24,20,1314,6,3,3
24,20,1529,10,6,4
24,20,1872,3,3,0
24,20,3765,55,27,28
24,20,390,2,1,1
24,20,545,0,0,0
24,20,339,2,1,1
24,20,1847,8,1,7
24,20,1216,11,5,6
24,20,1906,10,4,6
24,20,216,2,2,0
24,20,154,1,1,0
24,20,2414,14,6,8
24,20,157,0,0,0
24,20,650,5,2,3
24,20,1794,62,31,31
24,20,918,17,7,10
24,20,1287,23,11,12
24,20,224,1,1,0
24,20,204,0,0,0
24,20,607,1,0,1
24,20,1247,0,0,0
24,20,484,1,1,0
24,20,563,2,1,1
24,20,358,3,2,1
24,20,730,0,0,0
24,20,374,0,0,0
24,20,247,0,0,0
24,20,891,5,4,1
24,20,925,1,0,1
24,20,584,2,2,0
24,21,2298,14,5,9
24,21,2181,5,4,1
24,21,1314,2,0,2
24,21,1005,0,0,0
24,21,1898,57,31,26
24,21,1403,7,6,1
24,21,1544,11,5,6
24,21,1295,7,2,5
24,21,442,1,1,0
24,21,411,0,0,0
24,21,2672,9,3,6
24,21,1275,5,2,3
24,21,687,10,7,3
24,21,1072,34,19,15
24,21,483,3,1,2
24,21,957,5,4,1
24,21,806,9,6,3
24,21,3103,12,3,9
24,21,3138,6,4,2
24,21,1115,0,0,0
24,21,515,0,0,0
24,21,488,2,1,1
24,21,982,528,272,256
24,21,1168,8,4,4
24,21,1577,3,2,1
24,21,2676,12,6,6
24,21,2034,5,2,3
24,21,1932,8,3,5
24,21,1080,0,0,0
24,21,944,1,1,0
24,21,2351,9,3,6
24,21,3210,22,14,8
24,21,2028,58,26,32
24,21,2114,0,0,0
24,21,1709,5,3,2
24,21,1564,14,6,8
24,22,1044,20,11,9
24,22,1775,14,6,8
24,22,3234,10,5,5
24,22,246,0,0,0
24,22,251,0,0,0
24,22,651,5,4,1
24,22,605,1,0,1
24,22,420,0,0,0
24,22,348,5,2,3
24,22,820,5,3,2
24,22,580,6,1,5
24,22,909,5,3,2
24,22,914,1,1,0
24,22,601,9,4,5
24,22,606,12,6,6
24,22,815,5,4,1
24,22,1337,1,0,1
24,22,579,17,10,7
24,22,635,0,0,0
24,22,232,2,1,1
24,22,789,178,96,82
24,22,909,5,4,1
24,22,308,10,6,4
24,22,286,1,1,0
24,23,1903,0,0,0
24,23,1483,1,0,1
24,23,3349,12,5,7
24,23,560,1,1,0
24,23,576,0,0,0
24,23,806,0,0,0
24,23,465,3,1,2
24,23,1477,11,7,4
24,23,371,0,0,0
24,23,316,1,1,0
24,23,1452,14,6,8
24,23,596,1,0,1
24,23,467,1,0,1
24,23,153,0,0,0
24,23,251,0,0,0
24,23,114,0,0,0
24,23,171,0,0,0
24,23,864,2,0,2
24,24,1974,4,1,3
24,24,2061,5,2,3
24,24,2541,7,2,5
24,24,1758,2,0,2
24,24,2175,71,43,28
24,24,1909,9,4,5
24,24,867,1,1,0
24,24,3041,41,19,22
24,24,1672,1,1,0
24,24,977,132,82,50
24,24,384,13,6,7
24,24,950,4,3,1
24,24,2819,21,12,9
24,24,2074,3,2,1
24,24,1039,4,2,2
24,24,893,5,2,3
24,24,1142,105,63,42
24,24,1098,5,3,2
24,24,841,10,7,3
24,24,1147,3,1,2
24,24,796,4,1,3
24,24,6982,67,37,30
24,24,3670,24,13,11
24,24,3658,18,8,10
24,24,1593,14,9,5
24,24,560,0,0,0
24,24,2188,14,14,0
24,24,4124,87,53,34
24,24,1625,7,2,5
24,24,778,6,2,4
24,24,423,1,0,1
24,24,1018,3,2,1
24,24,1186,2,1,1
24,24,401,4,1,3
24,24,1476,3,1,2
24,24,1637,14,5,9
24,24,523,0,0,0
24,24,192,0,0,0
24,24,339,0,0,0
24,24,213,0,0,0
24,24,437,0,0,0
24,24,443,0,0,0
24,24,648,0,0,0
24,24,1324,0,0,0
24,24,589,0,0,0
24,24,129,1,0,1
24,24,747,9,4,5
24,24,137,0,0,0
24,24,619,0,0,0
24,24,298,0,0,0
24,24,517,0,0,0
24,24,956,2,1,1
24,24,283,1,1,0
24,24,395,0,0,0
24,24,1170,3,2,1
24,24,828,2,0,2
24,24,282,3,1,2
24,24,676,1,0,1
24,24,765,0,0,0
24,24,455,0,0,0
24,24,3969,16,10,6
24,24,2307,24,11,13
24,24,1173,1,1,0
24,24,541,0,0,0
24,24,474,0,0,0
24,24,919,0,0,0
24,24,1400,20,10,10
24,24,394,1,0,1
24,24,676,3,1,2
24,24,312,2,2,0
24,24,888,4,2,2
24,24,2005,5,3,2
24,24,503,1,0,1
24,24,953,5,2,3
24,24,261,1,1,0
24,24,1753,2,1,1
24,24,201,1,0,1
24,24,859,8,3,5
24,24,112,0,0,0
24,24,261,2,1,1
24,24,192,0,0,0
24,24,456,1,0,1
24,24,229,0,0,0
24,24,630,0,0,0
24,24,181,0,0,0
24,24,207,0,0,0
24,24,58,0,0,0
24,25,2401,2,1,1
24,25,3770,22,10,12
24,25,4412,53,29,24
24,25,712,5,1,4
24,25,2204,5,2,3
24,25,617,6,3,3
24,25,4439,5,3,2
24,25,712,1,1,0
24,25,621,2,0,2
24,25,868,9,6,3
24,25,254,0,0,0
24,25,1222,26,16,10
24,25,941,0,0,0
24,25,314,3,0,3
24,25,379,5,0,5
24,25,1332,0,0,0
24,25,451,0,0,0
24,25,968,2,2,0
24,25,537,1,0,1
24,25,584,0,0,0
24,25,253,1,1,0
24,25,2300,1,1,0
24,25,818,5,3,2
24,26,2164,16,8,8
24,26,635,86,48,38
24,26,469,4,2,2
24,26,706,0,0,0
24,26,1578,2,1,1
24,26,722,0,0,0
24,26,821,0,0,0
24,26,829,0,0,0
24,26,1473,1,1,0
24,27,892,1,0,1
24,27,774,68,40,28
24,27,1704,14,9,5
24,27,1590,14,9,5
24,27,814,6,2,4
24,27,695,3,1,2
24,27,1013,1,1,0
24,27,626,1,0,1
24,27,142,0,0,0
24,27,243,0,0,0
24,27,495,0,0,0
24,27,128,0,0,0
24,27,313,1,1,0
24,27,171,0,0,0
24,27,266,1,1,0
24,27,375,0,0,0
24,28,14464,1318,702,616
24,28,14599,225,131,94
24,28,25515,240,116,124
24,28,13984,151,69,82
24,28,1817,19,8,11
24,28,4000,38,17,21
24,28,9735,244,131,113
24,28,3356,80,47,33
24,28,7370,24,14,10
24,28,3659,55,20,35
24,28,4763,42,29,13
24,28,1964,71,34,37
24,28,2070,33,17,16
24,28,5096,149,85,64
24,28,21177,597,307,290
24,28,1179,6,3,3
24,28,2802,150,74,76
24,28,2679,14,8,6
24,28,3879,122,65,57
24,28,5036,73,34,39
24,28,1777,276,147,129
24,28,3089,39,18,21
24,28,3177,51,16,35
24,28,3659,26,12,14
24,28,2401,18,3,15
24,28,1414,3,1,2
24,28,1351,97,46,51
24,28,1455,35,15,20
24,28,1374,7,1,6
24,28,1205,30,17,13
24,28,3175,111,60,51
24,28,778,5,0,5
24,28,12749,273,125,148
24,28,930,15,11,4
24,28,1127,17,11,6
24,28,3123,32,19,13
24,28,1922,4,2,2
24,28,3423,16,4,12
24,28,766,37,23,14
24,28,1745,19,11,8
24,28,1575,243,129,114
24,28,1434,15,8,7
24,28,1510,506,251,255
24,28,2029,83,44,39
24,28,1295,183,96,87
24,28,737,26,17,9
24,28,1022,31,22,9
24,28,733,12,7,5
24,28,4526,35,13,22
24,28,1547,4,2,2
24,28,1058,31,18,13
24,28,2043,21,13,8
24,28,1489,19,8,11
24,28,1563,10,7,3
24,28,1353,15,5,10
24,28,2767,124,69,55
24,28,2321,2,1,1
24,28,2244,29,16,13
24,28,1805,16,7,9
24,28,1267,19,10,9
24,28,1471,570,289,281
24,28,1977,339,181,158
24,28,1994,31,14,17
24,28,1003,20,10,10
24,28,1628,56,31,25
24,28,1327,54,27,27
24,28,2064,33,16,17
24,28,1369,2,0,2
24,28,856,8,6,2
24,28,1886,13,7,6
24,28,2060,18,6,12
24,28,3672,22,10,12
24,28,1198,57,34,23
24,28,2231,28,15,13
24,28,3334,46,23,23
24,28,1865,41,22,19
24,28,1089,16,10,6
24,28,873,8,4,4
24,28,1424,27,11,16
24,28,899,1,0,1
24,28,649,1,1,0
24,28,1143,7,1,6
24,28,737,5,3,2
24,28,1201,10,3,7
24,28,2869,69,35,34
24,28,1813,55,27,28
24,28,1472,9,7,2
24,28,1138,12,6,6
24,28,840,5,3,2
24,28,931,5,3,2
24,28,1871,90,40,50
24,28,511,5,1,4
24,28,1191,18,7,11
24,28,1507,4,2,2
24,28,1611,361,195,166
24,28,1622,6,0,6
24,28,1113,14,5,9
24,28,1738,18,7,11
24,28,1282,11,5,6
24,28,783,11,7,4
24,28,180,2,1,1
24,28,692,9,4,5
24,28,964,13,7,6
24,28,902,11,4,7
24,28,1573,13,7,6
24,28,1076,12,7,5
24,28,1188,109,58,51
24,28,559,4,2,2
24,28,322,6,1,5
24,28,552,2,0,2
24,28,1121,28,16,12
24,28,1595,37,18,19
24,28,2420,105,57,48
24,28,1642,17,5,12
24,28,865,17,10,7
24,28,1228,61,32,29
24,28,887,6,3,3
24,28,1315,7,5,2
24,28,768,5,0,5
24,28,235,0,0,0
24,28,352,1,0,1
24,28,124,4,2,2
24,28,457,4,1,3
24,28,919,41,20,21
24,28,908,14,5,9
24,28,1283,22,8,14
24,28,569,39,20,19
24,28,607,33,13,20
24,28,1009,25,13,12
24,28,650,13,6,7
24,28,529,6,4,2
24,28,1037,21,10,11
24,28,639,8,3,5
24,28,1396,19,10,9
24,28,1747,8,5,3
24,28,968,10,5,5
24,28,610,9,5,4
24,28,1154,25,10,15
24,28,688,5,3,2
24,28,780,35,20,15
24,28,1513,17,9,8
24,28,1286,33,26,7
24,28,1079,21,10,11
24,28,1089,11,5,6
24,28,698,6,1,5
24,28,606,6,3,3
24,28,812,20,12,8
24,28,961,8,5,3
24,28,1588,18,7,11
24,28,1917,11,7,4
24,28,275,2,2,0
24,28,1262,56,24,32
24,28,902,5,3,2
24,28,1364,5,4,1
24,28,839,10,8,2
24,28,499,0,0,0
24,28,2072,21,10,11
24,28,724,5,2,3
24,28,1366,23,13,10
24,28,1452,0,0,0
24,28,754,5,4,1
24,28,1641,18,13,5
24,28,1543,13,7,6
24,28,4277,115,50,65
24,28,1458,19,10,9
24,28,1357,18,10,8
24,28,1788,7,4,3
24,28,1623,14,6,8
24,28,2585,7,3,4
24,28,2484,6,3,3
24,28,11245,159,82,77
24,28,4189,155,76,79
24,28,1426,29,14,15
24,28,1385,23,15,8
24,28,5210,89,47,42
24,28,1561,18,11,7
24,28,1268,4,1,3
24,28,1813,21,13,8
24,28,1195,3,3,0
24,28,1589,26,12,14
24,28,3703,30,15,15
24,28,1456,2,2,0
24,28,11466,301,144,157
24,28,1547,13,5,8
24,28,1580,43,24,19
24,28,1771,136,74,62
24,28,2934,55,30,25
24,28,1226,9,4,5
24,28,5264,71,37,34
24,28,1566,47,27,20
24,28,1649,97,54,43
24,28,1610,14,6,8
24,28,15005,828,442,386
24,28,1926,242,131,111
24,28,5061,243,121,122
24,28,1093,35,23,12
24,28,3686,39,18,21
24,28,3041,69,34,35
24,28,1469,15,6,9
24,28,1202,132,75,57
24,28,6770,645,316,329
24,28,10985,239,111,128
24,28,4969,188,87,101
24,28,11815,877,434,443
24,28,1117,32,20,12
24,28,1860,54,31,23
24,28,1367,37,23,14
24,28,1135,12,5,7
24,28,1328,11,6,5
24,28,2356,15,9,6
24,28,2896,35,15,20
24,28,1264,16,8,8
24,28,797,4,2,2
24,28,1178,17,12,5
24,28,955,6,2,4
24,28,973,12,4,8
24,28,566,10,8,2
24,28,409,6,5,1
24,28,463,1,0,1
24,28,639,5,3,2
24,28,1098,3,2,1
24,28,689,1,0,1
24,28,1158,4,2,2
24,28,1259,58,32,26
24,28,1875,14,6,8
24,28,2100,22,9,13
24,28,1919,6,2,4
24,28,1859,32,9,23
24,28,1100,2,2,0
24,28,1091,13,5,8
24,28,1332,8,5,3
24,28,994,34,11,23
24,28,780,4,1,3
24,28,1040,7,3,4
24,28,562,11,4,7
24,28,620,3,2,1
24,28,178,1,0,1
24,28,653,5,3,2
24,28,1381,11,7,4
24,28,970,4,1,3
24,28,1066,4,3,1
24,28,1008,9,4,5
24,28,371,3,0,3
24,28,779,29,10,19
24,28,1367,17,8,9
24,28,1275,4,2,2
24,28,1163,0,0,0
24,28,1221,16,7,9
24,28,1817,37,16,21
24,28,6663,71,32,39
24,28,1064,16,4,12
24,28,1011,14,9,5
24,28,1096,12,7,5
24,28,969,11,5,6
24,28,1718,17,6,11
24,28,1522,17,7,10
24,28,1229,4,3,1
24,28,2138,4,3,1
24,28,1467,6,2,4
24,28,1355,11,4,7
24,28,1405,10,6,4
24,28,1393,6,3,3
24,28,1256,5,3,2
24,28,1216,13,5,8
24,28,953,7,6,1
24,28,15731,272,144,128
24,28,1771,23,10,13
24,28,978,6,2,4
24,28,2084,29,14,15
24,28,1234,45,26,19
24,28,1270,8,6,2
24,28,3230,87,43,44
24,28,1502,16,5,11
24,28,1231,10,4,6
24,28,2027,11,5,6
24,28,1884,16,8,8
24,28,2107,17,9,8
24,28,2372,126,56,70
24,28,1382,16,10,6
24,28,2509,45,18,27
24,28,1557,40,21,19
24,28,4905,163,83,80
24,28,2306,41,23,18
24,28,2424,137,73,64
24,28,3118,657,327,330
24,28,3310,69,32,37
24,28,2049,24,14,10
24,28,2901,27,12,15
24,28,2624,103,55,48
24,28,2507,27,17,10
24,28,1688,25,16,9
24,28,1412,4,2,2
24,28,1368,28,15,13
24,28,1702,14,7,7
24,28,9982,846,428,418
24,28,4025,90,36,54
24,28,3376,78,35,43
24,28,1460,20,9,11
24,28,2459,98,50,48
24,28,15632,243,108,135
24,28,23384,420,209,211
24,28,9622,361,175,186
24,28,838,2,2,0
24,28,991,0,0,0
24,28,211,1,1,0
24,28,724,65,34,31
24,28,390,275,146,129
24,28,265,232,116,116
24,28,402,132,75,57
24,28,227,0,0,0
24,28,295,0,0,0
24,28,338,4,2,2
24,28,1175,241,129,112
24,28,353,0,0,0
24,28,853,0,0,0
24,28,356,1,0,1
24,28,644,0,0,0
24,28,184,0,0,0
24,28,617,1,1,0
24,28,868,2,0,2
24,28,328,0,0,0
24,28,120,2,2,0
24,28,775,3,0,3
24,28,810,1,1,0
24,28,113,0,0,0
24,28,125,0,0,0
24,28,1726,9,5,4
24,28,1468,18,8,10
24,28,265,0,0,0
24,28,4350,66,23,43
24,28,2577,44,22,22
24,28,1353,46,19,27
24,28,14245,147,78,69
24,28,771,14,6,8
24,28,5573,248,126,122
24,28,35245,1105,550,555
24,28,4844,100,52,48
24,28,3495,78,37,41
24,28,9298,140,74,66
24,28,6735,82,49,33
24,28,3759,29,14,15
24,28,9076,185,91,94
24,28,8847,36,16,20
24,28,3102,12,7,5
24,28,1445,3,0,3
24,28,9017,940,479,461
24,28,1920,11,6,5
24,28,1857,6,1,5
24,28,1400,4,4,0
24,28,6190,9,5,4
24,28,2364,10,7,3
24,28,1370,5,2,3
24,29,990,2,1,1
24,29,1966,101,57,44
24,29,883,8,2,6
24,29,1352,0,0,0
24,29,473,1,1,0
24,29,233,1,1,0
24,29,982,3,1,2
24,29,335,1,0,1
24,29,872,3,2,1
24,29,377,8,4,4
24,29,200,2,2,0
24,29,290,0,0,0
24,29,1555,4,2,2
24,29,2052,109,61,48
24,29,1400,8,4,4
24,29,1432,49,21,28
24,29,341,4,2,2
24,29,669,3,2,1
24,29,220,14,6,8
24,29,1791,15,9,6
24,30,864,7,2,5
24,30,119,0,0,0
24,30,145,0,0,0
24,30,360,0,0,0
24,30,336,0,0,0
24,30,471,1,1,0
24,30,89,0,0,0
24,30,333,1,1,0
24,30,393,0,0,0
24,30,350,2,0,2
24,30,1296,2,1,1
24,31,1133,9,4,5
24,31,1391,4,3,1
24,31,2816,7,1,6
24,31,1000,10,4,6
24,31,616,11,5,6
24,31,293,1,1,0
24,31,101,0,0,0
24,31,726,2,1,1
24,31,474,0,0,0
24,31,890,2,0,2
24,31,223,0,0,0
24,31,404,4,3,1
24,31,300,0,0,0
24,31,356,3,2,1
24,31,1294,1,0,1
24,31,279,0,0,0
24,31,517,0,0,0
24,31,641,2,1,1
24,31,1489,9,2,7
24,32,221,0,0,0
24,32,1059,0,0,0
24,32,1212,0,0,0
24,32,314,0,0,0
24,32,1363,0,0,0
24,32,976,12,4,8
24,32,1080,7,4,3
24,32,2507,690,343,347
24,32,3438,7,4,3
24,33,2471,2,1,1
24,33,1333,19,12,7
24,33,1997,12,8,4
24,33,2641,9,6,3
24,33,1454,3,2,1
24,33,2981,21,12,9
24,33,2041,14,7,7
24,33,463,1,1,0
24,33,426,2,0,2
24,33,258,1,1,0
24,33,348,3,1,2
24,33,573,4,1,3
24,33,601,0,0,0
24,33,734,3,1,2
24,33,1325,6,2,4
24,33,2123,463,245,218
24,33,2569,16,10,6
24,33,1119,4,0,4
24,33,586,12,6,6
24,33,119,0,0,0
24,33,1280,12,5,7
24,33,2022,7,3,4
24,33,917,8,3,5
24,33,2285,23,11,12
24,33,1182,11,4,7
24,33,1194,4,1,3
24,33,615,2,1,1
24,33,1992,4,1,3
24,33,1962,7,3,4
24,33,569,1,1,0
24,34,700,16,9,7
24,34,212,0,0,0
24,34,343,0,0,0
24,34,227,0,0,0
24,34,407,4,2,2
24,34,582,4,1,3
24,34,329,3,1,2
24,34,334,3,3,0
24,34,599,5,1,4
24,34,226,5,3,2
24,34,226,1,0,1
24,34,236,15,8,7
24,34,397,3,3,0
24,34,369,5,2,3
24,34,288,0,0,0
24,34,307,0,0,0
24,34,678,0,0,0
24,34,1765,6,2,4
24,34,259,0,0,0
24,34,1947,0,0,0
24,34,353,3,1,2
24,35,908,2,0,2
24,35,776,0,0,0
24,35,2557,7,2,5
24,35,2111,7,5,2
24,35,2751,27,13,14
24,35,22816,465,237,228
24,35,1795,10,7,3
24,35,1321,22,9,13
24,35,3400,13,4,9
24,35,3643,11,7,4
24,35,4795,30,10,20
24,35,12922,90,39,51
24,35,2044,4,3,1
24,35,2905,49,20,29
24,35,2973,36,18,18
24,35,894,2,1,1
24,35,1354,4,2,2
24,35,4366,47,21,26
24,35,1511,6,3,3
24,35,1561,15,7,8
24,35,698,3,1,2
24,35,771,5,3,2
24,35,963,8,4,4
24,35,931,1,1,0
24,35,1022,14,7,7
24,35,1568,19,10,9
24,35,2242,27,16,11
24,35,793,5,2,3
24,35,889,17,11,6
24,35,2483,70,36,34
24,35,3699,31,13,18
24,35,19597,356,174,182
24,35,24975,1157,539,618
24,35,2495,260,148,112
24,35,2134,201,114,87
24,35,928,10,3,7
24,35,2064,57,32,25
24,35,2110,444,241,203
24,35,1708,42,23,19
24,35,1141,10,4,6
24,35,1774,20,11,9
24,35,1779,28,12,16
24,35,1523,36,15,21
24,35,2354,57,31,26
24,35,2240,28,13,15
24,35,9820,240,124,116
24,35,10163,248,122,126
24,35,3391,33,15,18
24,35,1628,13,4,9
24,35,1597,34,19,15
24,35,2105,7,3,4
24,35,2904,12,6,6
24,35,1885,15,7,8
24,35,1488,32,14,18
24,35,1954,27,13,14
24,35,1794,15,8,7
24,35,1397,9,6,3
24,35,6882,78,35,43
24,35,2344,15,7,8
24,35,2775,25,12,13
24,35,1768,31,17,14
24,35,4572,29,12,17
24,35,22026,1232,627,605
24,35,6867,52,24,28
24,35,1635,16,3,13
24,35,951,4,2,2
24,35,912,0,0,0
24,35,623,10,6,4
24,35,933,13,5,8
24,35,1007,4,3,1
24,35,2158,27,18,9
24,35,5583,173,78,95
24,35,12803,142,68,74
24,35,7257,77,33,44
24,35,16437,127,57,70
24,35,3471,69,33,36
24,35,1163,37,16,21
24,36,2000,33,16,17
24,36,1373,7,1,6
24,36,1534,304,158,146
24,36,849,1,0,1
24,36,774,0,0,0
24,36,2110,85,44,41
24,36,721,30,11,19
24,36,2622,10,7,3
24,36,2140,2,1,1
24,36,2408,7,4,3
24,36,1630,9,5,4
24,36,2141,7,3,4
24,36,882,150,69,81
24,36,2179,128,61,67
24,36,2802,10,6,4
24,36,820,2,1,1
24,36,2048,5,4,1
24,37,584,3,2,1
24,37,313,0,0,0
24,37,412,0,0,0
24,37,778,175,97,78
24,37,967,31,18,13
24,37,1000,154,87,67
24,37,901,150,76,74
24,37,1120,5,3,2
24,37,2117,3,0,3
24,37,1197,8,5,3
24,37,1431,0,0,0
24,37,1861,0,0,0
24,37,2077,3,2,1
24,58,1507,6,4,2
24,58,1051,0,0,0
24,58,1456,2,0,2
24,58,726,8,6,2
24,58,2265,6,3,3
24,58,209,0,0,0
24,58,2017,50,22,28
24,58,1979,39,22,17
24,58,1224,2,0,2
24,58,3948,6,1,5
24,58,2490,31,13,18
24,58,1176,1,0,1
24,58,675,4,1,3
24,58,2010,3,2,1
24,58,2173,1,1,0
24,58,2437,4,2,2
24,37,391,3,1,2
24,58,1481,5,2,3
24,37,1488,4,1,3
24,37,1015,14,4,10
24,37,2029,4,2,2
24,37,609,0,0,0
24,37,1607,37,19,18
24,37,1589,12,5,7
24,37,1637,54,29,25
24,37,1049,507,261,246
24,37,2923,46,23,23
24,37,2333,228,115,113
24,37,1996,14,7,7
24,37,1415,364,179,185
24,37,336,0,0,0
24,37,2571,56,27,29
24,37,909,5,5,0
24,37,4576,613,321,292
24,37,1084,3,0,3
24,37,1159,0,0,0
24,37,1785,3,1,2
24,37,1890,0,0,0
24,37,803,4,3,1
24,37,5665,31,14,17
24,37,1250,3,1,2
24,37,1948,18,11,7
24,37,1835,5,3,2
24,37,2226,20,9,11
24,37,2701,9,5,4
24,37,873,1,1,0
24,37,1457,166,96,70
24,37,1545,3,1,2
24,37,1112,1,0,1
24,37,2408,7,3,4
24,37,1110,2,1,1
24,37,848,3,2,1
24,37,1699,1,0,1
24,37,1265,0,0,0
24,37,755,1,1,0
24,37,1954,2,1,1
24,37,1531,2,2,0
24,37,1100,0,0,0
24,37,1010,1,0,1
24,37,1512,1,0,1
24,37,2664,0,0,0
24,37,3457,12,2,10
24,37,3379,15,9,6
24,38,937,1,1,0
24,38,603,3,1,2
24,38,1174,9,2,7
24,38,500,1,1,0
24,38,267,0,0,0
24,38,1485,1,1,0
24,38,1382,2,1,1
24,38,439,2,1,1
24,38,489,4,4,0
24,38,696,2,1,1
24,38,795,0,0,0
24,38,1038,4,3,1
24,38,761,1,0,1
24,38,1427,2,1,1
24,38,223,0,0,0
24,38,2068,1,1,0
24,39,2261,9,3,6
24,39,1935,19,9,10
24,39,610,0,0,0
24,39,648,1,0,1
24,39,1006,1,0,1
24,39,793,3,1,2
24,39,515,0,0,0
24,39,596,0,0,0
24,39,734,1,1,0
24,39,838,4,2,2
24,39,998,4,2,2
24,39,238,2,2,0
24,39,425,248,118,130
24,39,584,4,2,2
24,39,806,2,2,0
24,39,643,0,0,0
24,40,738,2,1,1
24,40,1299,0,0,0
24,40,191,0,0,0
24,40,830,3,0,3
24,40,879,15,5,10
24,40,1325,12,9,3
24,40,951,10,4,6
24,40,509,1,0,1
24,40,711,5,3,2
24,40,610,1,0,1
24,40,7238,36,15,21
24,40,947,0,0,0
24,40,931,3,2,1
24,40,614,3,2,1
24,40,394,1,0,1
24,40,1253,10,5,5
24,40,627,2,0,2
24,40,1520,2,1,1
24,40,1190,11,4,7
24,40,1713,1,0,1
24,40,1599,11,4,7
24,40,342,0,0,0
24,40,549,0,0,0
24,40,872,1,0,1
24,40,239,0,0,0
24,40,262,1,0,1
24,40,451,2,2,0
24,40,1206,6,2,4
24,40,142,3,1,2
24,40,2272,4,1,3
24,40,1478,4,3,1
24,40,898,2,1,1
24,40,1358,8,4,4
24,40,344,0,0,0
24,40,605,0,0,0
24,41,2125,10,4,6
24,41,2194,9,6,3
24,41,518,1,1,0
24,41,999,1,0,1
24,41,389,2,0,2
24,41,653,0,0,0
24,41,717,0,0,0
24,41,989,1,0,1
24,41,559,6,5,1
24,41,848,3,3,0
24,41,1603,7,4,3
24,41,1115,3,1,2
24,41,2476,5,2,3
24,41,843,34,11,23
24,41,672,0,0,0
24,41,894,6,5,1
24,42,2813,208,107,101
24,42,2198,415,210,205
24,42,1339,13,6,7
24,42,2112,11,4,7
24,42,762,3,1,2
24,42,1715,251,131,120
24,42,829,12,8,4
24,42,561,4,2,2
24,42,886,0,0,0
24,42,100,10,3,7
24,42,137,4,1,3
24,43,679,0,0,0
24,43,1326,3,1,2
24,43,1008,8,7,1
24,43,1022,13,8,5
24,43,1847,14,6,8
24,43,944,1,0,1
24,43,258,0,0,0
24,43,449,1,0,1
24,43,187,1,0,1
24,43,108,1,0,1
24,43,109,0,0,0
24,44,1224,2,1,1
24,44,396,7,0,7
24,44,1011,1,1,0
24,44,144,0,0,0
24,44,207,0,0,0
24,44,670,5,2,3
24,44,319,0,0,0
24,44,780,0,0,0
24,44,398,1,1,0
24,44,326,18,9,9
24,44,585,2,1,1
24,44,336,1,1,0
24,44,322,0,0,0
24,44,715,0,0,0
24,45,1837,41,23,18
24,45,910,1,1,0
24,45,2120,3,1,2
24,45,1538,34,20,14
24,45,518,0,0,0
24,45,701,3,2,1
24,45,299,0,0,0
24,45,385,1,1,0
24,45,1107,2,0,2
24,45,828,0,0,0
24,45,652,5,3,2
24,45,299,0,0,0
24,45,130,0,0,0
24,45,260,0,0,0
24,45,469,0,0,0
24,45,548,0,0,0
24,45,358,0,0,0
24,45,343,0,0,0
24,45,456,0,0,0
24,45,404,4,2,2
24,46,3598,13,5,8
24,46,2659,6,4,2
24,46,2846,17,11,6
24,46,171,0,0,0
24,46,327,0,0,0
24,46,1620,0,0,0
24,46,921,1,1,0
24,46,477,0,0,0
24,46,824,12,6,6
24,46,1402,0,0,0
24,46,372,0,0,0
24,46,1591,14,7,7
24,46,456,0,0,0
24,47,2114,24,13,11
24,47,2857,26,12,14
24,47,1200,1,1,0
24,47,588,0,0,0
24,47,224,3,2,1
24,47,1036,9,4,5
24,47,1715,11,5,6
24,47,1532,2,0,2
24,47,330,1,0,1
24,47,368,8,6,2
24,47,1603,18,10,8
24,47,668,4,1,3
24,47,1477,7,4,3
24,47,231,0,0,0
24,47,525,1,1,0
24,47,1035,8,5,3
24,47,333,0,0,0
24,47,370,0,0,0
24,48,1081,4,1,3
24,48,671,5,2,3
24,48,124,0,0,0
24,48,1025,10,6,4
24,48,296,0,0,0
24,48,446,0,0,0
24,48,209,0,0,0
24,48,415,2,1,1
24,48,440,0,0,0
24,48,1172,2,2,0
24,48,638,1,0,1
24,48,193,0,0,0
24,48,1672,3,0,3
24,48,458,0,0,0
24,48,539,1,1,0
24,49,232,11,4,7
24,49,1248,1,0,1
24,49,1005,1,1,0
24,49,676,8,5,3
24,49,540,5,3,2
24,49,509,4,2,2
24,49,576,35,18,17
24,49,528,4,3,1
24,50,1971,1,0,1
24,50,2289,5,2,3
24,50,421,0,0,0
24,50,2327,7,3,4
24,50,2605,16,6,10
24,50,1228,0,0,0
24,50,1398,3,3,0
24,50,2189,30,17,13
24,50,2134,3,0,3
24,50,381,1,0,1
24,50,3569,15,7,8
24,50,2817,6,2,4
24,50,383,32,14,18
24,50,430,18,8,10
24,50,203,0,0,0
24,50,1082,2,1,1
24,50,1396,22,10,12
24,50,2235,9,4,5
24,50,1210,4,1,3
24,50,2563,6,3,3
24,50,1576,12,8,4
24,50,2366,5,2,3
24,50,682,0,0,0
24,50,520,0,0,0
24,50,414,0,0,0
24,51,1924,14,5,9
24,51,2124,18,9,9
24,51,1009,3,1,2
24,51,1479,6,3,3
24,51,3329,11,6,5
24,51,1386,3,2,1
24,51,542,0,0,0
24,51,3847,13,8,5
24,51,3036,22,7,15
24,51,1156,6,1,5
24,51,1699,7,3,4
24,51,1006,7,5,2
24,51,246,0,0,0
24,51,769,7,4,3
24,51,2203,19,11,8
24,51,3804,66,34,32
24,51,595,3,1,2
24,51,2523,7,2,5
24,51,1871,2,1,1
24,51,872,2,2,0
24,51,2338,11,7,4
24,51,2074,33,18,15
24,51,1047,2,0,2
24,51,1286,0,0,0
24,51,473,1,1,0
24,51,975,1,0,1
24,51,894,5,3,2
24,51,1408,6,4,2
24,51,1698,7,3,4
24,51,1404,2,2,0
24,51,3321,19,12,7
24,51,582,4,2,2
24,52,1577,11,7,4
24,52,1171,193,99,94
24,52,1097,0,0,0
24,52,448,0,0,0
24,52,1328,8,4,4
24,52,710,16,8,8
24,52,660,9,5,4
24,52,1129,16,9,7
24,52,52,0,0,0
24,52,628,0,0,0
24,52,1195,11,6,5
24,52,320,0,0,0
24,52,300,0,0,0
24,52,851,75,37,38
24,52,495,6,2,4
24,52,2159,13,7,6
24,52,607,8,3,5
24,52,419,15,5,10
24,52,238,0,0,0
24,53,1064,5,2,3
24,53,533,0,0,0
24,53,574,0,0,0
24,53,788,0,0,0
24,53,554,7,4,3
24,53,150,1,0,1
24,53,1462,1,0,1
24,53,416,0,0,0
24,53,1479,6,3,3
24,53,1358,35,19,16
24,53,473,0,0,0
24,53,654,3,0,3
24,53,129,0,0,0
24,53,139,0,0,0
24,53,136,0,0,0
24,53,478,89,43,46
24,54,2179,0,0,0
24,54,1199,31,17,14
24,54,2545,6,5,1
24,54,2123,2,0,2
24,54,1093,3,1,2
24,54,964,0,0,0
24,54,2426,3,2,1
24,54,791,2,0,2
24,54,507,3,2,1
24,54,1603,0,0,0
24,54,820,0,0,0
24,54,1769,2,2,0
24,54,1010,0,0,0
24,54,1895,12,2,10
24,54,1104,1,1,0
24,54,2392,2,1,1
24,54,1542,2,1,1
24,54,1495,0,0,0
24,54,1918,22,11,11
24,54,1465,9,4,5
24,54,1886,0,0,0
24,55,2829,2,0,2
24,55,1333,4,2,2
24,55,915,6,2,4
24,55,807,0,0,0
24,55,2303,28,15,13
24,55,2514,6,0,6
24,55,1650,6,2,4
24,55,691,1,0,1
24,55,73,0,0,0
24,55,1127,1,1,0
24,55,181,0,0,0
24,55,758,407,199,208
24,55,693,2,1,1
24,55,2555,2,1,1
24,55,844,18,9,9
24,55,1183,2,1,1
24,55,353,60,31,29
24,55,719,1,0,1
24,55,789,1,0,1
24,55,360,0,0,0
24,55,504,3,0,3
24,55,1073,0,0,0
24,55,927,0,0,0
24,55,1261,1,1,0
24,55,1082,0,0,0
24,55,1007,1,0,1
24,55,549,14,8,6
24,55,816,6,5,1
24,55,670,1,1,0
24,55,1049,4,2,2
24,55,1852,57,30,27
24,55,740,38,16,22
24,55,1074,2,1,1
24,55,737,7,5,2
24,55,1795,13,6,7
24,55,999,2,1,1
24,55,1705,7,4,3
24,55,1107,1,0,1
24,55,390,3,1,2
24,55,916,3,3,0
24,55,566,0,0,0
24,55,1407,8,5,3
24,55,462,1,0,1
24,55,1425,12,6,6
24,55,1019,23,15,8
24,55,599,4,1,3
24,55,1345,2,1,1
24,56,5289,1324,633,691
24,56,2710,37,19,18
24,56,2305,22,10,12
24,56,3885,102,45,57
24,56,232,0,0,0
24,56,1144,5,3,2
24,56,1492,3,1,2
24,56,337,0,0,0
24,56,936,1,1,0
24,56,342,7,5,2
24,56,967,6,4,2
24,56,701,1,1,0
24,56,628,8,5,3
24,56,182,1,1,0
24,56,2953,17,10,7
24,56,235,1,1,0
24,56,549,6,3,3
24,56,184,2,2,0
24,56,570,2,1,1
24,56,916,3,1,2
24,56,197,0,0,0
24,56,349,0,0,0
24,28,960,13,6,7
24,28,1045,1,0,1
24,28,1201,11,6,5
24,28,1476,25,13,12
24,28,1082,9,4,5
24,28,2016,31,18,13
24,28,870,14,6,8
24,28,2099,104,48,56
24,28,1076,5,2,3
24,28,1579,48,28,20
24,28,1367,9,4,5
24,28,1842,14,9,5
24,28,1657,28,16,12
24,28,560,11,6,5
24,28,634,7,3,4
24,28,1334,25,10,15
24,28,1487,9,4,5
24,28,1624,23,10,13
24,28,1588,35,19,16
24,35,1385,71,34,37
24,35,3015,68,34,34
24,35,3029,89,49,40
24,35,1894,45,20,25
24,35,1849,30,15,15
24,28,582,14,9,5
24,35,4302,130,62,68
24,35,3188,38,23,15
24,35,3287,51,24,27
24,35,4421,93,43,50
24,35,2969,18,10,8
24,35,2946,70,36,34
24,35,1706,65,28,37
25,1,264,1,0,1
25,1,1077,3,1,2
25,1,330,2,2,0
25,1,524,1,0,1
25,1,272,0,0,0
25,1,655,1,1,0
25,1,579,2,2,0
25,1,397,2,2,0
25,1,450,4,3,1
25,1,440,1,0,1
25,1,311,4,1,3
25,1,386,2,1,1
25,1,1073,6,3,3
25,1,321,0,0,0
25,1,352,1,1,0
25,1,294,1,0,1
25,1,305,1,0,1
25,1,1346,7,2,5
25,1,574,2,1,1
25,1,435,0,0,0
25,1,736,15,5,10
25,1,1422,29,17,12
25,1,957,4,2,2
25,1,364,9,5,4
25,1,486,4,2,2
25,1,325,0,0,0
25,1,255,8,5,3
25,1,162,4,1,3
25,1,539,1,0,1
25,1,530,1,1,0
25,1,217,5,2,3
25,1,3265,24,14,10
25,1,228,0,0,0
25,1,250,1,0,1
25,1,169,0,0,0
25,1,252,0,0,0
25,1,489,0,0,0
25,1,453,1,1,0
25,1,376,0,0,0
25,1,504,8,4,4
25,1,409,5,3,2
25,1,415,0,0,0
25,1,518,4,3,1
25,1,145,0,0,0
25,1,180,1,1,0
25,1,346,5,2,3
25,1,260,0,0,0
25,1,272,0,0,0
25,1,487,1,0,1
25,1,244,1,1,0
25,1,277,7,4,3
25,1,268,4,1,3
25,1,212,1,1,0
25,1,203,2,0,2
25,1,492,8,3,5
25,1,218,2,1,1
25,1,633,1,1,0
25,1,271,1,0,1
25,1,300,0,0,0
25,1,285,0,0,0
25,1,241,0,0,0
25,1,307,1,1,0
25,1,728,4,2,2
25,1,239,0,0,0
25,1,122,0,0,0
25,1,211,0,0,0
25,1,202,0,0,0
25,1,237,0,0,0
25,1,302,5,4,1
25,1,144,0,0,0
25,1,269,4,3,1
25,1,241,0,0,0
25,1,328,5,2,3
25,1,4225,323,179,144
25,1,1256,2,2,0
25,1,378,0,0,0
25,1,2286,53,27,26
25,1,589,0,0,0
25,1,664,9,4,5
25,1,659,6,4,2
25,1,388,0,0,0
25,1,426,2,0,2
25,1,185,6,4,2
25,1,673,1,0,1
25,1,1140,2,1,1
25,1,1796,5,1,4
25,1,718,1,0,1
25,1,643,2,0,2
25,1,559,0,0,0
25,1,2296,81,43,38
25,1,2127,6,5,1
25,1,171,0,0,0
25,1,1353,2,0,2
25,1,406,4,2,2
25,1,229,3,1,2
25,1,320,0,0,0
25,1,223,1,1,0
25,1,808,5,4,1
25,1,943,0,0,0
25,1,954,0,0,0
25,1,263,0,0,0
25,1,3063,14,10,4
25,1,2064,11,7,4
25,1,1381,5,2,3
25,1,373,3,1,2
25,1,386,0,0,0
25,1,599,0,0,0
25,1,613,1,1,0
25,1,755,5,2,3
25,1,2871,8,4,4
25,1,847,1,1,0
25,1,447,1,1,0
25,1,324,0,0,0
25,1,563,1,1,0
25,1,335,1,1,0
25,1,334,2,1,1
25,1,427,1,0,1
25,1,317,0,0,0
25,1,253,0,0,0
25,1,499,0,0,0
25,1,478,0,0,0
25,1,279,1,0,1
25,1,263,1,0,1
25,1,360,1,0,1
25,1,433,0,0,0
25,1,506,0,0,0
25,1,470,3,2,1
25,1,306,0,0,0
25,1,599,0,0,0
25,1,773,5,2,3
25,1,616,3,1,2
25,1,513,0,0,0
25,1,636,1,1,0
25,1,737,3,1,2
25,1,482,3,3,0
25,1,452,1,0,1
25,1,470,0,0,0
25,1,528,15,9,6
25,1,348,3,2,1
25,1,686,0,0,0
25,1,624,1,0,1
25,1,356,0,0,0
25,1,323,2,1,1
25,1,1324,2,2,0
25,1,1109,6,0,6
25,1,231,2,1,1
25,1,843,33,16,17
25,1,543,6,4,2
25,1,1391,18,7,11
25,1,1167,9,4,5
25,1,426,2,2,0
25,1,1143,0,0,0
25,1,268,1,1,0
25,1,410,0,0,0
25,1,462,0,0,0
25,1,666,4,1,3
25,1,578,6,4,2
25,1,286,0,0,0
25,1,442,0,0,0
25,1,444,1,1,0
25,1,262,0,0,0
25,1,347,0,0,0
25,1,210,0,0,0
25,1,189,0,0,0
25,1,422,4,3,1
25,1,396,32,16,16
25,1,332,7,3,4
25,1,338,2,2,0
25,1,248,2,1,1
25,1,268,0,0,0
25,1,698,6,4,2
25,1,388,3,3,0
25,1,250,3,1,2
25,1,211,2,0,2
25,1,380,1,0,1
25,1,141,0,0,0
25,1,281,0,0,0
25,1,238,2,0,2
25,1,320,2,0,2
25,1,208,0,0,0
25,1,242,0,0,0
25,1,625,1,0,1
25,1,943,2,1,1
25,1,244,0,0,0
25,1,6028,14,4,10
25,1,431,0,0,0
25,1,306,0,0,0
25,1,1142,2,1,1
25,1,386,2,1,1
25,1,821,7,2,5
25,1,947,115,54,61
25,1,878,7,6,1
25,1,867,2,1,1
25,1,425,0,0,0
25,1,642,1,0,1
25,1,269,0,0,0
25,1,248,0,0,0
25,1,306,2,1,1
25,1,498,6,4,2
25,1,404,11,4,7
25,1,330,3,1,2
25,1,380,1,0,1
25,1,343,0,0,0
25,1,440,3,2,1
25,1,598,5,5,0
25,1,609,5,2,3
25,1,395,2,1,1
25,1,410,1,0,1
25,1,374,2,2,0
25,1,461,3,1,2
25,1,175,4,4,0
25,1,2758,51,28,23
25,1,410,11,7,4
25,1,320,0,0,0
25,1,471,0,0,0
25,1,415,1,0,1
25,1,291,2,1,1
25,1,802,1,0,1
25,1,595,0,0,0
25,1,287,17,8,9
25,1,447,11,5,6
25,1,1644,50,27,23
25,1,548,0,0,0
25,1,257,0,0,0
25,1,385,0,0,0
25,1,3540,51,26,25
25,1,1350,9,3,6
25,1,1048,0,0,0
25,1,485,11,5,6
25,1,859,4,2,2
25,1,987,0,0,0
25,1,541,5,2,3
25,1,959,3,2,1
25,1,2202,8,5,3
25,1,474,7,3,4
25,1,446,0,0,0
25,1,430,0,0,0
25,1,5069,11,5,6
25,1,992,0,0,0
25,1,822,1,1,0
25,1,908,0,0,0
25,1,1723,12,6,6
25,1,751,0,0,0
25,1,769,0,0,0
25,1,572,3,2,1
25,1,1979,17,8,9
25,1,714,1,1,0
25,1,725,0,0,0
25,1,347,3,2,1
25,1,368,1,1,0
25,1,650,5,3,2
25,1,349,0,0,0
25,1,866,1,0,1
25,1,121,0,0,0
25,1,1483,4,2,2
25,1,605,27,16,11
25,1,1369,13,8,5
25,1,197,0,0,0
25,1,2761,344,1,343
25,1,247,1,0,1
25,1,265,0,0,0
25,1,783,0,0,0
25,1,926,6,6,0
25,1,461,1,1,0
25,1,912,10,4,6
25,1,871,0,0,0
25,1,2286,10,6,4
25,1,1519,15,5,10
25,1,1745,28,13,15
25,1,745,25,12,13
25,1,821,5,4,1
25,1,471,2,1,1
25,1,623,1,0,1
25,1,473,0,0,0
25,1,428,1,1,0
25,1,1773,0,0,0
25,1,1449,3,1,2
25,1,599,10,8,2
25,1,816,2,0,2
25,1,731,0,0,0
25,1,413,2,1,1
25,1,417,0,0,0
25,1,1257,3,1,2
25,1,1393,7,4,3
25,1,1021,14,10,4
25,1,587,0,0,0
25,1,722,1,1,0
25,1,634,0,0,0
25,1,575,1,1,0
25,1,1385,1,0,1
25,1,860,1,0,1
25,1,1327,4,2,2
25,1,291,0,0,0
25,1,612,52,23,29
25,1,330,16,8,8
25,1,127,1,0,1
25,1,778,6,1,5
25,1,1869,5,3,2
25,1,1471,4,2,2
25,1,542,15,4,11
25,1,1158,16,9,7
25,1,911,2,0,2
25,1,346,2,0,2
25,1,816,1,1,0
25,1,963,4,2,2
25,1,474,2,2,0
25,1,1014,0,0,0
25,1,675,0,0,0
25,1,1388,1,0,1
25,1,791,5,2,3
25,1,712,1,0,1
25,1,1039,2,1,1
25,1,973,14,10,4
25,1,1072,0,0,0
25,1,1,-6,-6,-6
25,1,670,2,0,2
25,1,571,0,0,0
25,1,469,0,0,0
25,1,470,0,0,0
25,1,1187,0,0,0
25,1,1607,0,0,0
25,1,510,0,0,0
25,1,865,1,0,1
25,1,283,0,0,0
25,1,544,0,0,0
25,1,411,0,0,0
25,1,433,0,0,0
25,1,619,2,2,0
25,1,676,0,0,0
25,1,664,1,0,1
25,1,872,2,1,1
25,1,1083,0,0,0
25,1,9664,196,92,104
25,1,391,1,1,0
25,1,2989,25,10,15
25,1,583,28,13,15
25,1,738,1,1,0
25,1,953,2,2,0
25,1,2324,10,6,4
25,1,8642,134,68,66
25,1,1352,7,3,4
25,1,854,2,1,1
25,1,953,1,0,1
25,1,1159,1,1,0
25,1,836,2,1,1
25,1,967,12,8,4
25,1,1296,2,2,0
25,1,349,1,0,1
25,1,2537,10,4,6
25,1,794,4,1,3
25,1,280,0,0,0
25,1,903,2,0,2
25,1,351,3,1,2
25,1,516,0,0,0
25,1,375,0,0,0
25,1,1669,2,1,1
25,1,926,1,1,0
25,1,321,0,0,0
25,1,633,1,0,1
25,1,425,2,1,1
25,1,364,4,2,2
25,1,221,6,3,3
25,1,558,1,0,1
25,1,1545,9,5,4
25,1,616,1,0,1
25,1,496,7,5,2
25,1,460,1,1,0
25,1,528,0,0,0
25,1,381,1,0,1
25,1,377,0,0,0
25,1,350,0,0,0
25,1,235,0,0,0
25,1,1259,0,0,0
25,1,1022,0,0,0
25,1,959,2,1,1
25,1,580,0,0,0
25,1,271,0,0,0
25,1,513,1,1,0
25,1,347,0,0,0
25,1,461,0,0,0
25,1,675,0,0,0
25,1,434,0,0,0
25,1,689,0,0,0
25,1,700,1,1,0
25,1,1242,0,0,0
25,1,278,0,0,0
25,1,427,2,1,1
25,1,622,68,28,40
25,1,786,23,12,11
25,1,438,0,0,0
25,1,1087,1,0,1
25,1,605,0,0,0
25,1,1288,1,0,1
25,1,458,0,0,0
25,1,1842,4,1,3
25,1,3989,5,2,3
25,1,744,1,1,0
25,1,1272,3,1,2
25,1,553,0,0,0
25,1,569,1,1,0
25,1,138,0,0,0
25,1,830,1,0,1
25,1,775,1,0,1
25,1,421,1,1,0
25,1,878,2,0,2
25,1,580,1,0,1
25,1,23,0,0,0
25,1,1008,2,2,0
25,1,452,1,0,1
25,1,808,0,0,0
25,1,737,0,0,0
25,1,362,1,0,1
25,1,315,3,0,3
25,1,1068,1,0,1
25,1,179,0,0,0
25,1,432,2,2,0
25,1,177,0,0,0
25,1,278,2,2,0
25,1,1098,10,4,6
25,1,719,1,1,0
25,1,469,0,0,0
25,1,1352,3,3,0
25,1,974,0,0,0
25,1,1015,1,1,0
25,1,1785,1,0,1
25,1,117,0,0,0
25,1,695,1,0,1
25,1,416,1,1,0
25,1,537,0,0,0
25,1,472,3,0,3
25,1,601,0,0,0
25,1,218,2,2,0
25,1,688,2,0,2
25,1,2810,6,2,4
25,1,1172,0,0,0
25,1,1034,1,1,0
25,1,191,0,0,0
25,1,757,2,0,2
25,1,388,1,0,1
25,1,449,0,0,0
25,2,1212,2,0,2
25,2,405,3,0,3
25,2,279,5,2,3
25,2,517,7,3,4
25,2,201,1,1,0
25,2,742,0,0,0
25,2,767,4,3,1
25,2,331,1,1,0
25,2,1058,2,2,0
25,2,1865,11,3,8
25,2,221,0,0,0
25,2,302,0,0,0
25,2,601,0,0,0
25,2,906,9,4,5
25,2,377,2,1,1
25,2,386,5,4,1
25,2,259,0,0,0
25,2,387,4,3,1
25,2,427,2,2,0
25,2,738,8,5,3
25,2,424,0,0,0
25,2,578,30,19,11
25,2,188,0,0,0
25,2,191,0,0,0
25,2,131,0,0,0
25,2,332,0,0,0
25,2,227,0,0,0
25,2,666,1,0,1
25,2,437,4,2,2
25,2,714,1,1,0
25,2,973,0,0,0
25,2,351,0,0,0
25,2,337,9,1,8
25,2,701,0,0,0
25,2,364,0,0,0
25,2,327,1,0,1
25,2,185,0,0,0
25,2,16,0,0,0
25,2,406,0,0,0
25,2,192,1,0,1
25,2,419,0,0,0
25,2,364,0,0,0
25,2,593,0,0,0
25,2,276,1,1,0
25,2,763,0,0,0
25,2,126,1,0,1
25,2,182,0,0,0
25,2,243,1,1,0
25,2,218,1,0,1
25,2,373,0,0,0
25,2,206,1,0,1
25,2,415,0,0,0
25,2,376,0,0,0
25,2,167,0,0,0
25,2,124,0,0,0
25,2,188,1,0,1
25,2,135,1,0,1
25,2,370,0,0,0
25,2,317,0,0,0
25,2,303,0,0,0
25,2,266,0,0,0
25,2,479,2,0,2
25,2,394,0,0,0
25,2,332,0,0,0
25,2,279,0,0,0
25,2,317,1,0,1
25,2,1046,1,0,1
25,2,818,0,0,0
25,2,378,0,0,0
25,2,329,0,0,0
25,2,420,3,2,1
25,2,322,2,0,2
25,2,416,3,1,2
25,2,301,1,1,0
25,2,150,0,0,0
25,2,213,0,0,0
25,2,134,1,1,0
25,2,199,0,0,0
25,2,489,1,1,0
25,2,1597,5,3,2
25,2,1251,7,3,4
25,2,521,2,1,1
25,2,947,0,0,0
25,2,283,1,0,1
25,2,416,1,0,1
25,2,362,6,5,1
25,2,279,2,0,2
25,2,399,26,11,15
25,2,218,0,0,0
25,2,840,6,3,3
25,2,325,7,2,5
25,2,306,9,3,6
25,2,200,0,0,0
25,2,233,0,0,0
25,2,378,1,1,0
25,2,404,2,1,1
25,2,296,0,0,0
25,2,360,0,0,0
25,2,381,0,0,0
25,2,218,0,0,0
25,2,260,0,0,0
25,2,219,0,0,0
25,2,713,1,1,0
25,3,563,2,1,1
25,3,1153,16,10,6
25,3,929,1,1,0
25,3,796,1,0,1
25,3,180,1,0,1
25,3,1657,7,2,5
25,3,785,0,0,0
25,3,975,3,2,1
25,3,543,11,4,7
25,3,1529,2,1,1
25,3,717,0,0,0
25,3,1603,2,1,1
25,3,1375,13,5,8
25,3,403,110,52,58
25,3,866,44,23,21
25,3,392,1,1,0
25,3,1041,84,41,43
25,3,391,0,0,0
25,3,423,1,0,1
25,3,360,0,0,0
25,3,147,0,0,0
25,3,328,1,0,1
25,3,721,0,0,0
25,3,152,1,0,1
25,3,522,0,0,0
25,3,193,0,0,0
25,3,209,0,0,0
25,3,364,3,0,3
25,3,311,1,1,0
25,3,126,0,0,0
25,3,327,1,1,0
25,3,224,0,0,0
25,3,224,1,1,0
25,3,166,0,0,0
25,3,80,1,0,1
25,3,3,0,0,0
25,3,203,1,0,1
25,3,478,2,0,2
25,3,331,1,1,0
25,3,243,0,0,0
25,3,127,1,0,1
25,3,47,1,0,1
25,3,151,6,2,4
25,3,146,3,1,2
25,3,222,0,0,0
25,3,251,3,1,2
25,3,252,1,1,0
25,3,112,0,0,0
25,3,33,0,0,0
25,3,141,0,0,0
25,3,381,0,0,0
25,3,98,1,0,1
25,3,556,1,1,0
25,3,311,1,0,1
25,3,435,2,0,2
25,3,64,0,0,0
25,3,96,0,0,0
25,3,11,0,0,0
25,3,434,0,0,0
25,3,366,2,1,1
25,3,45,1,0,1
25,4,740,0,0,0
25,4,252,3,2,1
25,4,1711,3,2,1
25,4,515,0,0,0
25,4,442,1,1,0
25,4,311,0,0,0
25,4,1018,150,77,73
25,4,1359,175,105,70
25,4,2401,301,159,142
25,4,392,1,0,1
25,4,339,10,5,5
25,4,2,-6,-6,-6
25,4,689,5,0,5
25,4,522,1,1,0
25,4,354,0,0,0
25,4,155,0,0,0
25,4,149,0,0,0
25,4,292,0,0,0
25,4,0,0,0,0
25,4,136,0,0,0
25,4,404,1,1,0
25,4,154,0,0,0
25,4,550,0,0,0
25,4,598,1,0,1
25,4,431,0,0,0
25,4,776,14,7,7
25,4,478,0,0,0
25,4,138,0,0,0
25,4,441,1,0,1
25,4,369,1,1,0
25,4,335,0,0,0
25,4,419,6,2,4
25,4,182,0,0,0
25,4,608,0,0,0
25,4,204,0,0,0
25,4,1701,11,6,5
25,4,1340,0,0,0
25,4,190,0,0,0
25,4,383,0,0,0
25,4,407,0,0,0
25,4,170,6,3,3
25,4,908,4,2,2
25,4,627,2,1,1
25,4,635,0,0,0
25,4,502,0,0,0
25,4,120,0,0,0
25,5,1114,32,23,9
25,5,721,27,11,16
25,5,617,18,8,10
25,5,1811,16,8,8
25,5,868,5,3,2
25,5,632,9,5,4
25,5,333,0,0,0
25,5,2351,22,11,11
25,5,142,0,0,0
25,5,461,6,3,3
25,5,423,0,0,0
25,5,243,1,1,0
25,5,169,0,0,0
25,5,334,0,0,0
25,5,469,0,0,0
25,5,281,0,0,0
25,5,912,1,0,1
25,5,243,0,0,0
25,5,110,0,0,0
25,5,146,1,1,0
25,5,487,0,0,0
25,5,483,2,2,0
25,5,493,1,1,0
25,5,431,2,1,1
25,5,194,0,0,0
25,5,536,2,0,2
25,5,298,1,0,1
25,5,228,0,0,0
25,5,289,0,0,0
25,5,195,1,1,0
25,5,175,0,0,0
25,5,467,1,1,0
25,6,1318,124,77,47
25,6,1332,118,58,60
25,6,970,33,21,12
25,6,1539,33,18,15
25,6,1709,724,386,338
25,6,3761,1193,604,589
25,6,1986,21,14,7
25,6,1615,38,20,18
25,6,630,13,7,6
25,6,692,25,15,10
25,6,377,53,31,22
25,6,446,21,13,8
25,6,413,39,21,18
25,6,515,5,2,3
25,6,332,20,10,10
25,6,4137,106,59,47
25,6,1825,480,262,218
25,6,347,19,9,10
25,6,353,0,0,0
25,6,382,20,13,7
25,6,2159,46,30,16
25,6,387,2,1,1
25,6,303,0,0,0
25,6,687,0,0,0
25,6,1825,1,1,0
25,6,612,0,0,0
25,6,968,25,12,13
25,6,584,0,0,0
25,6,413,4,2,2
25,6,480,7,4,3
25,6,522,6,3,3
25,6,737,2,1,1
25,6,463,5,3,2
25,6,520,5,3,2
25,6,955,3,2,1
25,6,374,0,0,0
25,6,424,2,0,2
25,6,314,2,1,1
25,6,441,9,6,3
25,6,390,7,4,3
25,6,458,3,2,1
25,6,295,15,9,6
25,6,316,2,0,2
25,6,464,0,0,0
25,6,386,0,0,0
25,6,586,1,0,1
25,6,253,3,0,3
25,6,310,0,0,0
25,6,351,10,6,4
25,6,271,2,1,1
25,6,385,5,3,2
25,6,719,3,1,2
25,6,231,2,1,1
25,6,316,0,0,0
25,6,390,2,1,1
25,6,495,2,1,1
25,6,220,1,1,0
25,6,453,1,1,0
25,6,178,1,1,0
25,6,178,0,0,0
25,6,465,4,3,1
25,6,301,33,18,15
25,6,357,10,6,4
25,6,360,0,0,0
25,6,2949,30,13,17
25,6,451,0,0,0
25,6,561,0,0,0
25,6,543,6,2,4
25,6,208,7,4,3
25,6,263,0,0,0
25,6,315,12,6,6
25,6,484,15,7,8
25,6,244,8,3,5
25,6,146,0,0,0
25,6,363,7,4,3
25,6,266,0,0,0
25,6,382,1,0,1
25,6,228,0,0,0
25,6,403,0,0,0
25,6,366,1,0,1
25,6,253,0,0,0
25,6,425,1,0,1
25,6,521,7,4,3
25,6,458,13,10,3
25,6,872,26,13,13
25,6,527,1,0,1
25,6,775,7,4,3
25,6,1564,5,3,2
25,6,461,6,5,1
25,6,543,9,6,3
25,6,274,2,1,1
25,6,656,85,50,35
25,6,352,2,1,1
25,6,240,1,0,1
25,6,214,0,0,0
25,6,408,5,3,2
25,6,427,1,0,1
25,6,189,0,0,0
25,6,156,1,1,0
25,6,242,50,29,21
25,6,93,1,1,0
25,6,111,4,1,3
25,6,227,5,2,3
25,6,161,0,0,0
25,6,107,0,0,0
25,6,68,0,0,0
25,6,233,1,0,1
25,6,248,5,4,1
25,6,319,1,1,0
25,6,366,11,7,4
25,6,264,3,3,0
25,6,352,1,1,0
25,6,550,0,0,0
25,6,534,1,1,0
25,6,448,3,2,1
25,6,566,0,0,0
25,6,640,2,1,1
25,6,445,0,0,0
25,6,469,2,0,2
25,6,787,0,0,0
25,6,393,3,3,0
25,6,582,34,18,16
25,6,412,7,3,4
25,6,344,0,0,0
25,6,539,1,0,1
25,6,430,0,0,0
25,6,310,0,0,0
25,6,235,4,2,2
25,6,284,0,0,0
25,6,584,1,0,1
25,6,348,3,2,1
25,6,358,3,2,1
25,6,353,0,0,0
25,6,339,1,1,0
25,6,414,2,1,1
25,6,452,2,0,2
25,6,339,1,0,1
25,6,405,1,0,1
25,6,249,0,0,0
25,6,419,3,1,2
25,6,349,0,0,0
25,6,138,0,0,0
25,6,177,1,0,1
25,6,102,0,0,0
25,6,150,0,0,0
25,6,139,1,1,0
25,6,170,0,0,0
25,6,268,3,0,3
25,6,409,1,0,1
25,6,184,0,0,0
25,6,234,2,2,0
25,6,281,0,0,0
25,6,207,1,0,1
25,6,391,5,4,1
25,6,279,1,1,0
25,6,141,0,0,0
25,6,165,0,0,0
25,6,132,3,1,2
25,6,137,1,0,1
25,6,131,0,0,0
25,6,324,2,1,1
25,6,449,2,1,1
25,6,264,3,1,2
25,6,286,4,1,3
25,6,65,0,0,0
25,6,239,2,2,0
25,6,224,2,1,1
25,6,149,6,3,3
25,6,358,3,2,1
25,6,399,5,1,4
25,6,114,0,0,0
25,6,242,0,0,0
25,6,495,1,1,0
25,6,4778,41,24,17
25,6,1121,3,2,1
25,6,22630,105,46,59
25,6,5783,25,14,11
25,6,7995,62,30,32
25,6,526,3,2,1
25,6,674,3,3,0
25,6,384,1,0,1
25,6,537,2,1,1
25,6,443,3,2,1
25,6,730,0,0,0
25,6,445,7,2,5
25,6,1311,8,3,5
25,6,979,10,6,4
25,6,1127,6,4,2
25,6,1575,4,3,1
25,6,491,1,0,1
25,6,352,0,0,0
25,6,425,4,2,2
25,6,311,0,0,0
25,6,1008,4,2,2
25,6,303,3,1,2
25,6,177,2,2,0
25,6,434,0,0,0
25,6,314,3,1,2
25,6,196,0,0,0
25,6,369,10,7,3
25,6,2048,15,6,9
25,6,900,1,0,1
25,6,687,2,1,1
25,6,733,0,0,0
25,6,1784,10,6,4
25,6,962,1,1,0
25,6,789,0,0,0
25,6,375,0,0,0
25,6,480,0,0,0
25,6,419,0,0,0
25,6,472,0,0,0
25,6,264,2,1,1
25,6,278,3,2,1
25,6,263,5,4,1
25,6,242,2,1,1
25,6,316,0,0,0
25,6,192,6,3,3
25,6,420,1,0,1
25,6,426,6,3,3
25,6,508,2,2,0
25,6,6911,118,64,54
25,6,5401,27,14,13
25,6,600,2,1,1
25,6,722,3,1,2
25,6,319,0,0,0
25,6,258,1,1,0
25,6,398,0,0,0
25,6,371,1,1,0
25,6,126,0,0,0
25,6,180,7,4,3
25,6,63,0,0,0
25,6,149,0,0,0
25,6,121,2,2,0
25,6,145,0,0,0
25,6,253,6,2,4
25,6,277,4,2,2
25,6,197,3,2,1
25,6,1022,9,4,5
25,6,3640,38,12,26
25,6,160,0,0,0
25,6,222,1,1,0
25,6,108,5,2,3
25,6,120,0,0,0
25,6,112,0,0,0
25,6,101,0,0,0
25,6,164,4,2,2
25,6,165,0,0,0
25,6,142,2,1,1
25,6,110,0,0,0
25,6,66,1,0,1
25,6,228,2,1,1
25,6,131,0,0,0
25,6,189,0,0,0
25,6,83,0,0,0
25,6,85,1,1,0
25,6,118,3,0,3
25,6,188,8,3,5
25,6,216,1,1,0
25,6,111,2,2,0
25,6,131,0,0,0
25,6,182,2,0,2
25,6,176,0,0,0
25,6,242,1,0,1
25,6,189,0,0,0
25,6,164,0,0,0
25,6,197,2,0,2
25,6,154,0,0,0
25,6,348,1,0,1
25,6,233,1,1,0
25,6,253,3,1,2
25,6,161,0,0,0
25,6,255,1,1,0
25,6,274,1,1,0
25,6,312,1,0,1
25,6,3858,30,12,18
25,6,716,1,0,1
25,6,3256,38,2,36
25,6,600,0,0,0
25,6,6542,146,82,64
25,6,1361,6,4,2
25,6,198,0,0,0
25,6,9860,49,20,29
25,6,16278,796,396,400
25,6,686,4,2,2
25,6,729,2,0,2
25,6,1095,10,5,5
25,6,867,5,1,4
25,6,1167,0,0,0
25,6,2449,10,7,3
25,6,3287,7,4,3
25,6,838,5,2,3
25,6,460,1,1,0
25,6,576,7,3,4
25,6,483,1,0,1
25,6,549,6,2,4
25,6,323,0,0,0
25,6,210,0,0,0
25,6,216,0,0,0
25,6,229,0,0,0
25,6,357,0,0,0
25,6,112,0,0,0
25,6,316,0,0,0
25,6,221,0,0,0
25,6,153,1,0,1
25,6,279,1,0,1
25,6,210,0,0,0
25,6,277,36,17,19
25,6,332,2,1,1
25,6,241,0,0,0
25,6,188,1,1,0
25,6,208,8,5,3
25,6,158,1,1,0
25,6,488,4,4,0
25,6,235,0,0,0
25,6,309,1,0,1
25,6,259,0,0,0
25,6,330,1,0,1
25,6,299,2,0,2
25,6,216,1,1,0
25,6,354,1,1,0
25,6,298,6,3,3
25,6,343,0,0,0
25,6,288,0,0,0
25,6,376,2,0,2
25,6,432,0,0,0
25,6,474,0,0,0
25,6,154,0,0,0
25,6,362,37,16,21
25,6,380,3,2,1
25,6,216,3,2,1
25,6,253,2,2,0
25,6,467,0,0,0
25,6,283,0,0,0
25,6,302,0,0,0
25,6,291,11,5,6
25,6,289,0,0,0
25,6,239,1,1,0
25,6,288,1,1,0
25,6,219,0,0,0
25,6,291,1,1,0
25,6,519,3,1,2
25,6,324,0,0,0
25,6,272,0,0,0
25,6,258,0,0,0
25,6,370,1,1,0
25,6,241,4,2,2
25,6,330,2,2,0
25,6,227,2,0,2
25,6,316,2,1,1
25,6,278,2,2,0
25,6,232,0,0,0
25,6,277,1,0,1
25,6,275,0,0,0
25,6,313,0,0,0
25,6,329,0,0,0
25,6,504,1,0,1
25,6,255,2,2,0
25,6,361,6,4,2
25,6,667,2,1,1
25,6,265,0,0,0
25,6,619,5,3,2
25,6,430,2,1,1
25,6,263,0,0,0
25,6,462,4,2,2
25,6,278,0,0,0
25,6,295,0,0,0
25,6,257,0,0,0
25,6,406,0,0,0
25,6,700,1,0,1
25,6,1907,17,9,8
25,6,1141,9,7,2
25,6,1810,10,4,6
25,6,932,2,1,1
25,6,976,9,5,4
25,6,421,0,0,0
25,6,585,5,3,2
25,6,555,2,0,2
25,6,465,1,1,0
25,6,452,0,0,0
25,6,300,0,0,0
25,6,448,2,1,1
25,6,317,1,1,0
25,6,271,2,0,2
25,6,479,2,0,2
25,6,289,3,2,1
25,6,424,1,1,0
25,6,252,1,0,1
25,6,294,0,0,0
25,6,409,0,0,0
25,6,326,0,0,0
25,6,329,2,0,2
25,6,239,0,0,0
25,6,283,2,0,2
25,6,380,3,3,0
25,6,433,1,0,1
25,6,246,0,0,0
25,6,456,8,6,2
25,6,332,1,0,1
25,6,397,1,0,1
25,6,430,3,0,3
25,6,414,9,3,6
25,6,3860,26,11,15
25,6,429,0,0,0
25,6,472,3,1,2
25,6,229,0,0,0
25,6,404,2,1,1
25,6,204,5,2,3
25,6,263,0,0,0
25,6,466,5,3,2
25,6,251,0,0,0
25,6,422,0,0,0
25,6,516,2,1,1
25,6,465,0,0,0
25,6,354,34,15,19
25,6,2421,67,31,36
25,6,367,3,2,1
25,6,423,5,4,1
25,6,322,5,3,2
25,6,339,0,0,0
25,6,321,2,1,1
25,6,429,1,1,0
25,6,293,1,0,1
25,6,299,6,2,4
25,6,368,0,0,0
25,6,434,4,3,1
25,6,444,0,0,0
25,6,357,1,1,0
25,6,600,23,11,12
25,6,706,4,2,2
25,6,542,2,1,1
25,6,470,5,1,4
25,6,851,2,1,1
25,6,2631,6,1,5
25,6,19192,129,59,70
25,6,2167,263,143,120
25,6,842,6,3,3
25,6,585,100,51,49
25,6,644,65,32,33
25,6,3833,54,33,21
25,6,422,0,0,0
25,6,381,0,0,0
25,6,389,0,0,0
25,6,415,0,0,0
25,6,325,0,0,0
25,6,491,0,0,0
25,6,442,0,0,0
25,6,527,0,0,0
25,6,483,3,3,0
25,6,524,2,0,2
25,6,419,5,3,2
25,6,328,1,0,1
25,6,2394,23,9,14
25,6,1471,8,4,4
25,6,701,6,3,3
25,6,675,0,0,0
25,6,374,0,0,0
25,6,438,2,1,1
25,6,523,0,0,0
25,6,399,1,1,0
25,6,318,0,0,0
25,6,5029,75,40,35
25,6,582,7,4,3
25,6,417,13,7,6
25,6,8627,92,45,47
25,6,2832,16,7,9
25,6,310,4,2,2
25,6,547,4,2,2
25,6,4642,3,3,0
25,6,18527,241,121,120
25,6,542,0,0,0
25,6,4030,9,4,5
25,6,3225,34,14,20
25,6,694,1,1,0
25,6,2458,15,9,6
25,6,2064,9,3,6
25,6,2667,7,4,3
25,6,2273,1,1,0
25,6,610,2,0,2
25,6,1926,5,1,4
25,6,518,0,0,0
25,6,1759,9,6,3
25,6,2714,19,6,13
25,6,1909,20,10,10
25,6,9850,43,21,22
25,6,642,73,43,30
25,6,572,16,7,9
25,6,4147,40,16,24
25,6,13840,79,37,42
25,6,4535,18,8,10
25,6,1005,2,0,2
25,6,344,0,0,0
25,6,329,1,0,1
25,6,27405,249,123,126
25,6,469,2,0,2
25,6,483,9,4,5
25,6,345,7,4,3
25,6,2156,23,18,5
25,6,588,6,3,3
25,6,659,3,2,1
25,6,2106,95,51,44
25,6,12292,167,78,89
25,6,2407,9,5,4
25,6,1788,109,55,54
25,6,111,0,0,0
25,6,907,5,3,2
25,6,405,3,1,2
25,6,563,2,0,2
25,6,198,2,1,1
25,6,465,1,1,0
25,6,385,0,0,0
25,6,338,2,2,0
25,6,129,0,0,0
25,6,260,4,0,4
25,6,371,1,1,0
25,6,251,0,0,0
25,6,387,12,4,8
25,6,115,1,1,0
25,6,654,24,14,10
25,6,442,4,1,3
25,6,234,0,0,0
25,6,287,0,0,0
25,6,731,4,1,3
25,6,323,1,1,0
25,6,775,1,0,1
25,6,485,2,0,2
25,6,280,2,0,2
25,6,2019,9,2,7
25,6,1072,12,4,8
25,6,549,35,20,15
25,6,1025,1,1,0
25,6,808,1,1,0
25,6,314,0,0,0
25,6,383,0,0,0
25,6,238,0,0,0
25,6,816,1,0,1
25,6,301,0,0,0
25,6,1771,2,0,2
25,6,1194,4,2,2
25,6,284,4,2,2
25,6,547,1,0,1
25,6,244,1,0,1
25,6,1002,7,2,5
25,6,5539,93,53,40
25,6,3457,844,405,439
25,6,1106,4,1,3
25,6,778,0,0,0
25,6,897,7,1,6
25,6,643,0,0,0
25,6,1075,1,0,1
25,6,432,1,1,0
25,6,275,0,0,0
25,6,1439,2,2,0
25,6,1248,171,83,88
25,6,1045,15,8,7
25,6,798,2,1,1
25,6,908,11,4,7
25,6,382,0,0,0
25,6,16688,137,68,69
25,6,1373,0,0,0
25,6,1431,12,8,4
25,6,778,20,10,10
25,6,28831,212,90,122
25,6,394,1,0,1
25,6,1826,7,4,3
25,6,1884,11,10,1
25,6,431,1,0,1
25,6,497,3,1,2
25,6,447,0,0,0
25,6,383,3,2,1
25,6,1211,20,10,10
25,6,1736,20,12,8
25,6,563,4,2,2
25,6,306,1,1,0
25,6,702,0,0,0
25,6,387,2,2,0
25,6,1078,23,14,9
25,6,808,0,0,0
25,6,515,16,7,9
25,6,508,2,2,0
25,6,349,0,0,0
25,6,462,0,0,0
25,6,232,0,0,0
25,6,484,2,1,1
25,6,324,5,1,4
25,6,357,0,0,0
25,6,438,4,4,0
25,6,435,4,2,2
25,6,673,1,0,1
25,6,656,8,3,5
25,6,836,0,0,0
25,6,181,0,0,0
25,6,394,0,0,0
25,6,18164,124,69,55
25,6,1708,166,89,77
25,6,477,14,5,9
25,6,709,0,0,0
25,6,430,5,3,2
25,6,391,4,3,1
25,6,505,3,1,2
25,6,520,1,0,1
25,6,424,4,3,1
25,6,254,1,0,1
25,6,277,2,0,2
25,6,367,2,2,0
25,6,1013,16,7,9
25,6,790,1,1,0
25,6,7149,200,111,89
25,6,861,49,33,16
25,6,415,0,0,0
25,6,410,6,2,4
25,6,393,1,0,1
25,6,484,0,0,0
25,6,257,0,0,0
25,6,248,0,0,0
25,6,654,15,8,7
25,6,516,7,4,3
25,6,709,0,0,0
25,6,486,2,0,2
25,6,416,0,0,0
25,6,587,0,0,0
25,6,307,0,0,0
25,6,587,0,0,0
25,6,905,7,4,3
25,6,562,1,1,0
25,6,649,0,0,0
25,6,379,0,0,0
25,6,395,1,1,0
25,6,593,8,4,4
25,6,365,9,5,4
25,6,293,0,0,0
25,6,305,25,12,13
25,6,774,9,5,4
25,6,480,2,1,1
25,6,426,0,0,0
25,6,476,0,0,0
25,6,549,0,0,0
25,6,1074,3,2,1
25,6,1282,1,0,1
25,6,1528,6,5,1
25,6,1271,13,9,4
25,6,941,4,3,1
25,6,640,10,5,5
25,6,426,4,3,1
25,6,452,3,2,1
25,6,362,0,0,0
25,6,405,0,0,0
25,6,364,3,1,2
25,6,227,1,1,0
25,6,300,0,0,0
25,6,528,5,2,3
25,6,340,2,2,0
25,6,349,0,0,0
25,6,668,0,0,0
25,6,440,4,3,1
25,6,410,1,0,1
25,6,333,2,2,0
25,6,365,0,0,0
25,6,912,15,3,12
25,6,10231,193,94,99
25,6,528,3,3,0
25,6,527,0,0,0
25,6,461,1,0,1
25,6,237,0,0,0
25,6,319,0,0,0
25,6,386,2,1,1
25,6,440,2,1,1
25,6,286,0,0,0
25,6,325,2,1,1
25,6,395,4,3,1
25,6,307,0,0,0
25,6,372,1,0,1
25,6,483,0,0,0
25,6,539,0,0,0
25,6,753,1,0,1
25,6,576,10,4,6
25,6,2017,5,3,2
25,6,544,2,0,2
25,6,562,4,2,2
25,6,360,5,3,2
25,6,379,2,0,2
25,6,396,6,2,4
25,6,214,0,0,0
25,6,247,1,1,0
25,6,252,4,4,0
25,6,497,1,1,0
25,6,432,4,2,2
25,6,530,4,4,0
25,6,376,5,3,2
25,6,463,1,1,0
25,6,573,11,6,5
25,6,877,3,0,3
25,6,799,8,5,3
25,6,2130,11,7,4
25,6,1538,4,2,2
25,6,844,12,9,3
25,6,381,2,0,2
25,6,389,1,0,1
25,6,525,13,8,5
25,6,428,0,0,0
25,6,339,2,0,2
25,6,683,3,0,3
25,6,800,1,0,1
25,6,863,4,2,2
25,6,392,1,0,1
25,6,385,3,2,1
25,6,283,2,1,1
25,6,2710,2,0,2
25,6,2510,8,5,3
25,6,596,6,1,5
25,6,301,5,4,1
25,6,409,0,0,0
25,6,830,1,0,1
25,6,834,11,5,6
25,6,889,2,2,0
25,6,714,6,3,3
25,6,692,19,8,11
25,6,768,1,0,1
25,6,701,16,9,7
25,6,283,9,5,4
25,6,370,19,14,5
25,6,537,0,0,0
25,6,1018,5,2,3
25,6,348,2,2,0
25,6,543,2,1,1
25,6,535,2,1,1
25,6,490,1,1,0
25,6,572,9,4,5
25,6,572,0,0,0
25,6,557,35,19,16
25,6,559,2,2,0
25,6,3412,23,15,8
25,6,543,17,8,9
25,6,461,0,0,0
25,6,563,7,5,2
25,6,515,5,2,3
25,6,516,7,4,3
25,6,534,10,4,6
25,6,631,8,5,3
25,6,553,1,0,1
25,6,616,68,32,36
25,6,613,89,51,38
25,6,560,2,0,2
25,6,1220,1,0,1
25,6,1479,24,10,14
25,6,593,3,2,1
25,6,666,145,71,74
25,6,584,1,0,1
25,6,889,2,1,1
25,6,1052,3,2,1
25,6,1233,15,7,8
25,6,2152,26,9,17
25,6,897,20,11,9
25,6,628,10,5,5
25,6,1826,47,23,24
25,6,3362,10,2,8
25,6,631,1,1,0
25,6,843,6,3,3
25,6,991,27,15,12
25,6,23056,200,99,101
25,6,10552,583,312,271
25,6,930,9,5,4
25,6,699,15,9,6
25,6,1411,5,3,2
25,6,19358,239,126,113
25,6,837,38,19,19
25,6,2630,25,11,14
25,6,723,14,8,6
25,6,855,4,0,4
25,6,192,0,0,0
25,6,292,0,0,0
25,6,183,0,0,0
25,6,224,1,0,1
25,6,168,0,0,0
25,6,291,1,0,1
25,6,303,0,0,0
25,6,419,2,1,1
25,6,433,1,0,1
25,6,446,0,0,0
25,6,385,0,0,0
25,6,522,0,0,0
25,6,153,0,0,0
25,6,1220,4,3,1
25,6,295,2,0,2
25,6,542,0,0,0
25,6,745,0,0,0
25,6,236,2,1,1
25,6,320,0,0,0
25,6,629,0,0,0
25,6,1219,1,0,1
25,6,2168,11,5,6
25,6,2553,3,1,2
25,6,960,4,0,4
25,6,2604,3,1,2
25,6,6060,45,17,28
25,6,218,0,0,0
25,6,259,0,0,0
25,6,124,0,0,0
25,6,435,0,0,0
25,6,104,0,0,0
25,6,233,0,0,0
25,6,195,1,0,1
25,6,220,0,0,0
25,6,2206,4,1,3
25,6,298,0,0,0
25,6,134,0,0,0
25,6,149,0,0,0
25,6,242,0,0,0
25,6,195,1,0,1
25,6,276,0,0,0
25,6,164,0,0,0
25,6,742,0,0,0
25,6,540,2,0,2
25,6,1436,16,11,5
25,6,1232,5,2,3
25,6,770,0,0,0
25,6,778,1,0,1
25,6,119,0,0,0
25,6,797,7,1,6
25,6,782,2,0,2
25,6,219,2,1,1
25,6,827,2,2,0
25,6,674,3,1,2
25,6,619,8,4,4
25,6,278,6,5,1
25,6,171,0,0,0
25,6,342,0,0,0
25,6,638,1,1,0
25,6,388,15,6,9
25,6,332,3,3,0
25,6,402,4,2,2
25,6,571,0,0,0
25,6,533,0,0,0
25,6,443,1,0,1
25,6,791,19,14,5
25,6,1191,14,7,7
25,6,3902,106,55,51
25,6,702,17,6,11
25,6,400,18,10,8
25,6,359,0,0,0
25,6,295,0,0,0
25,6,1002,1,0,1
25,6,1916,7,2,5
25,6,248,0,0,0
25,6,178,1,0,1
25,6,301,0,0,0
25,6,200,0,0,0
25,6,447,2,1,1
25,6,253,3,3,0
25,6,581,2,2,0
25,6,230,0,0,0
25,6,95,0,0,0
25,6,151,5,4,1
25,6,1255,18,9,9
25,6,347,1,1,0
25,6,925,1,1,0
25,6,450,2,1,1
25,6,357,2,1,1
25,6,473,4,2,2
25,6,871,2,1,1
25,6,1056,48,26,22
25,6,4963,75,34,41
25,6,1774,4,2,2
25,6,628,3,2,1
25,6,370,0,0,0
25,6,588,0,0,0
25,6,215,0,0,0
25,6,612,0,0,0
25,6,3126,8,2,6
25,6,671,93,45,48
25,6,1519,4,1,3
25,6,588,1,1,0
25,6,372,1,0,1
25,6,156,0,0,0
25,6,132,0,0,0
25,6,1059,13,5,8
25,6,918,37,20,17
25,6,1032,18,5,13
25,6,291,0,0,0
25,6,166,1,1,0
25,6,889,6,2,4
25,6,470,0,0,0
25,6,567,40,19,21
25,6,739,24,13,11
25,6,860,24,13,11
25,6,368,0,0,0
25,6,371,0,0,0
25,6,280,0,0,0
25,6,539,0,0,0
25,6,540,0,0,0
25,6,332,1,1,0
25,6,928,0,0,0
25,6,646,0,0,0
25,6,871,8,4,4
25,6,1467,8,3,5
25,6,386,17,10,7
25,6,888,2,1,1
25,6,641,1,0,1
25,6,1882,1,1,0
25,6,597,1,1,0
25,6,880,30,19,11
25,6,324,1,1,0
25,6,598,1,1,0
25,6,497,0,0,0
25,6,498,13,11,2
25,6,476,23,15,8
25,6,1085,1,0,1
25,6,900,200,107,93
25,6,345,120,57,63
25,6,183,0,0,0
25,6,1207,6,4,2
25,6,1094,320,160,160
25,6,952,105,55,50
25,6,964,12,6,6
25,6,545,2,1,1
25,6,1013,8,6,2
25,6,295,0,0,0
25,6,752,2,0,2
25,6,888,84,36,48
25,6,741,22,14,8
25,6,515,3,3,0
25,6,344,263,129,134
25,6,776,282,144,138
25,6,1171,122,64,58
25,6,194,0,0,0
25,6,508,2,0,2
25,6,473,0,0,0
25,6,635,0,0,0
25,6,318,2,2,0
25,6,1124,37,18,19
25,6,580,0,0,0
25,6,1260,3,2,1
25,6,361,0,0,0
25,6,521,1,1,0
25,6,712,1,0,1
25,6,773,621,306,315
25,6,451,284,144,140
25,6,315,0,0,0
25,6,1124,3,0,3
25,6,1043,0,0,0
25,6,1064,0,0,0
25,6,26,0,0,0
25,6,447,3,1,2
25,6,776,4,2,2
25,6,722,0,0,0
25,6,624,2,0,2
25,6,819,2,2,0
25,6,207,1,1,0
25,6,1297,4,3,1
25,6,1034,1,0,1
25,6,449,2,0,2
25,6,685,4,1,3
25,6,565,0,0,0
25,6,1284,0,0,0
25,6,502,1,1,0
25,6,284,1,1,0
25,6,1377,2,2,0
25,6,715,0,0,0
25,6,265,0,0,0
25,6,252,4,3,1
25,6,654,9,6,3
25,6,356,7,3,4
25,6,287,2,2,0
25,6,318,0,0,0
25,6,616,1,0,1
25,6,1608,2,1,1
25,6,833,3,3,0
25,6,388,6,3,3
25,6,634,5,2,3
25,6,353,10,4,6
25,6,905,15,6,9
25,6,183,2,2,0
25,6,758,6,3,3
25,6,736,5,1,4
25,6,1199,11,3,8
25,6,676,2,0,2
25,6,413,0,0,0
25,6,586,1,0,1
25,6,669,1,1,0
25,6,387,1,1,0
25,6,1096,7,2,5
25,6,1432,3,2,1
25,6,488,0,0,0
25,6,593,1,0,1
25,6,1157,9,3,6
25,6,851,1,0,1
25,6,810,38,23,15
25,6,848,2,1,1
25,6,442,3,2,1
25,6,1119,0,0,0
25,6,610,2,1,1
25,6,1629,4,1,3
25,6,233,0,0,0
25,6,261,0,0,0
25,6,1221,2,2,0
25,6,677,0,0,0
25,6,1571,2,1,1
25,6,192,0,0,0
25,6,144,0,0,0
25,6,818,0,0,0
25,6,958,5,3,2
25,7,2388,126,65,61
25,7,1379,213,111,102
25,7,701,79,44,35
25,7,906,34,23,11
25,7,917,145,71,74
25,7,555,64,32,32
25,7,152,46,24,22
25,7,2335,222,113,109
25,7,605,76,42,34
25,7,1412,5,4,1
25,7,167,0,0,0
25,7,28,0,0,0
25,7,200,0,0,0
25,7,224,1,1,0
25,7,239,0,0,0
25,7,213,0,0,0
25,7,300,1,0,1
25,7,572,3,2,1
25,7,518,8,3,5
25,7,122,100,38,62
25,7,211,0,0,0
25,7,414,0,0,0
25,7,199,0,0,0
25,7,58,0,0,0
25,7,175,0,0,0
25,7,347,2,1,1
25,7,612,3,2,1
25,7,368,0,0,0
25,7,70,23,9,14
25,7,298,56,28,28
25,7,145,8,4,4
25,7,265,19,8,11
25,7,174,115,54,61
25,7,233,0,0,0
25,7,248,0,0,0
25,7,166,1,1,0
25,7,296,1,0,1
25,7,194,0,0,0
25,7,198,0,0,0
25,7,709,0,0,0
25,7,373,4,1,3
25,7,468,395,200,195
25,7,322,275,123,152
25,7,328,6,2,4
25,7,285,1,1,0
25,7,420,0,0,0
25,7,197,0,0,0
25,7,255,2,1,1
25,7,546,0,0,0
25,7,334,1,1,0
25,7,241,0,0,0
25,7,150,0,0,0
25,7,467,8,4,4
25,7,271,0,0,0
25,7,816,0,0,0
25,7,255,0,0,0
25,7,311,2,1,1
25,7,700,0,0,0
25,7,441,1,1,0
25,7,82,0,0,0
25,7,351,0,0,0
25,7,224,0,0,0
25,7,387,1,1,0
25,7,426,0,0,0
25,7,150,0,0,0
25,7,100,0,0,0
25,7,302,1,0,1
25,7,544,0,0,0
25,7,267,0,0,0
25,8,2290,1,1,0
25,8,3144,19,11,8
25,8,524,3,2,1
25,8,3151,15,8,7
25,8,185,3,2,1
25,8,1684,2,2,0
25,8,691,2,1,1
25,8,681,10,4,6
25,8,404,6,3,3
25,8,188,11,7,4
25,8,301,8,3,5
25,8,329,0,0,0
25,8,2493,25,17,8
25,8,1844,10,6,4
25,8,1369,1,1,0
25,8,814,4,0,4
25,8,138,0,0,0
25,8,189,0,0,0
25,8,281,0,0,0
25,8,307,0,0,0
25,8,343,0,0,0
25,8,137,0,0,0
25,8,725,0,0,0
25,8,366,0,0,0
25,8,525,0,0,0
25,8,654,0,0,0
25,8,217,0,0,0
25,8,335,0,0,0
25,8,254,2,1,1
25,8,277,0,0,0
25,8,343,7,5,2
25,8,422,0,0,0
25,8,51,0,0,0
25,8,381,0,0,0
25,8,840,2,2,0
25,8,1070,10,3,7
25,8,495,0,0,0
25,8,1424,6,2,4
25,8,811,5,2,3
25,8,2852,12,3,9
25,8,641,0,0,0
25,8,590,0,0,0
25,8,605,0,0,0
25,8,1027,2,1,1
25,8,1062,2,0,2
25,8,1535,18,6,12
25,8,593,0,0,0
25,8,703,1,0,1
25,8,211,0,0,0
25,8,840,8,5,3
25,8,1016,6,2,4
25,8,2241,4,1,3
25,8,2561,35,13,22
25,8,1378,3,1,2
25,8,555,0,0,0
25,8,703,4,1,3
25,8,423,4,2,2
25,8,1087,3,3,0
25,8,4021,30,15,15
25,9,208,7,4,3
25,9,2201,49,28,21
25,9,855,0,0,0
25,9,1148,132,66,66
25,9,2647,47,18,29
25,9,1701,13,7,6
25,9,1044,45,21,24
25,9,1008,10,5,5
25,9,859,2,1,1
25,9,540,7,2,5
25,9,304,2,0,2
25,9,664,15,4,11
25,9,454,3,2,1
25,9,349,2,2,0
25,9,442,2,1,1
25,9,240,1,0,1
25,9,995,16,4,12
25,9,240,4,2,2
25,9,396,0,0,0
25,9,442,4,0,4
25,9,331,2,0,2
25,9,244,1,1,0
25,9,413,3,2,1
25,9,2485,28,15,13
25,9,3157,9,4,5
25,9,709,18,10,8
25,9,526,0,0,0
25,9,252,1,0,1
25,9,227,0,0,0
25,9,633,13,8,5
25,9,363,1,0,1
25,9,1350,5,2,3
25,9,683,4,3,1
25,9,744,9,5,4
25,9,2963,23,15,8
25,9,1936,41,23,18
25,9,443,1,1,0
25,9,410,3,2,1
25,9,467,1,0,1
25,9,1632,1,1,0
25,9,1422,113,58,55
25,9,3674,940,474,466
25,9,3070,224,103,121
25,9,389,1,0,1
25,9,1204,2,0,2
25,9,356,0,0,0
25,9,734,7,1,6
25,9,834,2,2,0
25,9,911,10,5,5
25,9,604,14,7,7
25,9,945,41,18,23
25,9,1993,3,1,2
25,9,521,12,7,5
25,9,960,11,4,7
25,9,899,3,2,1
25,9,793,6,4,2
25,9,988,4,3,1
25,9,454,5,3,2
25,9,331,1,0,1
25,9,459,0,0,0
25,9,589,2,0,2
25,9,377,0,0,0
25,9,482,3,2,1
25,10,691,1,0,1
25,10,264,2,2,0
25,10,328,3,2,1
25,10,276,1,0,1
25,10,559,0,0,0
25,10,1257,4,2,2
25,10,242,2,0,2
25,10,1285,8,4,4
25,10,756,1,0,1
25,10,806,3,0,3
25,10,278,3,2,1
25,10,226,3,0,3
25,10,410,3,2,1
25,10,1704,1,0,1
25,10,472,7,3,4
25,10,597,9,5,4
25,10,1734,4,2,2
25,10,1263,6,3,3
25,10,377,7,3,4
25,10,363,0,0,0
25,10,158,6,3,3
25,10,151,0,0,0
25,10,454,3,1,2
25,10,303,12,7,5
25,10,317,4,2,2
25,10,288,7,3,4
25,10,225,0,0,0
25,10,208,0,0,0
25,10,355,0,0,0
25,10,426,0,0,0
25,10,430,41,15,26
25,10,55,0,0,0
25,10,109,43,16,27
25,10,645,42,22,20
25,10,420,5,3,2
25,10,506,5,3,2
25,10,201,1,1,0
25,10,340,2,0,2
25,10,307,6,1,5
25,10,264,0,0,0
25,10,550,53,29,24
25,10,708,0,0,0
25,10,479,6,3,3
25,10,677,0,0,0
25,10,406,14,6,8
25,10,390,86,38,48
25,10,166,0,0,0
25,10,562,0,0,0
25,10,390,1,0,1
25,10,27,0,0,0
25,10,400,6,4,2
25,10,468,0,0,0
25,10,277,1,0,1
25,10,99,1,0,1
25,10,105,0,0,0
25,10,421,0,0,0
25,10,204,1,0,1
25,10,86,0,0,0
25,10,818,0,0,0
25,10,247,0,0,0
25,10,500,2,1,1
25,10,690,0,0,0
25,10,553,2,1,1
25,10,0,0,0,0
25,10,0,0,0,0
25,10,37,0,0,0
25,10,470,0,0,0
25,10,771,2,2,0
25,10,428,0,0,0
25,10,157,0,0,0
25,10,242,0,0,0
25,10,496,0,0,0
25,10,681,4,3,1
25,10,222,1,0,1
25,10,469,0,0,0
25,10,747,0,0,0
25,10,517,1,0,1
25,10,1092,0,0,0
25,10,348,1,0,1
25,10,522,4,2,2
25,10,699,0,0,0
25,10,584,1,0,1
25,10,642,4,2,2
25,10,441,1,0,1
25,10,627,0,0,0
25,10,470,1,0,1
25,10,175,1,0,1
25,10,480,0,0,0
25,10,147,0,0,0
25,10,849,1,1,0
25,10,372,0,0,0
25,10,401,0,0,0
25,10,305,0,0,0
25,10,376,0,0,0
25,10,460,0,0,0
25,10,259,0,0,0
25,10,240,0,0,0
25,10,428,0,0,0
25,10,452,0,0,0
25,10,382,1,1,0
25,10,222,0,0,0
25,10,483,0,0,0
25,10,657,2,0,2
25,10,352,0,0,0
25,10,1085,3,2,1
25,10,47,0,0,0
25,10,18,0,0,0
25,10,229,0,0,0
25,10,1111,0,0,0
25,10,286,0,0,0
25,10,410,1,0,1
25,10,230,0,0,0
25,10,675,0,0,0
25,10,796,0,0,0
25,10,472,0,0,0
25,10,892,0,0,0
25,10,702,6,3,3
25,10,960,8,3,5
25,10,486,6,4,2
25,10,1004,8,1,7
25,10,206,0,0,0
25,10,129,0,0,0
25,10,63,0,0,0
25,10,86,0,0,0
25,10,795,0,0,0
25,10,1376,4,2,2
25,10,553,0,0,0
25,10,1037,1,0,1
25,10,764,2,1,1
25,10,534,1,1,0
25,10,1380,1,0,1
25,10,1082,2,1,1
25,10,558,0,0,0
25,10,1030,13,4,9
25,10,488,3,2,1
25,10,923,7,2,5
25,10,1120,0,0,0
25,10,1194,9,3,6
25,10,998,2,1,1
25,10,1484,7,3,4
25,10,588,1,0,1
25,10,626,4,3,1
25,10,981,12,7,5
25,10,652,27,8,19
25,10,783,0,0,0
25,10,818,2,1,1
25,10,993,11,5,6
25,10,992,0,0,0
25,10,353,0,0,0
25,10,405,7,3,4
25,10,396,0,0,0
25,10,1655,18,7,11
25,10,754,1,0,1
25,10,313,0,0,0
25,10,688,564,300,264
25,10,696,445,217,228
25,10,1196,64,35,29
25,10,1155,3,1,2
25,10,340,0,0,0
25,10,853,2,1,1
25,10,535,0,0,0
25,10,947,0,0,0
25,10,505,1,1,0
25,10,695,1,1,0
25,10,1227,2,0,2
25,10,2262,9,4,5
25,10,686,9,5,4
25,10,1409,11,5,6
25,10,1375,13,7,6
25,10,695,1,0,1
25,11,3038,28,13,15
25,11,714,4,0,4
25,11,640,0,0,0
25,11,444,0,0,0
25,11,512,0,0,0
25,11,374,0,0,0
25,11,418,2,1,1
25,11,534,0,0,0
25,11,752,5,2,3
25,11,2636,13,5,8
25,11,3112,12,7,5
25,11,1077,4,3,1
25,11,604,3,1,2
25,11,394,1,1,0
25,11,284,2,2,0
25,11,701,5,2,3
25,11,419,1,1,0
25,11,616,11,10,1
25,11,5019,27,14,13
25,11,567,8,4,4
25,11,548,2,1,1
25,11,416,2,1,1
25,11,268,0,0,0
25,11,358,0,0,0
25,11,254,6,4,2
25,11,573,0,0,0
25,11,255,8,5,3
25,11,184,1,1,0
25,11,237,1,1,0
25,11,209,3,1,2
25,11,190,0,0,0
25,11,399,2,1,1
25,11,773,4,2,2
25,11,551,1,0,1
25,11,402,0,0,0
25,11,8584,72,40,32
25,11,396,1,1,0
25,11,443,18,9,9
25,11,590,19,11,8
25,11,370,0,0,0
25,11,239,0,0,0
25,11,250,0,0,0
25,11,141,0,0,0
25,11,178,0,0,0
25,11,263,2,2,0
25,11,380,0,0,0
25,11,329,1,0,1
25,11,208,0,0,0
25,11,223,0,0,0
25,11,98,0,0,0
25,11,244,0,0,0
25,11,177,0,0,0
25,11,396,2,2,0
25,11,499,5,4,1
25,11,16014,128,59,69
25,11,1763,212,115,97
25,11,424,215,129,86
25,11,757,11,3,8
25,11,191,1,0,1
25,11,194,0,0,0
25,11,199,0,0,0
25,11,165,0,0,0
25,11,333,1,0,1
25,11,504,2,0,2
25,11,479,2,0,2
25,11,218,0,0,0
25,11,242,3,2,1
25,11,213,1,0,1
25,11,145,0,0,0
25,11,269,1,0,1
25,11,330,0,0,0
25,11,261,0,0,0
25,11,469,0,0,0
25,11,484,3,2,1
25,11,501,0,0,0
25,11,732,1,1,0
25,11,428,0,0,0
25,11,779,2,0,2
25,11,885,9,5,4
25,11,1323,1,0,1
25,11,372,0,0,0
25,11,413,3,1,2
25,11,674,11,7,4
25,11,1045,5,2,3
25,11,721,6,2,4
25,11,1264,0,0,0
25,11,179,5,2,3
25,11,854,15,5,10
25,11,528,39,22,17
25,11,539,0,0,0
25,11,478,2,1,1
25,11,190,0,0,0
25,11,411,1,0,1
25,11,285,0,0,0
25,11,323,4,1,3
25,11,1702,20,11,9
25,11,449,40,18,22
25,11,435,0,0,0
25,11,200,0,0,0
25,11,457,0,0,0
25,11,475,0,0,0
25,11,88,0,0,0
25,11,502,0,0,0
25,11,545,1,0,1
25,11,368,0,0,0
25,11,473,1,1,0
25,11,443,0,0,0
25,11,633,35,18,17
25,11,145,2,1,1
25,11,635,1,1,0
25,11,757,3,2,1
25,11,353,0,0,0
25,11,227,0,0,0
25,11,1238,0,0,0
25,11,601,39,25,14
25,11,184,2,2,0
25,11,956,3,1,2
25,11,1295,1,1,0
25,11,520,4,1,3
25,11,716,1,1,0
25,11,1344,5,1,4
25,11,268,0,0,0
25,11,338,3,3,0
25,11,466,1,1,0
25,11,1099,2,1,1
25,11,627,7,5,2
25,11,522,0,0,0
25,11,765,1,1,0
25,11,579,0,0,0
25,11,709,6,3,3
25,11,524,0,0,0
25,11,308,0,0,0
25,11,277,0,0,0
25,11,726,0,0,0
25,11,857,1,1,0
25,11,196,0,0,0
25,11,158,39,20,19
25,11,818,790,401,389
25,11,3,0,0,0
25,11,457,11,6,5
25,11,375,12,5,7
25,11,402,5,2,3
25,11,382,8,4,4
25,11,278,0,0,0
25,11,298,1,1,0
25,11,965,4,2,2
25,11,748,4,1,3
25,11,691,0,0,0
25,11,960,5,1,4
25,11,723,1,1,0
25,11,541,0,0,0
25,11,523,0,0,0
25,11,808,3,1,2
25,11,378,1,0,1
25,11,294,1,1,0
25,11,366,0,0,0
25,11,1004,1,0,1
25,11,739,1,0,1
25,11,370,0,0,0
25,11,204,0,0,0
25,11,380,0,0,0
25,11,481,1,0,1
25,11,759,1,1,0
25,11,484,11,8,3
25,11,156,0,0,0
25,11,630,13,7,6
25,11,955,5,4,1
25,11,943,30,16,14
25,11,1286,6,0,6
25,11,1228,9,4,5
25,11,1101,49,28,21
25,11,154,4,2,2
25,11,210,5,2,3
25,11,251,0,0,0
25,11,641,36,19,17
25,11,374,3,1,2
25,11,635,5,1,4
25,11,282,1,0,1
25,11,199,0,0,0
25,11,253,2,0,2
25,11,3456,51,22,29
25,11,417,18,8,10
25,11,532,0,0,0
25,11,893,2,0,2
25,11,512,1,1,0
25,11,514,1,1,0
25,11,523,1,0,1
25,11,566,3,1,2
25,11,472,4,1,3
25,11,357,1,0,1
25,11,867,1,0,1
25,11,881,0,0,0
25,11,450,0,0,0
25,11,494,0,0,0
25,11,1075,3,1,2
25,11,330,3,0,3
25,11,576,5,3,2
25,11,874,1,0,1
25,11,528,0,0,0
25,11,1104,1,0,1
25,11,365,0,0,0
25,11,473,0,0,0
25,11,572,0,0,0
25,11,403,2,2,0
25,11,1469,8,6,2
25,11,315,0,0,0
25,11,492,0,0,0
25,11,301,1,1,0
25,11,969,4,2,2
25,11,270,0,0,0
25,11,386,0,0,0
25,11,489,0,0,0
25,11,629,1,1,0
25,11,767,0,0,0
25,11,866,1,0,1
25,11,766,2,1,1
25,11,820,3,2,1
25,11,1140,4,0,4
25,11,666,1,1,0
25,11,617,2,0,2
25,11,318,0,0,0
25,11,376,1,1,0
25,11,550,2,1,1
25,11,651,0,0,0
25,11,284,0,0,0
25,11,239,0,0,0
25,11,496,1,0,1
25,11,837,0,0,0
25,11,1119,0,0,0
25,11,246,0,0,0
25,11,171,1,0,1
25,11,180,1,0,1
25,11,182,0,0,0
25,11,330,1,0,1
25,11,459,1,1,0
25,11,720,0,0,0
25,11,1276,0,0,0
25,11,279,0,0,0
25,11,133,0,0,0
25,11,4420,11,4,7
25,11,881,1,1,0
25,11,259,0,0,0
25,11,462,0,0,0
25,11,2382,4,2,2
25,11,340,2,1,1
25,11,1710,2,2,0
25,11,6769,42,17,25
25,11,14,0,0,0
25,11,615,4,1,3
25,11,579,1,1,0
25,11,703,26,16,10
25,11,1068,1,0,1
25,11,589,0,0,0
25,11,368,0,0,0
25,11,557,0,0,0
25,11,293,0,0,0
25,11,375,0,0,0
25,11,131,1,1,0
25,11,613,0,0,0
25,11,308,0,0,0
25,11,358,1,1,0
25,11,208,0,0,0
25,11,155,0,0,0
25,11,747,2,1,1
25,11,528,0,0,0
25,11,567,1,1,0
25,11,887,0,0,0
25,11,720,32,15,17
25,11,456,4,1,3
25,11,485,44,23,21
25,11,497,1,1,0
25,11,657,12,6,6
25,11,1830,9,1,8
25,11,944,6,2,4
25,11,1163,1,0,1
25,11,548,1,0,1
25,11,592,0,0,0
25,11,534,0,0,0
25,11,575,5,4,1
25,11,638,5,1,4
25,11,489,3,2,1
25,11,423,0,0,0
25,11,381,0,0,0
25,11,438,0,0,0
25,11,169,0,0,0
25,11,169,8,5,3
25,11,528,13,7,6
25,11,1252,8,1,7
25,11,498,4,1,3
25,11,1008,4,2,2
25,11,791,0,0,0
25,11,648,3,3,0
25,11,1039,10,7,3
25,11,202,0,0,0
25,11,492,2,1,1
25,11,754,14,7,7
25,11,1129,4,3,1
25,11,182,0,0,0
25,11,485,0,0,0
25,11,1476,3,0,3
25,11,1079,0,0,0
25,11,470,0,0,0
25,11,219,0,0,0
25,11,312,10,6,4
25,11,281,0,0,0
25,11,1030,10,6,4
25,11,644,1,1,0
25,11,615,2,1,1
25,11,1451,3,1,2
25,11,412,1,1,0
25,11,540,1,0,1
25,11,669,2,2,0
25,11,739,11,4,7
25,11,1,-6,-6,-6
25,11,922,13,6,7
25,11,717,0,0,0
25,11,396,1,1,0
25,11,1569,8,5,3
25,11,640,3,1,2
25,11,1248,6,2,4
25,11,622,1,0,1
25,11,527,11,6,5
25,11,890,3,1,2
25,11,376,0,0,0
25,11,1080,3,2,1
25,11,618,1,0,1
25,11,546,1,0,1
25,11,227,0,0,0
25,11,261,0,0,0
25,11,289,0,0,0
25,11,570,0,0,0
25,11,177,0,0,0
25,11,561,0,0,0
25,11,653,0,0,0
25,11,551,0,0,0
25,11,198,1,1,0
25,11,306,0,0,0
25,11,789,0,0,0
25,11,947,0,0,0
25,11,630,1,0,1
25,11,152,2,1,1
25,11,121,0,0,0
25,11,252,0,0,0
25,11,183,0,0,0
25,11,357,0,0,0
25,11,133,1,0,1
25,11,101,3,2,1
25,11,539,0,0,0
25,11,838,4,3,1
25,11,562,2,2,0
25,11,287,2,1,1
25,11,454,1,1,0
25,11,1342,7,5,2
25,11,939,3,1,2
25,11,794,0,0,0
25,11,393,0,0,0
25,11,177,0,0,0
25,11,624,0,0,0
25,11,1495,2,1,1
25,11,666,1,0,1
25,11,188,1,0,1
25,11,98,0,0,0
25,11,260,1,1,0
25,11,380,0,0,0
25,11,189,2,1,1
25,11,283,0,0,0
25,11,339,1,0,1
25,11,665,2,1,1
25,11,697,0,0,0
25,11,790,1,1,0
25,11,264,1,0,1
25,11,943,0,0,0
25,11,1022,4,2,2
25,11,719,0,0,0
25,11,542,1,1,0
25,11,111,0,0,0
25,11,755,4,1,3
25,11,431,0,0,0
25,11,825,0,0,0
25,11,278,0,0,0
25,11,113,1,0,1
25,11,682,2,2,0
25,11,826,5,4,1
25,11,406,0,0,0
25,11,458,0,0,0
25,11,579,3,3,0
25,11,429,2,1,1
25,11,1201,1,0,1
25,11,666,5,2,3
25,11,200,0,0,0
25,11,205,0,0,0
25,11,112,0,0,0
25,11,1027,0,0,0
25,11,367,0,0,0
25,11,496,0,0,0
25,11,494,2,2,0
25,11,593,1,1,0
25,11,197,0,0,0
25,11,470,2,2,0
25,11,775,0,0,0
25,11,632,2,2,0
25,11,828,0,0,0
25,11,691,1,1,0
25,11,358,0,0,0
25,11,178,0,0,0
25,11,402,0,0,0
25,11,648,1,1,0
25,11,772,3,1,2
25,11,664,3,2,1
25,11,851,0,0,0
25,11,600,0,0,0
25,11,121,0,0,0
25,11,171,0,0,0
25,11,555,1,1,0
25,11,395,0,0,0
25,11,398,1,0,1
25,11,620,2,2,0
25,11,194,0,0,0
25,11,534,1,0,1
25,11,569,0,0,0
25,11,518,0,0,0
25,11,208,0,0,0
25,11,543,0,0,0
25,11,224,0,0,0
25,11,368,1,0,1
25,11,560,0,0,0
25,11,796,12,5,7
25,11,823,9,4,5
25,11,643,3,0,3
25,11,414,1,1,0
25,11,206,2,2,0
25,11,264,0,0,0
25,11,204,0,0,0
25,11,478,1,1,0
25,11,323,2,0,2
25,11,891,0,0,0
25,11,274,11,4,7
25,11,656,0,0,0
25,12,215,0,0,0
25,12,391,2,1,1
25,12,312,4,3,1
25,12,433,4,3,1
25,12,321,14,7,7
25,12,462,14,3,11
25,12,518,5,2,3
25,12,279,3,3,0
25,12,429,2,1,1
25,12,298,11,6,5
25,12,290,3,2,1
25,12,486,0,0,0
25,12,297,4,0,4
25,12,201,1,0,1
25,12,321,1,0,1
25,12,444,0,0,0
25,12,494,3,2,1
25,12,294,2,0,2
25,12,218,1,0,1
25,12,372,0,0,0
25,12,572,9,6,3
25,12,184,1,1,0
25,12,633,5,2,3
25,12,406,0,0,0
25,12,482,2,1,1
25,12,259,0,0,0
25,12,118,0,0,0
25,12,335,5,1,4
25,12,232,0,0,0
25,12,197,0,0,0
25,12,395,2,1,1
25,12,410,4,2,2
25,12,256,3,0,3
25,12,220,0,0,0
25,12,230,3,2,1
25,12,136,2,1,1
25,12,321,1,0,1
25,12,243,0,0,0
25,12,137,1,1,0
25,12,142,0,0,0
25,12,192,6,2,4
25,12,256,4,2,2
25,12,342,2,1,1
25,12,218,1,1,0
25,12,202,0,0,0
25,12,321,0,0,0
25,12,325,2,0,2
25,12,388,6,4,2
25,12,364,0,0,0
25,12,361,11,4,7
25,12,379,1,1,0
25,12,293,1,0,1
25,12,354,0,0,0
25,12,694,10,4,6
25,12,425,16,5,11
25,12,566,4,0,4
25,12,1269,26,10,16
25,12,203,5,3,2
25,12,264,1,0,1
25,12,259,1,0,1
25,12,495,2,1,1
25,12,395,9,5,4
25,12,399,2,2,0
25,12,1343,2,1,1
25,12,466,108,58,50
25,12,532,12,4,8
25,12,11664,629,305,324
25,12,628,106,54,52
25,12,515,5,3,2
25,12,946,9,3,6
25,12,822,3,2,1
25,12,969,0,0,0
25,12,8785,62,29,33
25,12,1357,6,4,2
25,12,684,1,1,0
25,12,1412,26,14,12
25,12,1427,3,2,1
25,12,11035,208,100,108
25,12,879,5,3,2
25,12,1995,8,4,4
25,12,394,0,0,0
25,12,625,0,0,0
25,12,565,5,1,4
25,12,227,1,1,0
25,12,304,0,0,0
25,12,673,0,0,0
25,12,827,0,0,0
25,12,427,1,0,1
25,12,493,0,0,0
25,12,331,0,0,0
25,12,355,0,0,0
25,12,275,0,0,0
25,12,186,0,0,0
25,12,293,0,0,0
25,12,291,0,0,0
25,12,1345,3,1,2
25,12,494,0,0,0
25,12,702,0,0,0
25,12,266,0,0,0
25,12,1097,31,11,20
25,12,1923,85,43,42
25,12,212,0,0,0
25,12,292,1,0,1
25,12,527,4,2,2
25,12,270,0,0,0
25,12,295,0,0,0
25,12,3276,13,7,6
25,12,663,3,2,1
25,12,245,0,0,0
25,12,385,1,1,0
25,12,495,4,2,2
25,12,476,0,0,0
25,12,438,0,0,0
25,12,1360,2,0,2
25,12,1131,1,0,1
25,12,2966,20,9,11
25,12,15,0,0,0
25,12,173,0,0,0
25,12,447,1,0,1
25,12,495,4,3,1
25,12,1944,14,7,7
25,12,467,16,11,5
25,12,686,0,0,0
25,12,1067,31,12,19
25,12,969,3,1,2
25,12,5126,54,22,32
25,12,787,1,0,1
25,12,697,4,3,1
25,12,965,3,1,2
25,12,821,0,0,0
25,12,6467,29,11,18
25,12,1320,6,4,2
25,12,1022,12,4,8
25,12,2407,14,7,7
25,12,1131,9,5,4
25,12,2253,81,44,37
25,12,477,4,2,2
25,12,449,9,3,6
25,12,393,1,0,1
25,12,540,0,0,0
25,12,1096,13,9,4
25,12,1670,7,4,3
25,12,2610,54,30,24
25,12,1167,5,2,3
25,12,1158,6,3,3
25,12,1482,5,2,3
25,12,1108,4,1,3
25,12,2272,8,4,4
25,12,17553,116,56,60
25,12,336,0,0,0
25,12,2314,6,3,3
25,12,8905,40,19,21
25,12,1315,1,0,1
25,12,901,3,1,2
25,12,488,3,1,2
25,12,4986,29,18,11
25,12,359,16,10,6
25,12,946,13,7,6
25,12,630,1,1,0
25,12,738,0,0,0
25,12,700,13,5,8
25,12,747,7,5,2
25,12,589,1,0,1
25,12,674,0,0,0
25,12,509,4,3,1
25,12,1108,8,5,3
25,12,338,0,0,0
25,12,451,7,2,5
25,12,756,2,2,0
25,12,918,17,7,10
25,12,207,0,0,0
25,12,482,0,0,0
25,12,1079,10,7,3
25,12,923,1,1,0
25,12,1824,8,2,6
25,12,555,7,6,1
25,12,425,6,1,5
25,12,524,1,1,0
25,12,787,2,0,2
25,12,1914,8,3,5
25,12,528,0,0,0
25,12,517,0,0,0
25,12,605,2,1,1
25,12,270,0,0,0
25,12,293,0,0,0
25,12,248,0,0,0
25,12,447,1,0,1
25,12,763,3,0,3
25,12,666,8,5,3
25,12,603,8,4,4
25,12,899,9,6,3
25,12,601,0,0,0
25,12,671,0,0,0
25,12,609,1,1,0
25,12,1713,9,3,6
25,12,1008,2,1,1
25,12,655,1,1,0
25,12,2701,2,0,2
25,12,2492,19,10,9
25,12,2884,64,29,35
25,12,3830,33,19,14
25,12,3177,9,5,4
25,12,1359,31,15,16
25,12,1848,11,6,5
25,12,408,4,2,2
25,12,216,10,6,4
25,12,770,1,1,0
25,12,303,1,0,1
25,12,553,1,1,0
25,12,571,1,1,0
25,12,625,2,1,1
25,12,640,1,1,0
25,12,636,4,1,3
25,12,318,2,1,1
25,12,299,0,0,0
25,12,293,1,0,1
25,12,352,0,0,0
25,12,424,0,0,0
25,12,889,1,0,1
25,12,1292,4,2,2
25,12,994,4,0,4
25,12,209,6,2,4
25,12,387,1,1,0
25,12,369,1,0,1
25,12,427,1,1,0
25,12,316,0,0,0
25,12,553,2,2,0
25,12,636,1,0,1
25,12,422,6,3,3
25,12,342,0,0,0
25,12,410,0,0,0
25,12,619,6,3,3
25,12,580,5,3,2
25,12,386,10,5,5
25,12,519,0,0,0
25,12,320,0,0,0
25,12,381,2,1,1
25,12,436,0,0,0
25,12,474,0,0,0
25,12,493,0,0,0
25,12,1242,15,10,5
25,12,702,6,4,2
25,12,450,2,1,1
25,12,481,2,1,1
25,12,437,1,1,0
25,12,547,0,0,0
25,12,603,3,2,1
25,12,510,5,1,4
25,12,790,4,2,2
25,12,410,3,3,0
25,12,379,0,0,0
25,12,453,6,3,3
25,12,505,1,1,0
25,12,699,1,0,1
25,12,496,6,0,6
25,12,1545,5,2,3
25,12,957,0,0,0
25,12,1197,7,3,4
25,12,787,5,0,5
25,12,561,6,1,5
25,12,502,5,4,1
25,12,6502,112,49,63
25,12,1017,2,1,1
25,12,689,3,2,1
25,12,3173,25,10,15
25,12,3978,12,7,5
25,12,1585,4,1,3
25,12,538,2,1,1
25,12,659,3,3,0
25,12,955,3,2,1
25,12,861,8,3,5
25,12,758,2,0,2
25,12,837,2,1,1
25,12,652,0,0,0
25,12,649,0,0,0
25,12,268,1,0,1
25,12,489,4,2,2
25,12,590,2,1,1
25,12,529,0,0,0
25,12,548,1,0,1
25,12,411,1,1,0
25,12,407,4,0,4
25,12,495,8,5,3
25,12,691,0,0,0
25,12,593,2,1,1
25,12,341,0,0,0
25,12,1218,12,6,6
25,12,1027,5,3,2
25,12,872,19,10,9
25,12,1204,12,5,7
25,12,924,5,1,4
25,12,1483,109,62,47
25,12,658,3,1,2
25,12,647,5,2,3
25,12,302,2,2,0
25,12,369,0,0,0
25,12,224,0,0,0
25,12,296,1,0,1
25,12,497,1,1,0
25,12,565,0,0,0
25,12,502,1,0,1
25,12,440,1,1,0
25,12,572,0,0,0
25,12,879,1,1,0
25,12,2433,64,28,36
25,12,5741,85,42,43
25,12,3508,71,37,34
25,12,1885,14,8,6
25,12,507,2,1,1
25,12,881,6,2,4
25,12,1048,1,1,0
25,12,646,0,0,0
25,12,583,41,22,19
25,12,301,1,0,1
25,12,251,1,0,1
25,12,316,2,1,1
25,12,404,1,1,0
25,12,683,68,34,34
25,12,573,2,0,2
25,12,1883,68,30,38
25,12,457,13,5,8
25,12,429,10,4,6
25,12,404,15,7,8
25,12,337,2,1,1
25,12,593,2,1,1
25,12,1001,4,2,2
25,12,816,38,17,21
25,12,1047,2,0,2
25,12,901,2,2,0
25,12,311,1,0,1
25,12,225,1,0,1
25,12,350,0,0,0
25,12,380,1,1,0
25,12,515,2,1,1
25,12,344,1,0,1
25,12,2279,19,7,12
25,12,941,1,0,1
25,12,505,5,3,2
25,12,379,0,0,0
25,12,452,3,1,2
25,12,414,0,0,0
25,12,1300,5,3,2
25,12,515,3,3,0
25,12,1801,1,1,0
25,12,1218,4,3,1
25,12,937,5,4,1
25,12,513,1,1,0
25,12,399,6,0,6
25,12,523,16,5,11
25,12,353,0,0,0
25,12,611,0,0,0
25,12,474,6,2,4
25,12,427,11,6,5
25,12,252,5,4,1
25,12,395,0,0,0
25,12,258,0,0,0
25,12,278,0,0,0
25,12,821,9,5,4
25,12,697,0,0,0
25,12,849,11,4,7
25,12,433,6,5,1
25,12,623,7,3,4
25,12,1794,1,0,1
25,12,775,1,1,0
25,12,133,4,2,2
25,12,811,11,4,7
25,12,511,4,2,2
25,12,390,3,2,1
25,12,211,0,0,0
25,12,301,7,4,3
25,12,250,3,2,1
25,12,530,2,0,2
25,12,239,2,0,2
25,12,502,2,1,1
25,12,354,3,1,2
25,12,450,11,5,6
25,12,364,3,3,0
25,12,654,26,16,10
25,12,1163,14,7,7
25,12,629,6,2,4
25,12,639,15,7,8
25,12,397,6,3,3
25,12,307,0,0,0
25,12,632,1,0,1
25,12,328,2,1,1
25,12,319,0,0,0
25,12,382,0,0,0
25,12,267,0,0,0
25,12,192,1,1,0
25,12,548,3,2,1
25,12,278,1,0,1
25,12,415,9,5,4
25,12,365,5,2,3
25,12,444,6,2,4
25,12,511,3,2,1
25,12,771,8,4,4
25,12,601,1,0,1
25,12,311,37,19,18
25,12,492,7,4,3
25,12,233,0,0,0
25,12,415,4,2,2
25,12,133,2,0,2
25,12,222,0,0,0
25,12,369,5,4,1
25,12,5656,117,59,58
25,12,675,0,0,0
25,12,673,3,2,1
25,12,2345,11,2,9
25,12,182,2,1,1
25,12,45,0,0,0
25,12,61,0,0,0
25,12,275,2,1,1
25,12,82,0,0,0
25,12,346,0,0,0
25,12,215,0,0,0
25,12,156,0,0,0
25,12,256,0,0,0
25,12,578,7,3,4
25,12,774,1,1,0
25,12,187,2,1,1
25,12,165,0,0,0
25,12,473,5,3,2
25,12,338,2,1,1
25,12,111,0,0,0
25,12,455,3,2,1
25,12,410,2,1,1
25,12,207,0,0,0
25,12,356,0,0,0
25,12,1014,7,4,3
25,12,764,2,1,1
25,12,471,1,0,1
25,12,257,1,0,1
25,12,211,0,0,0
25,12,810,0,0,0
25,12,211,0,0,0
25,12,482,0,0,0
25,12,733,0,0,0
25,12,532,0,0,0
25,12,1112,2,2,0
25,12,25723,1373,669,704
25,12,2690,64,35,29
25,12,479,2,1,1
25,12,546,0,0,0
25,12,302,0,0,0
25,12,720,1,1,0
25,12,211,0,0,0
25,12,22806,208,108,100
25,12,1284,15,8,7
25,13,604,9,7,2
25,13,538,8,2,6
25,13,101,1,1,0
25,13,122,0,0,0
25,13,159,1,0,1
25,13,200,1,1,0
25,13,635,3,2,1
25,13,441,1,0,1
25,13,431,2,1,1
25,13,273,3,3,0
25,13,1504,16,9,7
25,13,945,1,0,1
25,13,210,0,0,0
25,13,150,0,0,0
25,13,880,0,0,0
25,13,399,3,2,1
25,13,114,1,1,0
25,13,221,1,0,1
25,13,284,1,1,0
25,13,146,0,0,0
25,13,157,3,0,3
25,13,199,4,3,1
25,13,175,0,0,0
25,13,41,0,0,0
25,13,465,2,0,2
25,13,207,1,1,0
25,13,319,2,2,0
25,13,211,0,0,0
25,13,426,2,1,1
25,13,322,0,0,0
25,13,271,1,1,0
25,13,169,0,0,0
25,13,237,0,0,0
25,13,103,2,0,2
25,13,198,2,2,0
25,13,24,1,1,0
25,13,117,1,1,0
25,13,457,1,0,1
25,13,308,0,0,0
25,13,502,0,0,0
25,13,279,1,0,1
25,13,292,0,0,0
25,13,311,1,0,1
25,13,594,0,0,0
25,13,839,0,0,0
25,13,555,1,1,0
25,13,307,2,0,2
25,13,608,1,1,0
25,13,126,0,0,0
25,13,273,2,1,1
25,13,120,0,0,0
25,13,207,0,0,0
25,13,297,3,2,1
25,13,187,0,0,0
25,13,235,0,0,0
25,13,354,0,0,0
25,13,248,0,0,0
25,13,154,0,0,0
25,13,95,0,0,0
25,13,180,0,0,0
25,13,134,1,0,1
25,13,265,1,0,1
25,13,29,0,0,0
25,13,167,0,0,0
25,13,115,0,0,0
25,13,70,0,0,0
25,13,137,0,0,0
25,13,60,0,0,0
25,13,119,0,0,0
25,13,140,1,1,0
25,13,116,1,0,1
25,13,400,7,2,5
25,13,249,2,1,1
25,13,566,5,2,3
25,13,73,0,0,0
25,13,272,2,1,1
25,13,398,1,1,0
25,13,373,1,0,1
25,13,749,1,0,1
25,13,407,2,1,1
25,13,421,1,1,0
25,13,311,2,2,0
25,13,2145,18,11,7
25,13,378,1,1,0
25,13,296,0,0,0
25,13,155,0,0,0
25,13,145,0,0,0
25,13,655,5,1,4
25,13,618,0,0,0
25,13,171,0,0,0
25,13,166,0,0,0
25,13,498,0,0,0
25,13,616,1,0,1
25,13,427,0,0,0
25,13,176,1,0,1
25,13,418,0,0,0
25,13,1073,4,2,2
25,13,377,0,0,0
25,13,619,1,0,1
25,13,920,4,3,1
25,13,254,0,0,0
25,13,147,0,0,0
25,13,335,9,3,6
25,13,399,1,0,1
25,13,351,1,0,1
25,13,358,0,0,0
25,13,312,1,0,1
25,13,516,0,0,0
25,13,342,1,1,0
25,13,518,0,0,0
25,13,450,1,0,1
25,13,535,2,1,1
25,13,652,4,2,2
25,13,202,0,0,0
25,14,1773,9,3,6
25,14,1494,10,7,3
25,14,592,1,1,0
25,14,265,3,1,2
25,14,608,0,0,0
25,14,562,2,0,2
25,14,381,2,0,2
25,14,2181,163,90,73
25,14,1816,12,5,7
25,14,2032,5,1,4
25,14,427,3,2,1
25,14,485,5,3,2
25,14,986,2,0,2
25,14,355,0,0,0
25,14,110,0,0,0
25,14,335,1,0,1
25,14,900,8,2,6
25,14,772,2,1,1
25,14,396,2,2,0
25,14,497,3,2,1
25,14,535,3,2,1
25,14,170,0,0,0
25,14,53,0,0,0
25,14,141,1,0,1
25,14,299,0,0,0
25,14,80,0,0,0
25,14,43,0,0,0
25,14,210,0,0,0
25,14,225,0,0,0
25,14,283,0,0,0
25,14,695,3,1,2
25,14,361,3,1,2
25,14,422,3,2,1
25,14,147,0,0,0
25,14,797,4,2,2
25,14,508,9,5,4
25,14,185,0,0,0
25,14,378,1,0,1
25,14,191,0,0,0
25,14,323,1,0,1
25,14,1244,1,0,1
25,14,936,35,19,16
25,14,3,0,0,0
25,14,1125,2,1,1
25,14,210,0,0,0
25,14,1034,2,1,1
25,14,408,2,1,1
25,14,360,1,1,0
25,14,510,27,16,11
25,14,331,0,0,0
25,14,787,1,0,1
25,14,118,0,0,0
25,14,426,2,1,1
25,14,197,0,0,0
25,14,465,3,2,1
25,14,490,57,31,26
25,14,684,0,0,0
25,14,155,0,0,0
25,14,1614,1,1,0
25,14,1137,8,3,5
25,14,359,2,1,1
25,14,586,4,2,2
25,14,493,0,0,0
25,14,775,3,1,2
25,14,785,3,0,3
25,14,754,8,2,6
25,14,182,0,0,0
25,14,884,1,1,0
25,14,227,0,0,0
25,14,443,0,0,0
25,14,962,0,0,0
25,14,1244,0,0,0
25,14,744,2,1,1
25,14,1911,2,2,0
25,14,1119,0,0,0
25,14,1066,4,2,2
25,14,648,2,1,1
25,14,609,1,1,0
25,14,569,0,0,0
25,14,395,2,0,2
25,14,569,0,0,0
25,14,539,0,0,0
25,14,250,0,0,0
25,14,328,0,0,0
25,14,227,0,0,0
25,14,773,0,0,0
25,15,2536,15,6,9
25,15,729,0,0,0
25,15,3034,2,0,2
25,15,332,4,2,2
25,15,1896,16,8,8
25,15,420,1,0,1
25,15,525,4,1,3
25,15,522,6,4,2
25,15,646,1,0,1
25,15,259,10,5,5
25,15,258,1,0,1
25,15,174,0,0,0
25,15,270,6,2,4
25,15,418,4,2,2
25,15,436,0,0,0
25,15,581,0,0,0
25,15,276,1,1,0
25,15,599,4,3,1
25,15,771,1,0,1
25,15,1737,3,1,2
25,15,386,3,2,1
25,15,318,1,0,1
25,15,180,2,0,2
25,15,190,0,0,0
25,15,429,0,0,0
25,15,331,3,2,1
25,15,436,5,3,2
25,15,269,0,0,0
25,15,192,0,0,0
25,15,356,1,0,1
25,15,159,0,0,0
25,15,215,0,0,0
25,15,282,0,0,0
25,15,267,2,0,2
25,15,190,1,0,1
25,15,215,1,0,1
25,15,319,5,3,2
25,15,404,2,0,2
25,15,211,1,0,1
25,15,101,0,0,0
25,15,240,0,0,0
25,15,250,2,0,2
25,15,224,0,0,0
25,15,125,2,2,0
25,15,295,1,1,0
25,15,268,3,3,0
25,15,215,0,0,0
25,15,299,3,2,1
25,15,444,1,0,1
25,15,811,4,1,3
25,15,775,1,1,0
25,15,4127,13,4,9
25,15,1635,3,1,2
25,15,1332,6,1,5
25,15,460,1,0,1
25,15,767,0,0,0
25,15,465,1,1,0
25,15,649,0,0,0
25,15,396,1,0,1
25,15,372,4,2,2
25,15,722,47,30,17
25,15,553,25,14,11
25,15,485,3,2,1
25,15,9790,60,30,30
25,15,292,2,0,2
25,15,158,2,2,0
25,15,153,2,0,2
25,15,156,0,0,0
25,15,152,0,0,0
25,15,150,3,3,0
25,15,145,0,0,0
25,15,195,0,0,0
25,15,166,0,0,0
25,15,232,0,0,0
25,15,287,2,1,1
25,15,274,23,13,10
25,15,223,1,1,0
25,15,195,0,0,0
25,15,287,1,0,1
25,15,266,2,1,1
25,15,693,4,1,3
25,15,406,6,2,4
25,15,673,0,0,0
25,15,3286,30,13,17
25,15,451,0,0,0
25,15,434,0,0,0
25,15,309,10,5,5
25,15,311,1,1,0
25,15,544,1,1,0
25,15,347,0,0,0
25,15,407,2,2,0
25,15,414,1,0,1
25,15,392,3,2,1
25,15,358,3,1,2
25,15,308,5,3,2
25,15,420,4,2,2
25,15,807,7,4,3
25,15,553,1,1,0
25,15,443,2,0,2
25,15,830,3,2,1
25,15,129,0,0,0
25,15,267,1,1,0
25,15,160,0,0,0
25,15,293,1,1,0
25,15,240,0,0,0
25,15,166,1,1,0
25,15,296,1,0,1
25,15,209,0,0,0
25,15,168,0,0,0
25,15,161,2,0,2
25,15,189,1,1,0
25,15,97,0,0,0
25,15,834,1,1,0
25,15,670,3,2,1
25,15,463,6,3,3
25,15,343,0,0,0
25,15,663,0,0,0
25,15,420,0,0,0
25,15,234,0,0,0
25,15,324,0,0,0
25,15,187,0,0,0
25,15,211,0,0,0
25,15,213,2,0,2
25,15,179,0,0,0
25,15,154,1,0,1
25,15,321,0,0,0
25,15,496,0,0,0
25,15,294,0,0,0
25,15,403,0,0,0
25,15,362,0,0,0
25,15,411,0,0,0
25,15,1961,2,0,2
25,15,621,1,1,0
25,15,374,0,0,0
25,15,741,1,0,1
25,15,445,0,0,0
25,15,425,0,0,0
25,15,138,0,0,0
25,15,234,0,0,0
25,15,495,0,0,0
25,15,313,0,0,0
25,15,97,1,1,0
25,15,222,0,0,0
25,15,149,1,0,1
25,16,2013,6,3,3
25,16,392,1,0,1
25,16,438,3,3,0
25,16,742,3,2,1
25,16,1620,6,4,2
25,16,165,2,2,0
25,16,165,0,0,0
25,16,117,0,0,0
25,16,235,0,0,0
25,16,321,2,1,1
25,16,0,0,0,0
25,16,286,0,0,0
25,16,25,0,0,0
25,16,334,0,0,0
25,16,123,0,0,0
25,16,337,0,0,0
25,16,254,1,0,1
25,16,579,1,1,0
25,16,52,0,0,0
25,16,269,0,0,0
25,16,67,0,0,0
25,16,504,1,0,1
25,16,516,1,1,0
25,16,851,3,1,2
25,16,472,2,2,0
25,16,537,3,1,2
25,16,179,2,1,1
25,16,419,4,3,1
25,16,180,0,0,0
25,16,328,0,0,0
25,16,755,0,0,0
25,16,939,0,0,0
25,16,478,0,0,0
25,16,854,2,0,2
25,16,397,1,1,0
25,16,449,5,2,3
25,16,824,2,0,2
25,16,1392,3,3,0
25,16,415,0,0,0
25,16,259,0,0,0
25,16,182,1,0,1
25,17,819,0,0,0
25,17,306,0,0,0
25,17,409,1,1,0
25,17,1130,0,0,0
25,17,291,0,0,0
25,17,2212,4,2,2
25,17,392,2,1,1
25,17,444,0,0,0
25,17,255,1,1,0
25,17,209,1,0,1
25,17,757,0,0,0
25,17,272,0,0,0
25,17,411,4,4,0
25,17,193,11,8,3
25,17,496,0,0,0
25,17,1632,11,5,6
25,17,166,0,0,0
25,17,272,0,0,0
25,17,220,0,0,0
25,17,60,0,0,0
25,17,154,0,0,0
25,17,462,0,0,0
25,17,610,0,0,0
25,17,180,1,0,1
25,17,383,2,1,1
25,17,920,0,0,0
25,17,736,1,0,1
25,17,44,0,0,0
25,17,188,0,0,0
25,17,271,1,0,1
25,17,91,0,0,0
25,17,311,0,0,0
25,17,431,1,0,1
25,17,226,0,0,0
25,17,291,0,0,0
25,17,136,1,1,0
25,17,219,1,0,1
25,17,514,24,11,13
25,17,913,8,4,4
25,17,396,2,0,2
25,17,915,2,1,1
25,17,195,0,0,0
25,17,492,1,0,1
25,17,581,5,2,3
25,17,131,0,0,0
25,17,171,1,0,1
25,17,953,1,1,0
25,17,237,0,0,0
25,17,623,0,0,0
25,17,696,0,0,0
25,17,529,0,0,0
25,17,594,1,1,0
25,17,1050,0,0,0
25,17,264,0,0,0
25,17,134,2,2,0
25,17,150,0,0,0
25,17,178,1,0,1
25,17,101,0,0,0
25,17,489,0,0,0
25,17,893,2,0,2
25,17,349,1,0,1
25,17,302,0,0,0
25,17,247,0,0,0
25,17,243,1,1,0
25,17,179,1,1,0
25,17,155,2,0,2
25,17,169,0,0,0
25,17,342,0,0,0
25,17,568,0,0,0
25,17,282,0,0,0
25,17,346,0,0,0
25,17,413,0,0,0
25,17,5,0,0,0
25,17,174,0,0,0
25,17,88,0,0,0
25,17,770,3,1,2
25,17,298,0,0,0
25,17,584,3,1,2
25,17,410,83,42,41
25,17,1228,93,43,50
25,17,63,8,5,3
25,17,163,2,2,0
25,17,1043,97,47,50
25,17,387,111,53,58
25,17,366,64,31,33
25,17,1932,5,2,3
25,17,544,2,2,0
25,17,458,0,0,0
25,17,383,1,0,1
25,17,375,0,0,0
25,17,276,1,0,1
25,17,240,0,0,0
25,17,346,0,0,0
25,17,233,0,0,0
25,17,554,0,0,0
25,17,547,3,2,1
25,17,234,0,0,0
25,17,286,0,0,0
25,17,610,0,0,0
25,17,841,0,0,0
25,17,609,0,0,0
25,17,291,0,0,0
25,17,361,0,0,0
25,17,341,1,1,0
25,17,402,3,1,2
25,17,156,0,0,0
25,17,119,0,0,0
25,17,399,0,0,0
25,17,257,1,1,0
25,17,392,0,0,0
25,17,260,0,0,0
25,17,137,0,0,0
25,17,258,1,0,1
25,17,185,0,0,0
25,17,287,0,0,0
25,17,17,0,0,0
25,17,279,1,1,0
25,17,174,0,0,0
25,17,275,1,0,1
25,17,426,1,0,1
25,17,273,1,0,1
25,17,121,0,0,0
25,17,84,0,0,0
25,17,418,0,0,0
25,17,928,0,0,0
25,17,229,1,0,1
25,17,398,0,0,0
25,17,67,0,0,0
25,17,348,0,0,0
25,17,558,2,1,1
25,17,358,0,0,0
25,17,728,0,0,0
25,17,996,4,2,2
25,17,420,0,0,0
25,17,409,0,0,0
25,17,485,0,0,0
25,17,423,1,1,0
25,17,575,6,6,0
25,17,911,0,0,0
25,17,353,0,0,0
25,17,41,0,0,0
25,17,1028,2,2,0
25,17,579,0,0,0
25,17,436,2,2,0
25,17,426,1,0,1
25,17,732,0,0,0
25,17,230,1,0,1
25,17,413,1,0,1
25,17,508,0,0,0
25,17,957,0,0,0
25,17,283,2,1,1
25,17,301,1,0,1
25,17,1012,18,10,8
25,17,479,10,5,5
25,17,1163,6,1,5
25,17,0,0,0,0
25,17,596,1,1,0
25,17,538,7,3,4
25,17,526,6,3,3
25,17,737,11,7,4
25,17,340,0,0,0
25,17,300,0,0,0
25,17,429,0,0,0
25,17,377,0,0,0
25,17,142,0,0,0
25,17,476,1,0,1
25,17,143,0,0,0
25,17,261,1,1,0
25,17,363,0,0,0
25,17,147,0,0,0
25,17,235,2,1,1
25,17,208,2,1,1
25,17,628,0,0,0
25,17,514,1,0,1
25,17,565,0,0,0
25,17,758,0,0,0
25,17,458,0,0,0
25,17,76,0,0,0
25,17,169,0,0,0
25,18,254,19,11,8
25,18,544,15,6,9
25,18,245,2,1,1
25,18,128,2,2,0
25,18,658,0,0,0
25,18,1133,3,2,1
25,18,534,0,0,0
25,18,478,3,2,1
25,18,539,0,0,0
25,18,315,7,4,3
25,18,120,1,1,0
25,18,241,4,1,3
25,18,254,5,3,2
25,18,315,2,1,1
25,18,79,0,0,0
25,18,227,15,7,8
25,18,741,61,30,31
25,18,261,3,2,1
25,18,285,28,13,15
25,18,1631,101,48,53
25,18,805,2,1,1
25,18,1869,18,10,8
25,18,890,16,6,10
25,18,258,4,1,3
25,18,282,2,1,1
25,18,344,1,0,1
25,18,2957,39,16,23
25,18,603,6,2,4
25,18,528,0,0,0
25,18,582,0,0,0
25,18,1021,18,8,10
25,18,8627,852,430,422
25,18,2312,169,87,82
25,18,449,1,1,0
25,18,353,1,0,1
25,18,240,0,0,0
25,18,1239,4,2,2
25,18,272,0,0,0
25,18,787,47,21,26
25,18,300,0,0,0
25,18,1487,10,4,6
25,18,252,7,1,6
25,18,484,0,0,0
25,18,866,2,1,1
25,18,832,6,2,4
25,18,100,0,0,0
25,18,1165,3,0,3
25,18,405,10,7,3
25,18,677,0,0,0
25,18,445,2,1,1
25,18,1431,2,0,2
25,18,938,1,0,1
25,18,454,0,0,0
25,18,415,0,0,0
25,18,1850,0,0,0
25,18,1720,2,1,1
25,18,315,1,1,0
25,18,1698,9,3,6
25,18,280,1,1,0
25,18,822,5,2,3
25,18,516,437,237,200
25,18,257,44,22,22
25,18,297,16,7,9
25,18,175,0,0,0
25,18,580,0,0,0
25,18,295,0,0,0
25,18,584,0,0,0
25,18,809,3,2,1
25,18,701,12,6,6
25,18,406,0,0,0
25,18,499,2,1,1
25,18,1088,8,3,5
25,18,125,0,0,0
25,18,323,4,1,3
25,18,342,5,3,2
25,18,529,2,1,1
25,18,955,0,0,0
25,18,870,1,1,0
25,18,942,3,0,3
25,18,973,0,0,0
25,18,505,4,1,3
25,18,834,0,0,0
25,18,810,4,2,2
25,18,433,0,0,0
25,18,1294,3,1,2
25,18,1120,54,25,29
25,18,59,1,0,1
25,18,701,33,21,12
25,18,652,2,1,1
25,18,342,0,0,0
25,18,106,0,0,0
25,18,885,11,8,3
25,18,892,4,3,1
25,18,881,2,0,2
25,18,857,2,1,1
25,18,931,4,4,0
25,18,906,4,1,3
25,18,460,0,0,0
25,18,281,0,0,0
25,18,503,1,0,1
25,18,715,0,0,0
25,18,883,1,1,0
25,18,1108,9,6,3
25,18,315,3,1,2
25,18,880,3,1,2
25,18,1030,5,1,4
25,18,1278,7,5,2
25,18,143,0,0,0
25,18,549,1,1,0
25,18,775,3,2,1
25,18,892,0,0,0
25,18,689,1,1,0
25,18,1743,3,1,2
25,18,232,0,0,0
25,18,507,4,2,2
25,18,801,0,0,0
25,18,804,7,4,3
25,18,700,0,0,0
25,18,22,0,0,0
25,18,853,0,0,0
25,18,446,1,0,1
25,18,629,28,12,16
25,18,409,44,23,21
25,18,336,0,0,0
25,18,783,3,0,3
25,18,287,1,1,0
25,18,801,1,1,0
25,18,718,0,0,0
25,18,369,0,0,0
25,18,982,1,0,1
25,18,661,1,1,0
25,18,1346,9,4,5
25,18,854,3,0,3
25,18,17,0,0,0
25,18,1349,1,1,0
25,18,221,0,0,0
25,18,198,0,0,0
25,18,644,1,0,1
25,18,503,5,3,2
25,18,213,0,0,0
25,18,4599,9,5,4
25,18,610,1,1,0
25,18,799,2,2,0
25,18,581,0,0,0
25,18,458,0,0,0
25,18,645,1,0,1
25,18,3773,3,1,2
25,18,556,0,0,0
25,18,560,4,2,2
25,18,2089,8,5,3
25,18,284,1,1,0
25,18,498,1,0,1
25,18,16972,30,15,15
25,18,2352,12,5,7
25,18,0,0,0,0
25,18,329,1,1,0
25,18,266,0,0,0
25,18,233,7,4,3
25,18,374,1,1,0
25,18,135,0,0,0
25,18,564,0,0,0
25,18,1742,9,7,2
25,18,43,0,0,0
25,18,1212,216,116,100
25,18,2883,3,2,1
25,18,218,0,0,0
25,18,276,1,1,0
25,18,739,12,0,12
25,18,934,3,2,1
25,18,671,2,2,0
25,18,625,1,1,0
25,18,582,3,2,1
25,12,2231,75,38,37
25,12,2518,7,2,5
25,12,1700,1,1,0
25,12,2000,14,5,9
25,12,1272,12,5,7
25,12,1852,57,28,29
25,12,1153,19,12,7
25,12,1519,54,29,25
25,12,685,0,0,0
25,12,1523,7,3,4
25,12,1093,2,0,2
25,12,2149,91,47,44
25,12,981,15,5,10
25,12,1154,3,0,3
25,12,1583,7,3,4
25,12,1462,44,23,21
25,12,862,25,11,14
25,12,574,7,3,4
25,12,857,0,0,0
25,12,1080,7,3,4
25,12,1070,4,2,2
25,12,802,0,0,0
25,12,1107,0,0,0
25,12,889,3,1,2
25,12,650,8,2,6
25,12,1078,0,0,0
25,12,2047,13,5,8
25,12,1958,4,2,2
25,12,1571,6,3,3
25,12,1183,7,3,4
25,12,1963,331,163,168
25,12,2142,14,8,6
25,12,843,17,11,6
25,12,1623,12,6,6
25,12,944,9,4,5
25,12,740,20,12,8
25,12,1256,5,1,4
25,12,980,4,2,2
25,12,1901,78,39,39
25,12,1398,15,6,9
25,12,1862,21,10,11
25,12,1324,5,1,4
25,12,1163,2,0,2
25,12,977,7,4,3
25,12,1354,15,10,5
25,12,674,4,0,4
25,12,1201,48,25,23
25,12,555,9,5,4
25,6,1183,57,30,27
25,6,981,23,10,13
25,6,3706,57,28,29
25,6,1273,14,10,4
25,6,5143,41,23,18
25,6,4368,21,11,10
25,6,727,0,0,0
25,6,3384,18,9,9
25,6,4912,23,9,14
25,6,3478,6,3,3
25,1,4558,29,17,12
25,1,4452,60,34,26
25,1,3680,34,14,20
25,1,1284,26,12,14
25,1,4605,51,30,21
25,1,5480,20,9,11
25,1,2053,26,18,8
25,1,3270,15,7,8
25,1,1533,1,0,1
25,1,4850,32,18,14
25,1,1504,17,4,13
25,1,1356,3,2,1
25,1,5214,102,53,49
25,1,4261,19,10,9
25,1,786,20,12,8
25,1,3561,16,6,10
25,1,1094,6,1,5
25,1,1395,19,10,9
25,1,2064,24,13,11
25,1,3745,8,5,3
25,1,849,9,4,5
25,1,1468,8,3,5
25,1,1433,1,0,1
25,1,5060,35,17,18
25,1,1091,1,1,0
25,1,3748,10,4,6
25,1,5052,6,3,3
25,1,2686,6,2,4
25,1,4450,22,9,13
25,1,5287,44,24,20
25,1,1458,2,1,1
25,1,3630,29,11,18
25,1,2716,50,23,27
25,1,3745,18,12,6
25,1,5360,37,19,18
25,1,2068,8,6,2
25,1,3874,26,10,16
25,1,4910,32,15,17
25,1,1746,13,4,9
25,1,3712,10,5,5
25,1,1955,57,28,29
25,1,1050,5,3,2
26,1,1644,18,8,10
26,1,919,2,2,0
26,2,1416,11,3,8
26,2,643,0,0,0
26,2,487,0,0,0
26,2,1744,12,5,7
26,2,1383,22,9,13
26,2,3224,7,4,3
26,2,3805,10,7,3
26,2,3712,8,1,7
26,2,1105,10,8,2
26,2,1035,1,0,1
26,2,925,11,6,5
26,2,2810,23,11,12
26,2,693,4,0,4
26,2,401,0,0,0
26,2,12122,177,83,94
26,2,2185,26,9,17
26,2,3684,9,7,2
26,2,5714,23,16,7
26,2,1490,13,5,8
26,2,8238,27,10,17
26,2,9950,55,29,26
26,2,10563,88,38,50
26,2,1880,10,4,6
26,2,7646,25,15,10
26,2,55,0,0,0
26,2,150,1,0,1
26,2,346,3,1,2
26,2,4216,8,2,6
26,2,307,9,3,6
26,3,1586,11,3,8
26,3,2698,26,13,13
26,3,419,3,2,1
26,4,673,4,1,3
26,4,392,1,0,1
26,4,112,1,1,0
26,5,808,1,0,1
26,5,1047,1,1,0
26,5,407,0,0,0
26,5,274,3,1,2
26,5,256,0,0,0
26,6,633,1,1,0
26,7,979,0,0,0
26,8,510,2,1,1
26,8,154,0,0,0
26,8,95,0,0,0
26,9,1221,3,0,3
26,10,1124,5,1,4
26,10,351,6,3,3
26,11,1023,2,1,1
26,11,606,2,0,2
26,12,905,0,0,0
26,12,909,0,0,0
26,12,304,1,0,1
26,12,93,0,0,0
26,12,250,0,0,0
26,12,715,2,2,0
26,13,852,0,0,0
26,13,317,0,0,0
26,14,1305,5,0,5
26,14,1310,5,3,2
26,14,1356,5,2,3
26,14,1012,3,2,1
26,15,1212,11,4,7
26,15,1548,7,2,5
26,15,1850,22,14,8
26,15,3586,21,9,12
26,15,2826,27,16,11
26,15,11502,123,67,56
26,15,964,2,2,0
26,15,926,70,38,32
26,15,1149,3,0,3
26,15,841,1,1,0
26,15,785,5,1,4
26,15,1194,19,10,9
26,15,1915,5,3,2
26,15,5171,19,7,12
26,15,1907,9,4,5
26,15,706,1,0,1
26,15,311,0,0,0
26,15,352,1,0,1
26,15,676,3,2,1
26,16,883,4,2,2
26,17,419,2,1,1
26,17,1316,3,1,2
26,17,1407,0,0,0
26,17,105,0,0,0
26,17,1169,11,7,4
26,17,610,1,0,1
26,17,329,2,1,1
26,17,478,1,0,1
26,18,753,0,0,0
26,19,1045,4,2,2
26,19,181,5,1,4
26,19,3585,8,1,7
26,19,1791,6,1,5
26,19,2453,12,4,8
26,20,1031,1,0,1
26,21,846,0,0,0
26,21,342,0,0,0
26,22,866,2,1,1
26,23,1014,3,1,2
26,23,123,0,0,0
26,24,2267,13,8,5
26,24,3300,8,6,2
26,24,989,10,5,5
26,24,2670,66,36,30
26,24,2232,15,7,8
26,24,420,3,1,2
26,24,391,18,10,8
26,24,372,36,15,21
26,25,3148,23,13,10
26,25,1241,1,0,1
26,25,1668,0,0,0
26,25,4090,34,15,19
26,25,1045,2,1,1
26,25,1876,9,3,6
26,25,2426,18,8,10
26,25,4184,52,26,26
26,25,4553,38,14,24
26,25,2840,18,5,13
26,25,2385,6,2,4
26,25,325,57,24,33
26,25,349,5,2,3
26,25,2430,54,23,31
26,25,444,3,1,2
26,26,2541,6,2,4
26,26,1052,6,3,3
26,26,1448,4,3,1
26,26,132,0,0,0
26,27,848,11,4,7
26,27,594,6,2,4
26,27,1620,7,5,2
26,27,2707,25,15,10
26,28,1053,1,0,1
26,28,476,0,0,0
26,29,1384,9,4,5
26,29,2359,58,33,25
26,29,1920,3,1,2
26,29,1380,2,0,2
26,29,1398,0,0,0
26,29,985,4,1,3
26,29,850,0,0,0
26,29,2860,31,15,16
26,29,858,5,2,3
26,29,349,0,0,0
26,30,1129,6,4,2
26,30,238,2,1,1
26,30,706,6,1,5
26,30,1791,13,5,8
26,30,2188,10,3,7
26,30,2579,9,6,3
26,30,1465,26,10,16
26,30,747,18,8,10
26,30,1096,17,6,11
26,30,464,0,0,0
26,30,443,3,1,2
26,30,885,4,1,3
26,30,1855,45,24,21
26,30,1450,10,4,6
26,30,954,20,11,9
26,30,860,13,3,10
26,30,2191,16,9,7
26,30,760,9,5,4
26,30,373,21,10,11
26,30,1132,28,12,16
26,30,1670,44,18,26
26,30,2756,15,6,9
26,30,1020,3,3,0
26,30,1356,21,8,13
26,30,869,14,8,6
26,30,1580,13,6,7
26,30,2654,19,7,12
26,30,1110,15,10,5
26,30,3126,29,19,10
26,30,1436,6,2,4
26,30,874,1,1,0
26,30,594,10,3,7
26,30,1287,9,5,4
26,30,3300,54,28,26
26,30,2542,40,22,18
26,30,2094,24,14,10
26,30,1095,8,2,6
26,30,870,18,12,6
26,30,468,3,0,3
26,30,994,4,2,2
26,30,2419,26,8,18
26,30,1114,12,6,6
26,30,1374,13,5,8
26,30,1083,10,6,4
26,30,930,3,2,1
26,30,1602,60,35,25
26,30,5550,224,118,106
26,30,5586,55,36,19
26,30,4651,24,11,13
26,30,1388,1,0,1
26,30,1654,4,1,3
26,30,1984,29,14,15
26,30,1414,33,16,17
26,30,1142,15,6,9
26,30,1258,15,9,6
26,30,13655,177,89,88
26,30,2814,23,13,10
26,30,5208,39,18,21
26,30,18281,291,146,145
26,30,1907,38,20,18
26,30,1269,16,8,8
26,30,3378,17,11,6
26,30,8957,68,36,32
26,30,6698,37,14,23
26,30,14476,91,44,47
26,30,1359,6,3,3
26,30,1764,20,6,14
26,30,759,4,2,2
26,30,1132,13,6,7
26,30,68,0,0,0
26,30,1749,10,6,4
26,31,498,0,0,0
26,32,1660,0,0,0
26,32,420,1,0,1
26,32,1680,8,5,3
26,32,197,0,0,0
26,32,148,1,0,1
26,32,136,3,2,1
26,32,329,1,0,1
26,32,413,0,0,0
26,32,125,0,0,0
26,32,149,0,0,0
26,33,369,1,1,0
26,34,537,2,2,0
26,35,1056,3,3,0
26,35,43,0,0,0
26,35,354,8,3,5
26,36,629,18,13,5
26,36,1192,0,0,0
26,36,1663,13,6,7
26,36,4773,12,9,3
26,36,989,21,11,10
26,36,1850,5,3,2
26,36,178,1,1,0
26,36,446,0,0,0
26,36,967,29,12,17
26,36,828,1,1,0
26,36,1357,3,3,0
26,36,1381,3,3,0
26,37,1840,4,3,1
26,38,1066,0,0,0
26,38,1003,6,3,3
26,39,155,2,0,2
26,39,321,1,0,1
26,39,297,2,2,0
26,39,162,0,0,0
26,39,393,0,0,0
26,40,1106,2,1,1
26,41,787,1,1,0
26,41,400,1,0,1
26,42,1102,2,2,0
26,42,393,2,1,1
26,43,337,1,0,1
26,43,124,0,0,0
26,43,169,0,0,0
26,43,731,0,0,0
26,44,532,0,0,0
26,44,652,2,0,2
26,44,253,0,0,0
26,45,535,0,0,0
26,45,252,0,0,0
26,45,300,0,0,0
26,46,3693,8,6,2
26,46,1290,9,4,5
26,46,3420,36,18,18
26,46,6563,82,25,57
26,46,4186,110,56,54
26,46,8850,70,28,42
26,46,2911,34,19,15
26,46,1471,8,2,6
26,46,1054,17,9,8
26,46,696,8,3,5
26,46,901,1,1,0
26,46,1590,18,8,10
26,46,1503,13,5,8
26,46,323,6,3,3
26,46,82,0,0,0
26,46,36,0,0,0
26,46,1977,4,2,2
26,46,791,5,1,4
26,46,2700,10,3,7
26,46,6065,34,18,16
26,46,605,1,1,0
26,46,3165,18,9,9
26,46,2092,8,4,4
26,46,698,2,0,2
26,46,1388,2,1,1
26,46,1671,8,3,5
26,46,6935,509,255,254
26,46,3492,3,2,1
26,46,1456,2,1,1
26,46,2421,1,1,0
26,46,1513,7,6,1
26,46,1826,9,4,5
26,46,729,11,5,6
26,46,1976,22,8,14
26,46,7234,76,15,61
26,46,571,2,1,1
26,47,3552,45,23,22
26,47,1397,27,15,12
26,48,466,4,1,3
26,48,789,19,6,13
26,48,156,2,0,2
26,48,273,3,1,2
26,48,159,0,0,0
26,49,8834,1411,720,691
26,49,5030,76,35,41
26,49,8688,105,46,59
26,49,4869,213,98,115
26,49,13070,368,183,185
26,49,25757,226,107,119
26,49,6217,45,20,25
26,49,7843,422,223,199
26,49,9014,117,53,64
26,49,3829,24,18,6
26,49,1183,4,4,0
26,49,2795,110,57,53
26,49,1521,15,7,8
26,49,1208,6,3,3
26,49,2586,75,36,39
26,49,2940,28,14,14
26,49,1266,5,4,1
26,49,1468,47,25,22
26,49,1382,40,19,21
26,49,1292,21,11,10
26,49,2001,97,45,52
26,49,1758,4,3,1
26,49,5398,66,38,28
26,49,2371,60,32,28
26,49,1079,1,1,0
26,49,1678,11,6,5
26,49,814,3,1,2
26,49,1459,21,13,8
26,49,1728,41,20,21
26,49,1664,4,4,0
26,49,2334,155,73,82
26,49,935,0,0,0
26,49,1469,3,2,1
26,49,1484,3,2,1
26,49,1161,12,3,9
26,49,1382,59,31,28
26,49,1685,23,8,15
26,49,15743,151,74,77
26,49,3272,35,19,16
26,49,2714,38,17,21
26,49,1533,6,2,4
26,49,1461,20,8,12
26,49,1539,35,17,18
26,49,1756,10,4,6
26,49,1292,19,11,8
26,49,1589,22,9,13
26,49,759,1,0,1
26,49,2151,27,14,13
26,49,1518,58,29,29
26,49,1825,33,21,12
26,49,1944,41,19,22
26,49,1039,19,7,12
26,49,1222,15,5,10
26,49,1883,16,7,9
26,49,850,21,6,15
26,49,1713,10,8,2
26,49,1987,3,2,1
26,49,1451,4,3,1
26,49,982,35,17,18
26,49,1402,6,0,6
26,49,1310,84,39,45
26,49,1282,7,6,1
26,49,1309,8,6,2
26,49,2610,16,7,9
26,49,2333,9,6,3
26,49,3251,63,29,34
26,49,1784,55,25,30
26,49,1218,12,6,6
26,49,871,4,2,2
26,49,1202,8,5,3
26,49,1015,14,9,5
26,49,1154,5,5,0
26,49,1360,4,0,4
26,49,1393,5,5,0
26,49,1350,10,4,6
26,49,798,17,10,7
26,49,3064,89,40,49
26,49,2276,95,52,43
26,49,6377,57,20,37
26,49,1275,28,12,16
26,49,859,1,0,1
26,49,1332,10,3,7
26,49,986,5,3,2
26,49,1200,42,21,21
26,49,1206,43,21,22
26,49,639,12,8,4
26,49,1085,5,2,3
26,49,1192,14,4,10
26,49,1572,27,15,12
26,49,1297,8,2,6
26,49,1967,139,71,68
26,49,3037,34,20,14
26,49,3479,173,87,86
26,49,2258,484,250,234
26,49,2138,44,24,20
26,49,1028,8,5,3
26,49,1318,22,9,13
26,49,1372,45,16,29
26,49,820,27,12,15
26,49,641,7,5,2
26,49,770,4,3,1
26,49,1334,46,22,24
26,49,1511,0,0,0
26,49,1020,276,149,127
26,49,918,10,4,6
26,49,1207,13,7,6
26,49,995,7,5,2
26,49,1201,6,2,4
26,49,660,1,0,1
26,49,715,9,2,7
26,49,1033,40,22,18
26,49,4177,101,48,53
26,49,5251,66,27,39
26,49,1262,18,9,9
26,49,1417,8,2,6
26,49,1364,12,5,7
26,49,750,1,1,0
26,49,977,21,10,11
26,49,565,7,1,6
26,49,1990,28,13,15
26,49,820,8,4,4
26,49,732,3,1,2
26,49,931,23,12,11
26,49,956,20,7,13
26,49,889,3,1,2
26,49,701,7,3,4
26,49,1397,0,0,0
26,49,1074,3,0,3
26,49,1338,8,4,4
26,49,673,0,0,0
26,49,874,1,1,0
26,49,1172,6,3,3
26,49,375,19,9,10
26,49,572,13,10,3
26,49,1381,35,19,16
26,49,1136,17,6,11
26,49,1459,16,7,9
26,49,5220,40,19,21
26,49,961,29,12,17
26,49,1142,19,10,9
26,49,981,18,8,10
26,49,729,13,5,8
26,49,561,11,3,8
26,49,554,1,0,1
26,49,741,3,1,2
26,49,1001,7,3,4
26,49,696,6,1,5
26,49,1905,9,5,4
26,49,1542,1,0,1
26,49,1840,449,235,214
26,49,1764,4,1,3
26,49,1127,12,4,8
26,49,1271,17,9,8
26,49,1168,5,3,2
26,49,808,8,4,4
26,49,935,8,3,5
26,49,1139,90,51,39
26,49,747,4,0,4
26,49,1297,11,5,6
26,49,1973,27,12,15
26,49,395,0,0,0
26,49,1751,46,21,25
26,49,2414,56,27,29
26,49,963,14,7,7
26,49,1965,15,6,9
26,49,927,0,0,0
26,49,1230,9,5,4
26,49,1037,2,1,1
26,49,1352,19,13,6
26,49,1194,5,1,4
26,49,405,0,0,0
26,49,1389,22,11,11
26,49,2023,33,16,17
26,49,1499,14,8,6
26,49,960,10,3,7
26,49,1631,9,7,2
26,49,1333,2,0,2
26,49,3021,27,10,17
26,49,371,12,7,5
26,49,384,5,2,3
26,49,982,13,6,7
26,49,773,10,3,7
26,49,797,2,1,1
26,49,871,11,4,7
26,49,753,5,4,1
26,49,1152,21,11,10
26,49,590,6,4,2
26,49,6239,88,50,38
26,49,945,156,81,75
26,49,565,28,16,12
26,49,806,5,2,3
26,49,919,0,0,0
26,49,1140,21,13,8
26,49,769,5,1,4
26,49,1147,16,8,8
26,49,24560,406,188,218
26,49,13084,54,14,40
26,49,1560,16,9,7
26,49,1239,3,1,2
26,49,2202,30,17,13
26,49,2595,68,36,32
26,49,1612,33,14,19
26,49,1334,7,6,1
26,49,658,25,13,12
26,49,1443,9,2,7
26,49,692,3,1,2
26,49,1176,0,0,0
26,49,2104,23,13,10
26,49,1288,16,9,7
26,49,666,6,3,3
26,49,979,6,3,3
26,49,942,6,3,3
26,49,842,23,13,10
26,49,874,12,7,5
26,49,880,11,7,4
26,49,974,9,5,4
26,49,903,16,10,6
26,49,3212,34,13,21
26,49,1585,5,2,3
26,49,1340,11,5,6
26,49,878,4,1,3
26,49,10888,66,26,40
26,49,1509,0,0,0
26,49,1072,4,1,3
26,49,981,3,2,1
26,49,1608,26,14,12
26,49,1137,10,5,5
26,49,15261,175,79,96
26,49,2699,113,64,49
26,49,1302,21,11,10
26,49,1683,27,13,14
26,49,3171,20,10,10
26,49,12748,124,70,54
26,49,2474,8,6,2
26,49,23107,1340,680,660
26,49,886,6,3,3
26,49,930,21,13,8
26,49,1141,30,10,20
26,49,1728,27,17,10
26,49,1085,34,19,15
26,49,7798,194,86,108
26,49,956,19,5,14
26,49,1596,53,30,23
26,49,1892,2,1,1
26,49,1980,23,13,10
26,49,2351,18,7,11
26,49,2274,28,9,19
26,49,1971,110,58,52
26,49,240,9,4,5
26,49,5926,104,53,51
26,49,14932,399,192,207
26,49,1429,51,18,33
26,49,6321,45,19,26
26,49,1138,14,7,7
26,49,3436,98,6,92
26,49,6291,42,17,25
26,49,5171,238,113,125
26,49,877,14,6,8
26,49,18176,131,60,71
26,49,2109,6,0,6
26,49,2950,277,126,151
26,49,5103,199,89,110
26,49,6810,30,13,17
26,49,1380,0,0,0
26,49,668,29,3,26
26,49,1126,12,3,9
26,49,635,26,4,22
26,49,645,1,0,1
26,49,390,2,1,1
26,49,1213,23,8,15
26,49,1373,58,32,26
26,49,1405,3,0,3
26,49,977,14,5,9
26,50,1118,17,11,6
26,51,374,2,2,0
26,51,1234,205,107,98
26,51,441,32,11,21
26,51,178,13,5,8
26,51,180,5,3,2
26,52,2705,24,10,14
26,52,1112,2,1,1
26,52,2783,27,14,13
26,52,493,137,61,76
26,53,3718,26,12,14
26,53,5495,35,14,21
26,53,1140,2,1,1
26,53,8356,28,9,19
26,53,1453,12,6,6
26,53,1738,10,4,6
26,53,1244,13,4,9
26,53,23274,2060,1011,1049
26,53,1052,3,2,1
26,53,846,5,4,1
26,53,997,14,4,10
26,53,1295,18,9,9
26,53,1554,2,1,1
26,53,5338,39,17,22
26,53,1378,5,1,4
26,53,1444,1,1,0
26,53,115,0,0,0
26,53,2258,41,17,24
26,54,303,0,0,0
26,54,1195,1,0,1
26,55,880,3,1,2
26,55,141,4,3,1
26,55,265,11,3,8
26,55,504,14,9,5
26,55,821,13,8,5
26,55,650,2,1,1
26,55,933,1,0,1
26,55,849,8,2,6
26,55,1013,1,0,1
26,55,18028,200,99,101
26,55,568,38,20,18
26,55,188,3,2,1
26,55,690,7,2,5
26,55,683,5,3,2
26,55,1240,8,2,6
26,55,1031,9,3,6
26,55,1428,6,1,5
26,55,1786,7,4,3
26,55,5296,157,80,77
26,55,334,11,3,8
26,55,646,8,3,5
26,55,714,2,2,0
26,55,601,12,5,7
26,55,567,1,0,1
26,55,866,1,1,0
26,55,1266,8,4,4
26,55,1126,5,2,3
26,55,1188,15,11,4
26,55,1881,101,55,46
26,55,3123,48,23,25
26,55,432,4,2,2
26,55,1469,1,1,0
26,55,953,0,0,0
26,55,1271,37,17,20
26,55,583,11,6,5
26,55,769,2,1,1
26,55,1054,31,14,17
26,55,876,3,1,2
26,55,1123,3,0,3
26,55,622,9,4,5
26,55,974,5,3,2
26,55,891,8,3,5
26,55,1092,87,43,44
26,55,1260,24,10,14
26,55,2785,13,2,11
26,55,1006,13,7,6
26,55,882,12,4,8
26,55,861,3,1,2
26,55,990,3,0,3
26,55,3329,12,3,9
26,55,1661,44,17,27
26,55,1746,11,7,4
26,55,2063,20,12,8
26,55,1810,2,0,2
26,55,1731,1,0,1
26,55,1327,13,6,7
26,55,1155,8,3,5
26,55,1415,9,6,3
26,55,5271,46,24,22
26,55,4236,31,17,14
26,55,893,9,3,6
26,55,1737,15,5,10
26,55,1601,2,1,1
26,55,1331,3,0,3
26,55,1010,4,2,2
26,55,967,8,3,5
26,55,2298,6,1,5
26,55,3556,18,11,7
26,55,1001,6,4,2
26,55,3200,9,5,4
26,55,1769,5,3,2
26,55,5385,86,42,44
26,55,8371,88,41,47
26,55,1450,5,3,2
26,55,1275,4,0,4
26,55,1577,12,8,4
26,55,3100,20,7,13
26,55,19476,111,54,57
26,55,15533,182,86,96
26,55,959,632,301,331
26,55,2685,217,121,96
26,55,3148,352,178,174
26,55,715,9,4,5
26,55,266,2,0,2
26,55,358,7,3,4
26,55,8598,43,15,28
26,55,2155,13,5,8
26,55,252,13,6,7
26,55,2095,3,0,3
26,55,2668,8,5,3
26,55,4641,16,7,9
26,56,458,0,0,0
26,56,177,0,0,0
26,56,387,1,0,1
26,56,9720,44,20,24
26,57,1311,18,7,11
26,57,1311,21,13,8
26,57,1093,4,0,4
26,57,1490,9,2,7
26,57,186,0,0,0
26,57,304,4,1,3
26,57,1072,0,0,0
26,57,438,0,0,0
26,57,358,0,0,0
26,57,546,1,0,1
26,57,223,0,0,0
26,57,95,0,0,0
26,57,108,0,0,0
26,58,1717,40,23,17
26,58,2613,9,3,6
26,58,2675,11,8,3
26,58,638,4,1,3
26,58,825,2,1,1
26,58,2924,15,5,10
26,58,1441,1,0,1
26,58,1737,14,7,7
26,58,3242,32,18,14
26,58,1419,9,5,4
26,58,1321,4,2,2
26,58,1580,3,1,2
26,58,1029,1,1,0
26,59,2334,15,8,7
26,59,684,6,3,3
26,59,1224,2,2,0
26,59,1441,8,3,5
26,59,2396,46,22,24
26,59,1440,11,5,6
26,59,1305,4,2,2
26,59,8449,114,64,50
26,59,921,1,0,1
26,59,1279,0,0,0
26,59,1557,1,0,1
26,59,944,9,6,3
26,59,1459,0,0,0
26,59,6561,85,44,41
26,59,1261,27,11,16
26,59,963,0,0,0
26,59,1235,7,2,5
26,59,1253,12,2,10
26,59,645,0,0,0
26,59,1058,7,3,4
26,59,923,12,3,9
26,59,7160,272,140,132
26,59,1416,9,6,3
26,59,1206,3,1,2
26,59,715,0,0,0
26,59,1421,17,6,11
26,59,588,4,2,2
26,59,652,0,0,0
26,59,467,3,3,0
26,59,670,2,1,1
26,59,781,9,5,4
26,59,834,2,2,0
26,59,574,5,3,2
26,59,1487,16,3,13
26,59,18458,147,75,72
26,59,684,0,0,0
26,59,1071,3,1,2
26,59,841,53,23,30
26,59,1183,5,2,3
26,59,792,11,11,0
26,59,1292,7,5,2
26,59,601,17,10,7
26,59,589,5,0,5
26,59,487,1,1,0
26,59,299,0,0,0
26,59,167,0,0,0
26,59,684,12,7,5
26,59,212,0,0,0
26,59,2960,16,9,7
26,59,899,6,3,3
26,59,490,4,1,3
26,59,289,1,0,1
26,59,589,0,0,0
26,59,549,1,1,0
26,59,394,1,0,1
26,59,172,2,1,1
26,59,2224,3,3,0
26,59,969,4,0,4
26,59,645,3,2,1
26,59,890,6,3,3
26,59,416,0,0,0
26,59,412,0,0,0
26,59,349,2,1,1
26,59,739,1,0,1
26,59,1012,3,2,1
26,59,500,0,0,0
26,59,328,1,0,1
26,59,638,28,13,15
26,59,1820,121,56,65
26,59,1385,7,2,5
26,59,1213,14,8,6
26,59,860,9,3,6
26,59,921,6,2,4
26,59,649,3,0,3
26,59,1023,8,4,4
26,59,1006,14,7,7
26,59,508,2,2,0
26,59,679,0,0,0
26,59,703,2,2,0
26,59,827,0,0,0
26,59,690,2,0,2
26,59,975,3,1,2
26,59,1048,13,8,5
26,59,6834,34,18,16
26,59,5645,206,105,101
26,59,753,1,1,0
26,59,649,6,1,5
26,59,1115,3,2,1
26,59,1097,15,6,9
26,59,890,7,1,6
26,59,754,5,3,2
26,59,800,2,1,1
26,59,1490,12,8,4
26,59,1055,2,1,1
26,59,642,9,4,5
26,59,856,14,6,8
26,59,780,11,3,8
26,59,1063,3,1,2
26,59,959,1,0,1
26,59,829,3,1,2
26,59,661,13,7,6
26,59,1146,8,4,4
26,59,830,0,0,0
26,59,1045,1,1,0
26,59,636,0,0,0
26,59,795,4,2,2
26,59,996,0,0,0
26,59,1217,174,80,94
26,59,1198,483,255,228
26,59,1752,11,4,7
26,59,1930,7,3,4
26,59,1000,0,0,0
26,59,760,0,0,0
26,59,12634,66,29,37
26,59,2528,4,4,0
26,59,1412,8,3,5
26,59,1263,10,5,5
26,59,755,6,1,5
26,59,860,3,1,2
26,59,792,6,4,2
26,59,1392,3,2,1
26,59,973,18,8,10
26,59,1496,1,1,0
26,59,1748,6,5,1
26,59,966,9,2,7
26,59,1230,0,0,0
26,59,777,6,3,3
26,59,7570,38,23,15
26,59,1014,4,2,2
26,59,2662,6,6,0
26,59,3639,31,18,13
26,59,1171,1,0,1
26,59,2002,16,11,5
26,59,3075,30,18,12
26,59,2428,4,2,2
26,59,2370,2,0,2
26,59,6101,29,13,16
26,59,7287,63,31,32
26,59,6475,40,20,20
26,59,1172,2,2,0
26,59,828,6,3,3
26,59,4046,22,13,9
26,59,5927,104,54,50
26,59,875,36,25,11
26,59,856,64,38,26
26,59,2835,22,14,8
26,59,3135,58,35,23
26,59,1226,4,3,1
26,59,1325,10,8,2
26,59,946,19,9,10
26,59,1790,4,2,2
26,59,1078,14,9,5
26,59,1077,0,0,0
26,59,969,0,0,0
26,59,2003,8,5,3
26,59,1248,1,0,1
26,59,1878,7,4,3
26,59,1058,1,0,1
26,59,1133,2,2,0
26,59,323,1,1,0
26,59,583,3,1,2
26,59,808,3,2,1
26,59,2979,10,4,6
26,59,2100,3,2,1
26,59,891,3,1,2
26,59,1605,2,0,2
26,59,1556,1,0,1
26,59,1114,6,2,4
26,59,1965,24,13,11
26,59,1248,14,7,7
26,59,887,1,0,1
26,59,4182,14,3,11
26,59,880,0,0,0
26,59,1332,1,1,0
26,59,1445,34,13,21
26,59,7453,38,21,17
26,59,972,2,1,1
26,59,20875,116,58,58
26,59,2782,16,6,10
26,59,422,0,0,0
26,59,2594,17,10,7
26,59,1027,2,0,2
26,59,22915,328,160,168
26,59,1358,1,1,0
26,59,1501,6,3,3
26,59,1063,2,0,2
26,59,1441,1,1,0
26,59,1396,6,4,2
26,59,1379,26,10,16
26,59,1671,25,12,13
26,59,1963,7,3,4
26,59,1103,10,6,4
26,59,3183,6,2,4
26,59,1895,5,4,1
26,59,1134,2,2,0
26,59,1173,1,0,1
26,59,875,9,3,6
26,59,1758,7,2,5
26,59,1088,4,2,2
26,59,1433,0,0,0
26,59,2419,2,2,0
26,59,1565,10,4,6
26,59,3522,5,3,2
26,59,1882,0,0,0
26,59,1608,0,0,0
26,59,950,0,0,0
26,59,1087,8,2,6
26,59,1081,7,4,3
26,59,973,1,1,0
26,59,1297,7,1,6
26,59,750,2,1,1
26,59,735,3,1,2
26,59,1399,0,0,0
26,59,1081,13,8,5
26,59,513,3,1,2
26,59,338,1,0,1
26,59,410,0,0,0
26,59,2618,2,0,2
26,60,1785,3,3,0
26,60,1238,18,10,8
26,60,1570,11,5,6
26,60,1389,10,5,5
26,60,1765,8,6,2
26,60,1438,4,2,2
26,60,7550,65,28,37
26,60,5590,44,15,29
26,60,1822,21,11,10
26,60,1099,11,6,5
26,60,884,12,5,7
26,60,1063,18,11,7
26,60,1507,16,10,6
26,60,1015,1,0,1
26,60,1567,9,3,6
26,60,1221,3,2,1
26,60,778,4,4,0
26,60,834,12,8,4
26,60,956,6,3,3
26,60,844,6,3,3
26,60,780,4,2,2
26,60,1339,11,7,4
26,60,1391,7,3,4
26,60,3325,19,6,13
26,60,2070,2,2,0
26,60,2355,17,9,8
26,60,455,3,2,1
26,60,598,2,1,1
26,60,1907,3,1,2
26,60,1513,3,3,0
26,61,1026,8,6,2
26,61,715,2,2,0
26,61,766,2,1,1
26,61,785,2,1,1
26,61,1309,15,6,9
26,61,930,3,2,1
26,61,237,1,0,1
26,61,857,5,2,3
26,61,1582,17,9,8
26,61,1014,3,1,2
26,61,1277,3,2,1
26,61,856,6,5,1
26,61,888,5,2,3
26,61,977,4,4,0
26,61,629,4,4,0
26,61,848,5,2,3
26,61,930,3,1,2
26,61,3678,49,23,26
26,61,1949,10,2,8
26,61,2138,1,0,1
26,61,2565,19,10,9
26,61,3254,15,6,9
26,61,1082,6,2,4
26,61,1156,26,14,12
26,61,1064,2,0,2
26,61,614,19,13,6
26,61,563,5,3,2
26,61,1199,2,0,2
26,61,376,0,0,0
26,61,634,0,0,0
26,61,769,20,7,13
26,61,512,1,0,1
26,61,887,0,0,0
26,61,588,1,0,1
26,61,2533,16,6,10
26,61,3307,49,21,28
26,61,1332,1,1,0
26,61,509,4,2,2
26,61,850,2,0,2
26,61,537,3,3,0
26,61,848,5,2,3
26,61,683,3,3,0
26,61,1336,13,5,8
26,61,999,6,3,3
26,61,1403,2,1,1
26,61,4565,53,27,26
26,61,1106,15,13,2
26,61,919,7,4,3
26,61,1288,2,0,2
26,61,1631,25,19,6
26,61,959,18,10,8
26,61,2011,5,3,2
26,61,3002,45,22,23
26,61,1587,4,3,1
26,61,4806,26,13,13
26,61,936,21,6,15
26,61,1057,40,18,22
26,61,3543,80,36,44
26,61,2244,10,7,3
26,61,1454,5,1,4
26,61,555,6,3,3
26,61,869,10,5,5
26,61,1959,1,1,0
26,61,2299,0,0,0
26,61,4662,62,33,29
26,61,2169,6,4,2
26,61,3236,12,7,5
26,61,2286,8,3,5
26,61,1439,16,11,5
26,61,2663,7,5,2
26,61,1262,5,3,2
26,61,4155,8,3,5
26,61,4540,3,0,3
26,61,1217,0,0,0
26,61,1828,8,2,6
26,72,832,4,2,2
26,72,3684,3,0,3
26,72,991,2,0,2
26,72,947,4,1,3
26,72,2543,2,0,2
26,72,1534,10,7,3
26,72,3182,3,1,2
26,72,784,4,0,4
26,62,6497,17,7,10
26,62,2129,8,3,5
26,62,1370,2,1,1
26,62,1385,2,1,1
26,62,683,6,3,3
26,62,825,3,3,0
26,62,1207,56,26,30
26,62,155,0,0,0
26,62,314,3,2,1
26,62,470,0,0,0
26,62,261,0,0,0
26,62,269,2,0,2
26,62,610,1,1,0
26,62,829,0,0,0
26,62,1419,0,0,0
26,62,776,24,12,12
26,62,127,0,0,0
26,62,250,0,0,0
26,62,314,0,0,0
26,62,150,0,0,0
26,62,968,106,46,60
26,62,800,36,18,18
26,62,533,0,0,0
26,62,567,0,0,0
26,62,560,170,69,101
26,62,533,86,37,49
26,62,221,0,0,0
26,62,431,74,32,42
26,63,2230,4,3,1
26,63,726,5,2,3
26,63,1884,15,9,6
26,63,2673,2,1,1
26,71,1769,5,3,2
26,63,282,0,0,0
26,63,192,0,0,0
26,63,1252,1,0,1
26,71,1203,33,24,9
26,71,2756,6,3,3
26,71,1876,19,10,9
26,71,1214,1,0,1
26,71,1665,8,6,2
26,71,1891,15,7,8
26,71,2047,8,2,6
26,63,1725,1,0,1
26,63,305,0,0,0
26,71,2411,754,359,395
26,71,3521,139,64,75
26,71,524,1,0,1
26,63,1668,12,5,7
26,63,2085,2,0,2
26,63,1208,8,2,6
26,63,1546,9,3,6
26,63,1407,0,0,0
26,63,1210,1,0,1
26,63,1113,0,0,0
26,63,1445,21,12,9
26,63,1547,15,9,6
26,63,1200,16,4,12
26,63,2027,3,1,2
26,63,900,7,2,5
26,63,1032,4,2,2
26,63,1991,10,5,5
26,63,627,8,3,5
26,63,323,1,1,0
26,63,2516,1,1,0
26,63,818,0,0,0
26,63,867,0,0,0
26,63,2238,5,3,2
26,63,718,4,0,4
26,63,910,12,4,8
26,63,2317,20,9,11
26,63,2817,17,5,12
26,63,1901,1,1,0
26,63,2763,4,2,2
26,63,3151,3,1,2
26,63,1049,4,1,3
26,63,2242,745,389,356
26,63,1971,12,5,7
26,63,2624,11,6,5
26,64,2183,89,45,44
26,64,3627,21,13,8
26,64,1075,161,82,79
26,64,1300,33,21,12
26,64,916,6,4,2
26,64,948,21,8,13
26,64,4437,19,10,9
26,64,554,12,7,5
26,64,1606,8,2,6
26,64,897,8,1,7
26,64,2069,4,2,2
26,64,912,2,1,1
26,64,2454,16,7,9
26,64,1470,0,0,0
26,64,4453,20,12,8
26,64,1046,3,2,1
26,64,1434,8,3,5
26,64,1610,27,15,12
26,64,1400,9,6,3
26,64,1710,0,0,0
26,64,2160,11,1,10
26,64,1436,2,0,2
26,64,2529,18,9,9
26,64,2290,7,3,4
26,64,1941,18,10,8
26,64,1689,3,2,1
26,64,1835,7,4,3
26,64,3403,16,6,10
26,64,3114,2,2,0
26,64,3204,1,1,0
26,64,1249,1,1,0
26,64,792,0,0,0
26,64,2881,2,1,1
26,64,1733,6,5,1
26,64,729,0,0,0
26,64,1076,4,3,1
26,64,1467,0,0,0
26,64,2073,19,9,10
26,64,486,0,0,0
26,64,2983,2,0,2
26,64,2275,12,3,9
26,65,4152,9,4,5
26,65,861,7,5,2
26,65,1230,6,4,2
26,65,764,8,3,5
26,65,1346,3,2,1
26,65,1479,22,13,9
26,65,1830,68,36,32
26,65,1553,33,20,13
26,65,1070,29,12,17
26,65,2015,18,11,7
26,65,342,8,5,3
26,65,438,8,6,2
26,65,616,1,0,1
26,65,3477,16,7,9
26,65,1831,11,6,5
26,65,975,2,0,2
26,65,1135,5,2,3
26,65,1120,7,1,6
26,65,396,1,0,1
26,65,1297,8,5,3
26,65,1039,0,0,0
26,65,6426,45,22,23
26,65,3211,5,3,2
26,65,1769,6,4,2
26,65,1261,6,6,0
26,65,863,1,0,1
26,65,1499,16,6,10
26,65,1837,5,2,3
26,65,1577,22,12,10
26,65,3815,12,5,7
26,65,5960,8,4,4
26,65,9004,39,19,20
26,65,1365,4,2,2
26,65,3265,3,1,2
26,65,4748,11,5,6
26,65,3749,34,18,16
26,65,1396,1,0,1
26,65,8191,34,13,21
26,65,2371,8,5,3
26,65,2141,13,6,7
26,65,2359,10,7,3
26,65,1729,7,3,4
26,65,501,1,1,0
26,65,745,3,3,0
26,65,287,11,6,5
26,65,1108,0,0,0
26,65,1216,0,0,0
26,65,2118,32,14,18
26,65,2668,1,0,1
26,65,2292,14,7,7
26,65,1807,134,58,76
26,65,454,1,1,0
26,65,1414,2,1,1
26,65,1452,3,2,1
26,65,2441,5,4,1
26,65,1312,0,0,0
26,65,2821,26,13,13
26,65,1432,2,0,2
26,65,1933,46,23,23
26,65,7820,36,17,19
26,65,1422,3,0,3
26,65,3592,12,6,6
26,65,2177,12,5,7
26,65,1934,3,3,0
26,65,1391,0,0,0
26,65,1480,1,1,0
26,65,1374,9,5,4
26,65,2376,2,1,1
26,65,1132,6,0,6
26,65,548,0,0,0
26,65,2490,8,2,6
26,65,613,10,8,2
26,65,818,9,6,3
26,65,10587,98,50,48
26,65,887,11,8,3
26,65,689,2,1,1
26,66,386,1,1,0
26,67,1672,0,0,0
26,67,984,0,0,0
26,67,424,1,0,1
26,68,1709,32,13,19
26,68,1795,11,6,5
26,68,172,0,0,0
26,68,809,0,0,0
26,68,334,0,0,0
26,69,804,1,1,0
26,69,1930,5,3,2
26,69,263,0,0,0
26,69,1031,238,115,123
26,69,423,1,0,1
26,69,237,1,1,0
26,69,104,0,0,0
26,70,2694,12,4,8
26,70,2721,11,6,5
26,70,2006,9,5,4
26,70,2626,9,5,4
26,70,993,3,3,0
26,70,488,3,2,1
26,70,1464,5,1,4
26,70,643,7,4,3
26,71,823,0,0,0
26,49,44242,612,315,297
26,49,4448,63,33,30
26,49,2089,21,8,13
26,49,2829,28,11,17
26,49,2646,24,11,13
26,49,2131,15,8,7
26,49,2760,10,4,6
26,49,3011,12,5,7
26,49,2397,41,20,21
26,49,1938,20,9,11
26,49,1968,12,3,9
26,49,4645,41,12,29
26,49,2063,2,0,2
26,49,1588,46,28,18
26,49,3475,18,6,12
26,49,1610,15,7,8
26,49,1619,1,0,1
26,49,1522,5,3,2
26,49,1439,16,6,10
26,49,1512,6,5,1
26,49,1946,2,1,1
26,49,1764,5,1,4
26,49,2117,13,4,9
26,49,2187,8,2,6
26,49,2098,14,5,9
26,49,2338,107,48,59
26,49,1503,7,3,4
26,49,1647,33,17,16
26,49,1474,479,236,243
26,49,1318,29,15,14
26,3,2258,20,9,11
26,3,1221,40,13,27
26,3,1182,5,3,2
26,3,1212,3,1,2
26,52,1205,5,1,4
26,52,980,3,1,2
26,30,933,3,0,3
26,30,1220,8,2,6
26,30,797,7,2,5
26,30,555,7,0,7
26,30,728,3,0,3
26,30,1342,9,3,6
26,30,621,0,0,0
26,30,676,12,8,4
26,30,2338,1,0,1
26,30,2408,13,4,9
26,30,1752,30,16,14
26,30,866,3,1,2
26,30,1177,0,0,0
26,30,631,1,0,1
26,30,1056,4,4,0
26,30,505,0,0,0
26,30,1100,4,2,2
26,30,2818,18,8,10
26,30,1509,16,6,10
26,30,2834,46,26,20
26,30,938,2,1,1
26,30,1313,2,1,1
26,30,585,35,23,12
26,30,935,1,1,0
26,30,468,1,1,0
26,30,443,0,0,0
26,30,581,4,2,2
26,30,475,0,0,0
26,49,800,7,4,3
26,49,1198,5,4,1
26,49,3013,24,13,11
26,49,954,1,1,0
26,49,3461,50,25,25
26,49,983,12,7,5
26,49,1169,3,1,2
26,49,3549,39,18,21
26,49,3759,226,113,113
26,49,4216,689,345,344
26,49,4670,423,208,215
26,49,685,2,0,2
26,30,3568,51,17,34
26,30,12272,122,64,58
26,30,11724,382,201,181
26,30,798,3,0,3
26,30,834,3,3,0
26,30,719,2,0,2
26,30,948,0,0,0
26,30,1174,16,5,11
26,30,2309,30,13,17
26,30,936,1,1,0
26,30,1188,4,2,2
26,30,714,11,5,6
26,30,896,2,0,2
26,30,761,8,3,5
26,30,588,2,1,1
26,30,467,2,1,1
26,30,688,4,2,2
26,30,428,2,1,1
26,30,329,0,0,0
26,30,529,4,1,3
26,30,511,0,0,0
26,30,1228,7,2,5
26,30,1040,16,9,7
26,30,513,7,5,2
26,30,727,2,1,1
26,30,327,0,0,0
26,30,582,27,16,11
26,30,559,5,3,2
26,30,774,5,1,4
26,30,590,3,0,3
26,30,4731,43,22,21
26,30,4413,24,11,13
26,30,1049,8,4,4
26,30,2553,24,9,15
26,49,9168,198,99,99
26,49,7448,137,66,71
26,49,8455,39,15,24
26,49,598,0,0,0
26,49,901,1,0,1
26,49,742,1,0,1
26,49,901,8,2,6
26,49,599,4,1,3
26,49,324,4,2,2
26,49,985,10,6,4
26,49,693,5,3,2
26,49,433,7,5,2
26,49,585,3,1,2
26,49,1143,30,16,14
26,49,3347,33,16,17
26,49,2492,67,29,38
26,49,644,17,7,10
26,49,761,7,0,7
26,49,757,8,3,5
26,49,617,3,1,2
26,49,485,14,6,8
26,49,514,3,2,1
26,49,591,0,0,0
26,49,445,0,0,0
26,49,876,2,2,0
26,49,705,2,1,1
26,49,983,25,11,14
26,49,949,31,19,12
26,49,1574,28,10,18
26,49,836,7,4,3
26,49,857,6,3,3
26,49,940,1,0,1
26,49,1114,6,3,3
26,49,380,5,1,4
26,49,485,3,1,2
26,49,647,7,4,3
26,49,772,0,0,0
26,49,1879,100,54,46
26,49,756,40,17,23
26,49,1649,474,243,231
26,49,754,16,9,7
26,49,1354,27,13,14
26,49,2220,40,23,17
26,49,697,5,4,1
26,49,1056,4,1,3
26,49,849,8,0,8
26,49,1364,22,11,11
26,49,590,39,24,15
26,49,414,64,24,40
26,49,881,26,12,14
26,49,1590,21,10,11
26,49,1142,55,28,27
26,49,1050,56,26,30
26,49,1409,24,15,9
26,49,1396,21,9,12
26,49,1479,35,17,18
26,49,1064,11,4,7
26,49,474,19,9,10
26,49,923,5,2,3
26,49,1595,10,4,6
26,49,525,5,3,2
26,49,616,1,1,0
26,49,2149,30,11,19
26,49,238,2,2,0
26,49,281,1,0,1
26,49,1305,37,22,15
26,49,817,48,25,23
26,49,2189,26,13,13
26,49,1972,47,21,26
26,49,887,3,2,1
26,49,518,0,0,0
26,49,1701,1,1,0
26,49,1882,11,4,7
26,61,2869,57,32,25
26,61,3223,64,32,32
26,61,1000,14,8,6
26,61,2533,29,11,18
26,61,2024,5,2,3
26,61,1830,4,2,2
26,61,3522,18,7,11
26,61,1451,3,2,1
26,61,4374,22,12,10
26,61,1753,29,14,15
26,61,1410,4,1,3
26,61,1450,4,1,3
26,61,1225,1,1,0
26,61,1056,5,2,3
26,49,1012,4,4,0
26,49,1385,3,2,1
26,49,958,5,2,3
26,49,1450,18,6,12
26,49,1530,5,4,1
26,49,1439,11,2,9
26,49,1302,3,2,1
26,49,1576,102,51,51
26,49,1588,44,22,22
26,49,1503,112,56,56
26,49,2424,771,400,371
26,49,920,1,0,1
26,49,1770,12,1,11
26,49,2760,47,25,22
26,49,1712,16,8,8
26,49,1730,5,2,3
26,49,2765,44,26,18
26,49,1628,10,6,4
26,49,1739,23,9,14
26,49,2707,42,20,22
26,49,1726,23,12,11
26,49,2575,13,3,10
26,49,3547,55,25,30
26,49,2401,2,2,0
26,49,1953,29,16,13
26,49,2357,23,6,17
26,49,5755,29,13,16
26,49,2417,27,15,12
26,59,4864,143,65,78
26,59,2217,19,5,14
26,59,1361,7,2,5
26,59,5611,43,17,26
26,59,4239,32,15,17
26,59,5035,71,29,42
26,59,863,58,34,24
26,59,2010,12,10,2
26,59,779,1,0,1
26,59,3441,39,27,12
26,59,944,1,1,0
26,59,3003,14,8,6
26,59,4727,18,10,8
26,61,3508,55,19,36
26,61,4045,50,21,29
27,1,4186,34,19,15
27,1,3205,21,14,7
27,1,1373,22,13,9
27,1,1323,28,16,12
27,1,2193,8,2,6
27,1,770,12,7,5
27,1,1515,8,5,3
27,1,1908,3,1,2
27,1,1741,20,12,8
27,1,365,0,0,0
27,1,676,5,2,3
27,1,896,56,31,25
27,1,1593,1,0,1
27,1,964,11,6,5
27,1,1009,16,5,11
27,1,1011,8,3,5
27,1,1343,6,4,2
27,1,1622,3,2,1
27,1,366,0,0,0
27,1,893,12,6,6
27,1,367,0,0,0
27,1,1120,0,0,0
27,1,1319,1,1,0
27,1,2918,30,14,16
27,1,1099,68,32,36
27,1,784,6,4,2
27,1,1043,13,1,12
27,1,1079,0,0,0
27,1,1526,50,21,29
27,1,196,0,0,0
27,1,447,0,0,0
27,1,468,0,0,0
27,1,471,0,0,0
27,1,1471,4,2,2
27,1,848,1,0,1
27,1,1572,7,1,6
27,1,1321,0,0,0
27,1,1157,3,1,2
27,1,1159,4,1,3
27,1,1158,1,1,0
27,1,2869,21,10,11
27,1,1211,5,1,4
27,1,2278,9,5,4
27,1,1396,427,214,213
27,2,1272,14,9,5
27,2,7530,67,42,25
27,2,3096,3,0,3
27,2,1357,4,2,2
27,2,2091,2,2,0
27,2,1868,0,0,0
27,2,2190,9,5,4
27,2,2175,20,7,13
27,2,1446,7,4,3
27,2,3002,119,60,59
27,2,2274,48,28,20
27,2,559,1,1,0
27,2,766,0,0,0
27,2,931,3,2,1
27,2,1127,9,5,4
27,2,528,1,1,0
27,2,931,0,0,0
27,2,3973,27,14,13
27,2,1221,10,6,4
27,2,967,29,15,14
27,2,578,31,19,12
27,2,531,8,2,6
27,2,610,1,0,1
27,2,599,1,1,0
27,2,2568,10,6,4
27,2,5559,21,15,6
27,2,1092,6,2,4
27,2,680,10,6,4
27,2,537,14,8,6
27,2,1205,12,7,5
27,2,963,12,6,6
27,2,785,16,8,8
27,2,1211,20,8,12
27,2,979,3,1,2
27,2,716,4,3,1
27,2,2229,6,2,4
27,2,519,2,0,2
27,2,1318,12,5,7
27,2,1934,16,10,6
27,2,1980,1,0,1
27,2,3746,5,2,3
27,2,3256,7,3,4
27,2,2724,21,8,13
27,2,2906,0,0,0
27,2,1994,2,0,2
27,2,1691,3,2,1
27,2,1605,4,4,0
27,2,1379,1,1,0
27,2,929,3,2,1
27,2,1895,1,1,0
27,2,1433,2,0,2
27,2,1408,7,2,5
27,2,2568,2,0,2
27,2,3300,11,4,7
27,2,2808,17,7,10
27,2,2285,7,4,3
27,2,984,1,1,0
27,2,2451,10,4,6
27,2,431,0,0,0
27,2,2518,5,2,3
27,2,2204,7,5,2
27,2,1450,14,4,10
27,2,613,2,0,2
27,2,2027,17,11,6
27,2,3536,3,2,1
27,2,1345,0,0,0
27,2,1289,7,3,4
27,2,1154,3,2,1
27,2,762,0,0,0
27,2,1126,14,8,6
27,2,990,10,7,3
27,2,542,20,11,9
27,2,1538,32,16,16
27,2,1809,0,0,0
27,2,1790,6,5,1
27,2,2275,15,9,6
27,2,3069,0,0,0
27,2,1486,34,13,21
27,2,1589,1,1,0
27,2,2525,5,2,3
27,2,1342,11,8,3
27,2,1167,0,0,0
27,2,2337,7,4,3
27,2,2326,6,1,5
27,2,2775,6,2,4
27,2,2403,8,5,3
27,2,2857,4,2,2
27,2,1600,10,6,4
27,2,2764,6,3,3
27,2,662,42,25,17
27,2,2091,0,0,0
27,2,1463,1,1,0
27,2,2065,1,1,0
27,2,3631,8,3,5
27,2,1661,3,1,2
27,2,1992,4,2,2
27,2,1572,2,2,0
27,2,2408,3,2,1
27,2,3263,7,4,3
27,2,2236,11,6,5
27,2,3446,34,17,17
27,2,2184,3,2,1
27,2,3418,13,6,7
27,2,1575,3,2,1
27,2,1885,5,3,2
27,2,909,0,0,0
27,2,4350,68,35,33
27,2,1095,6,3,3
27,2,3963,179,92,87
27,2,4054,16,9,7
27,2,2323,1,0,1
27,2,3470,2,0,2
27,2,1125,0,0,0
27,2,2085,16,5,11
27,2,2884,16,7,9
27,2,460,9,3,6
27,2,6056,24,5,19
27,2,3127,11,6,5
27,2,1902,4,2,2
27,2,2920,6,1,5
27,2,2498,11,4,7
27,2,743,1,1,0
27,3,1229,21,9,12
27,3,3800,29,15,14
27,3,1895,6,3,3
27,3,1294,14,8,6
27,3,636,8,4,4
27,3,573,50,27,23
27,3,649,5,1,4
27,3,1231,5,3,2
27,3,2261,18,10,8
27,3,2648,14,7,7
27,3,1048,3,2,1
27,3,1888,25,11,14
27,3,1749,5,3,2
27,3,2669,12,3,9
27,3,798,3,2,1
27,3,1177,1,0,1
27,3,1368,1,0,1
27,3,528,0,0,0
27,3,1194,1,1,0
27,3,640,8,3,5
27,3,490,1,1,0
27,3,2477,3,2,1
27,3,1148,4,1,3
27,3,739,8,3,5
27,3,2479,34,17,17
27,3,761,3,2,1
27,3,793,0,0,0
27,3,741,2,1,1
27,3,3708,29,13,16
27,3,2459,7,1,6
27,3,2648,49,22,27
27,3,1397,2,2,0
27,3,2429,17,7,10
27,3,2422,6,1,5
27,3,3248,10,3,7
27,3,3541,4,1,3
27,3,4220,7,3,4
27,3,1923,1,0,1
27,3,2385,54,29,25
27,3,1870,8,2,6
27,3,1718,7,3,4
27,3,3275,15,8,7
27,3,3280,206,108,98
27,3,2673,35,17,18
27,3,1762,10,7,3
27,3,1714,6,5,1
27,3,2593,1,0,1
27,3,204,0,0,0
27,3,1902,21,10,11
27,3,724,2,2,0
27,3,657,1,1,0
27,3,291,0,0,0
27,3,2006,2,1,1
27,3,503,1,0,1
27,3,1785,125,64,61
27,3,2737,10,6,4
27,3,3073,6,1,5
27,3,1270,0,0,0
27,3,405,1,0,1
27,3,1653,27,9,18
27,3,1390,2,0,2
27,3,677,0,0,0
27,3,268,0,0,0
27,3,518,2,0,2
27,4,21475,239,110,129
27,4,1049,20,7,13
27,4,4286,17,7,10
27,4,1055,10,7,3
27,4,1015,47,26,21
27,4,4266,10,5,5
27,4,2322,19,9,10
27,4,955,59,37,22
27,4,742,27,10,17
27,4,2635,33,19,14
27,4,3564,36,18,18
27,4,1560,45,27,18
27,4,1395,27,13,14
27,4,1729,16,6,10
27,4,1064,15,7,8
27,4,1235,8,5,3
27,4,1558,12,6,6
27,4,8747,159,86,73
27,4,2171,21,8,13
27,4,3208,31,19,12
27,4,962,7,2,5
27,4,4540,33,13,20
27,4,4881,53,27,26
27,4,1699,28,14,14
27,4,1257,18,9,9
27,4,1757,13,7,6
27,4,723,6,3,3
27,4,1255,9,5,4
27,4,1777,45,25,20
27,4,1389,24,14,10
27,4,964,20,16,4
27,4,718,15,11,4
27,4,1672,22,13,9
27,4,1164,64,25,39
27,4,735,74,39,35
27,4,2256,36,19,17
27,4,1940,57,29,28
27,4,1694,15,5,10
27,4,1798,6,4,2
27,4,615,10,5,5
27,4,909,21,14,7
27,4,1926,6,3,3
27,4,1593,3,2,1
27,4,1055,6,6,0
27,4,1010,38,18,20
27,4,1250,80,43,37
27,4,644,5,4,1
27,4,664,8,3,5
27,4,1931,3,2,1
27,4,1815,1,1,0
27,4,1717,7,2,5
27,4,1475,9,3,6
27,4,531,3,3,0
27,4,573,14,7,7
27,4,805,5,3,2
27,4,613,1,1,0
27,4,695,10,5,5
27,4,1010,33,16,17
27,4,2440,10,4,6
27,4,2135,5,1,4
27,4,614,7,5,2
27,4,631,2,1,1
27,4,720,0,0,0
27,4,620,0,0,0
27,4,541,12,5,7
27,4,1509,10,7,3
27,4,298,4,2,2
27,4,1073,26,13,13
27,4,1090,11,6,5
27,4,852,39,19,20
27,4,1826,29,17,12
27,4,1354,30,18,12
27,4,2141,37,21,16
27,4,1286,47,22,25
27,4,919,26,14,12
27,4,1097,18,8,10
27,4,760,0,0,0
27,4,568,1,1,0
27,4,858,15,12,3
27,4,897,7,3,4
27,4,1419,3,1,2
27,4,732,1,0,1
27,4,5798,108,48,60
27,4,2106,126,61,65
27,4,1097,73,39,34
27,4,930,20,12,8
27,4,472,2,1,1
27,4,884,51,26,25
27,4,1676,12,6,6
27,4,695,2,0,2
27,4,722,5,3,2
27,4,1074,56,30,26
27,4,1023,66,42,24
27,4,931,21,12,9
27,4,1043,1,0,1
27,4,1157,13,5,8
27,4,1298,9,7,2
27,4,1118,6,3,3
27,4,957,17,7,10
27,4,815,41,25,16
27,4,1136,50,26,24
27,4,720,0,0,0
27,4,1533,13,7,6
27,4,768,8,4,4
27,4,525,5,3,2
27,4,1248,40,21,19
27,4,1038,9,6,3
27,4,604,0,0,0
27,4,1201,14,8,6
27,4,797,3,1,2
27,4,930,17,9,8
27,4,1282,5,3,2
27,4,1603,65,31,34
27,4,2992,56,24,32
27,4,113,11,7,4
27,4,1194,39,21,18
27,4,917,14,9,5
27,4,989,29,14,15
27,4,1631,6,3,3
27,4,898,5,4,1
27,4,1140,6,1,5
27,4,1088,14,8,6
27,4,1029,21,6,15
27,4,1045,4,3,1
27,4,1681,25,14,11
27,4,1244,5,4,1
27,4,1947,10,4,6
27,4,2485,21,11,10
27,4,2509,13,8,5
27,4,2627,20,10,10
27,4,1587,38,22,16
27,4,1065,32,15,17
27,4,988,6,5,1
27,4,1024,38,22,16
27,4,819,73,37,36
27,4,1122,67,39,28
27,4,1445,28,17,11
27,4,2534,30,16,14
27,4,635,35,17,18
27,4,1326,63,30,33
27,4,9923,158,79,79
27,4,1197,75,39,36
27,4,711,80,39,41
27,4,1052,11,5,6
27,4,1283,126,74,52
27,4,1169,45,26,19
27,4,703,14,8,6
27,4,1362,10,3,7
27,4,820,13,4,9
27,4,1305,131,65,66
27,4,2492,66,33,33
27,4,2640,19,12,7
27,4,2269,9,6,3
27,4,1169,17,11,6
27,4,1083,4,2,2
27,4,1118,66,36,30
27,4,1057,8,4,4
27,4,269,7,4,3
27,4,769,27,13,14
27,4,1507,25,11,14
27,4,1112,9,7,2
27,4,2157,7,4,3
27,4,887,16,9,7
27,4,1173,42,26,16
27,4,863,119,67,52
27,4,1828,505,267,238
27,4,6812,134,65,69
27,4,1403,105,56,49
27,4,1391,55,32,23
27,4,2977,41,20,21
27,4,1605,31,16,15
27,4,1418,33,19,14
27,4,2855,59,25,34
27,4,10078,84,48,36
27,4,1239,25,12,13
27,4,1355,22,10,12
27,4,1835,72,35,37
27,4,1472,99,44,55
27,4,4734,68,41,27
27,4,1899,153,77,76
27,4,1139,14,8,6
27,4,1314,4,2,2
27,4,1432,6,1,5
27,4,4790,215,112,103
27,4,8658,107,53,54
27,4,1181,37,21,16
27,4,4603,58,26,32
27,4,708,1,0,1
27,4,2776,5,1,4
27,4,3493,96,44,52
27,4,3854,7,2,5
27,4,4672,26,12,14
27,4,459,232,115,117
27,4,2759,11,5,6
27,4,3302,6,2,4
27,4,1877,12,5,7
27,4,1829,40,29,11
27,4,2588,9,3,6
27,4,7277,75,42,33
27,4,3587,32,15,17
27,4,1300,0,0,0
27,4,1373,4,1,3
27,4,1594,8,1,7
27,4,5758,71,37,34
27,4,1009,1,1,0
27,4,3041,3,2,1
27,4,3732,31,17,14
27,4,1170,187,90,97
27,4,19090,480,234,246
27,4,2779,169,87,82
27,4,303,0,0,0
27,4,5310,164,80,84
27,4,768,0,0,0
27,4,3258,331,162,169
27,4,6734,280,140,140
27,4,1189,1,1,0
27,4,1458,0,0,0
27,4,1567,2,0,2
27,4,14346,391,190,201
27,4,3207,33,18,15
27,4,1244,1,1,0
27,4,1240,14,4,10
27,4,2011,10,7,3
27,4,1895,62,31,31
27,4,4334,76,37,39
27,4,0,0,0,0
27,4,4056,10,6,4
27,4,1615,3,0,3
27,4,5390,4,2,2
27,4,2941,11,8,3
27,4,5131,35,18,17
27,4,4364,22,11,11
27,4,2599,10,6,4
27,4,13498,232,118,114
27,4,2263,110,52,58
27,4,3307,17,7,10
27,4,7686,87,43,44
27,4,1994,30,11,19
27,4,1574,1,1,0
27,4,1757,1,1,0
27,4,9281,73,41,32
27,4,3666,15,8,7
27,4,10074,27,11,16
27,4,1210,3,2,1
27,4,1333,8,3,5
27,4,4809,56,22,34
27,4,8363,196,92,104
27,4,5281,43,18,25
27,4,2245,67,43,24
27,4,2673,65,31,34
27,4,5318,86,41,45
27,4,2249,16,7,9
27,4,9031,169,80,89
27,4,3786,29,16,13
27,4,1027,16,9,7
27,4,2321,8,4,4
27,4,2427,1,0,1
27,4,3238,8,3,5
27,4,3137,23,11,12
27,4,1453,9,4,5
27,4,5600,54,27,27
27,4,2318,22,15,7
27,4,1733,7,3,4
27,4,2362,3,2,1
27,4,3207,7,2,5
27,4,806,12,5,7
27,4,14426,307,145,162
27,4,2077,24,19,5
27,4,15463,221,104,117
27,4,5526,669,360,309
27,4,1778,5,1,4
27,4,1792,2,1,1
27,4,14504,109,49,60
27,4,1743,15,7,8
27,4,2326,0,0,0
27,4,688,0,0,0
27,4,648,2,2,0
27,5,1527,8,3,5
27,5,5860,28,15,13
27,5,667,11,3,8
27,5,1676,16,8,8
27,5,1409,14,7,7
27,5,1126,1,1,0
27,5,644,6,3,3
27,5,733,11,5,6
27,5,567,5,2,3
27,5,713,5,3,2
27,5,547,0,0,0
27,5,1405,17,8,9
27,5,654,2,2,0
27,5,2335,5,1,4
27,5,486,1,0,1
27,5,809,3,1,2
27,5,4128,30,13,17
27,5,876,3,1,2
27,5,836,4,3,1
27,5,1998,19,8,11
27,5,913,3,0,3
27,5,1239,32,13,19
27,5,968,7,5,2
27,5,1111,36,16,20
27,5,1710,2,2,0
27,5,849,7,2,5
27,5,3128,5,3,2
27,5,1362,2,0,2
27,5,1126,2,1,1
27,5,1244,40,17,23
27,5,2034,1261,654,607
27,5,1737,0,0,0
27,5,1379,13,4,9
27,5,2857,1,0,1
27,5,1509,664,343,321
27,5,1389,1202,609,593
27,5,2091,958,479,479
27,5,1817,8,5,3
27,5,2213,16,9,7
27,5,3252,3,1,2
27,5,2636,9,4,5
27,5,1879,7,4,3
27,5,2787,151,74,77
27,5,880,0,0,0
27,5,4910,7,4,3
27,5,2226,811,409,402
27,5,3502,7,3,4
27,5,3002,0,0,0
27,5,6,0,0,0
27,5,2431,46,26,20
27,5,1771,66,30,36
27,5,1090,9,3,6
27,5,2303,31,17,14
27,5,1628,32,16,16
27,5,1498,31,15,16
27,5,2333,0,0,0
27,5,2062,470,235,235
27,5,5309,4,3,1
27,5,2775,1,1,0
27,5,2621,22,14,8
27,5,2413,10,7,3
27,5,2666,14,10,4
27,5,7175,771,406,365
27,5,4218,5,2,3
27,5,1897,1,1,0
27,5,3318,15,6,9
27,5,1262,72,36,36
27,5,1199,6,4,2
27,5,3152,11,4,7
27,5,2281,5,3,2
27,5,2691,1,1,0
27,5,1975,0,0,0
27,5,1636,2,2,0
27,5,2326,7,2,5
27,5,3623,7,5,2
27,5,3417,1,1,0
27,5,2811,25,14,11
27,5,4531,7,4,3
27,5,1778,0,0,0
27,5,4317,43,17,26
27,5,2287,8,4,4
27,5,3240,28,14,14
27,5,1829,0,0,0
27,5,1836,11,4,7
27,5,1494,1,1,0
27,5,3233,1,1,0
27,5,1553,1,1,0
27,5,3987,15,7,8
27,5,3595,6,3,3
27,5,2524,20,10,10
27,5,2229,6,3,3
27,5,1569,1,1,0
27,5,1040,1,0,1
27,5,2943,11,3,8
27,5,2294,0,0,0
27,5,2495,5,2,3
27,6,5596,113,59,54
27,6,2270,19,8,11
27,6,3446,29,14,15
27,6,1371,27,16,11
27,6,1585,15,10,5
27,6,2896,21,10,11
27,6,1322,48,24,24
27,6,2147,31,12,19
27,6,2232,120,62,58
27,6,2320,5,2,3
27,6,1987,20,10,10
27,6,2860,13,9,4
27,6,2092,7,3,4
27,6,1536,7,3,4
27,6,1919,5,1,4
27,6,1944,7,4,3
27,6,2589,6,3,3
27,6,1568,496,264,232
27,6,1535,2,0,2
27,6,2087,7,3,4
27,6,2362,1,0,1
27,6,2249,16,9,7
27,6,2350,36,19,17
27,6,1591,4,2,2
27,6,2809,2,1,1
27,6,1560,6,2,4
27,6,3376,11,3,8
27,6,2454,4,4,0
27,6,2139,64,26,38
27,6,2638,38,15,23
27,6,2365,19,8,11
27,6,2656,4,2,2
27,6,2891,1,0,1
27,6,4266,20,12,8
27,6,1594,0,0,0
27,6,2137,708,342,366
27,6,3008,28,13,15
27,6,1759,1,1,0
27,6,1896,25,10,15
27,6,1287,4,0,4
27,6,820,1,1,0
27,6,1710,325,158,167
27,6,2031,4,2,2
27,6,2122,0,0,0
27,6,698,1,0,1
27,6,5661,32,12,20
27,6,1407,3,2,1
27,6,3104,6,4,2
27,6,1483,7,4,3
27,6,2423,3,1,2
27,6,6862,34,15,19
27,6,1033,3,1,2
27,6,1331,1,0,1
27,6,2230,3,0,3
27,6,4352,16,7,9
27,6,891,1,0,1
27,6,3870,8,3,5
27,6,1903,5,2,3
27,6,2027,4,1,3
27,7,2890,13,6,7
27,7,1166,33,14,19
27,7,832,38,18,20
27,7,1110,18,7,11
27,7,2568,90,45,45
27,7,1176,52,31,21
27,7,5842,67,31,36
27,7,979,44,24,20
27,7,1585,123,62,61
27,7,5293,622,319,303
27,7,4397,4,1,3
27,7,1352,3,2,1
27,7,391,0,0,0
27,7,814,20,10,10
27,7,658,1,0,1
27,7,1236,1,0,1
27,8,2223,7,4,3
27,8,1207,5,3,2
27,8,2214,28,17,11
27,8,1814,3,0,3
27,8,809,0,0,0
27,8,1479,9,5,4
27,8,733,2,1,1
27,8,775,1,1,0
27,8,1234,1,0,1
27,8,1487,1,0,1
27,8,5763,11,4,7
27,8,1564,0,0,0
27,8,1046,6,2,4
27,8,2916,17,9,8
27,8,1520,1,1,0
27,8,3080,25,14,11
27,8,1396,6,3,3
27,8,957,1,1,0
27,8,764,0,0,0
27,8,2396,12,5,7
27,8,1562,1,0,1
27,8,1058,3,3,0
27,8,3573,13,9,4
27,8,3155,0,0,0
27,8,1982,5,3,2
27,8,1208,2,1,1
27,8,2294,9,6,3
27,8,1699,1,1,0
27,8,2362,4,2,2
27,8,1877,0,0,0
27,8,2497,2,2,0
27,8,367,0,0,0
27,8,3106,5,2,3
27,8,1376,3,2,1
27,8,2499,1,0,1
27,8,2468,2,2,0
27,8,2310,6,6,0
27,8,2312,3,0,3
27,8,3543,15,6,9
27,8,3204,14,7,7
27,8,11675,30,14,16
27,8,3574,1,0,1
27,8,1982,0,0,0
27,8,4303,14,3,11
27,8,1514,7,5,2
27,8,4104,4,2,2
27,8,2144,8,6,2
27,8,3050,13,4,9
27,8,930,5,3,2
27,8,2725,6,2,4
27,8,580,0,0,0
27,8,2239,2,1,1
27,8,2959,8,3,5
27,8,1276,3,1,2
27,8,4362,2,0,2
27,8,713,1,1,0
27,8,253,0,0,0
27,8,2796,12,6,6
27,8,2401,3,1,2
27,8,3351,5,2,3
27,8,1855,4,2,2
27,8,928,10,6,4
27,8,1820,0,0,0
27,8,4055,8,3,5
27,8,3649,3,1,2
27,8,1984,4,2,2
27,8,934,0,0,0
27,8,772,1,0,1
27,8,1072,1,1,0
27,8,668,1,1,0
27,8,1062,16,9,7
27,8,914,0,0,0
27,8,1084,2,2,0
27,8,2575,2,1,1
27,8,1136,1,0,1
27,8,1643,1,1,0
27,8,2673,3,3,0
27,8,388,0,0,0
27,8,1108,0,0,0
27,8,1214,10,5,5
27,8,1511,4,2,2
27,8,3950,2,1,1
27,8,967,5,3,2
27,8,1295,1,1,0
27,8,1123,0,0,0
27,8,2068,1,0,1
27,8,1522,3,1,2
27,8,1259,1,0,1
27,8,697,3,1,2
27,8,1795,2,2,0
27,8,1818,12,5,7
27,8,610,121,56,65
27,8,538,210,90,120
27,8,1549,804,409,395
27,8,1177,2,1,1
27,8,1598,0,0,0
27,8,1116,3,3,0
27,9,2691,5,2,3
27,9,1179,2,0,2
27,9,1112,9,3,6
27,9,645,5,1,4
27,9,1483,0,0,0
27,9,1829,3,1,2
27,9,990,2,1,1
27,9,1205,0,0,0
27,9,2164,9,2,7
27,9,172,0,0,0
27,9,509,0,0,0
27,9,1585,9,2,7
27,9,1619,4,2,2
27,9,1665,4,3,1
27,9,1693,5,3,2
27,9,1016,0,0,0
27,9,92,0,0,0
27,9,1999,4,3,1
27,9,2048,4,2,2
27,9,2433,6,3,3
27,9,2064,1,0,1
27,9,558,0,0,0
27,9,1373,7,4,3
27,9,1305,3,2,1
27,9,318,0,0,0
27,9,2053,4,3,1
27,9,638,3,1,2
27,9,1843,3,1,2
27,10,2153,19,9,10
27,10,4532,358,168,190
27,10,1548,14,7,7
27,10,2952,54,32,22
27,10,2561,20,9,11
27,10,722,10,7,3
27,10,2039,48,24,24
27,10,1248,18,8,10
27,10,1552,13,6,7
27,10,1675,0,0,0
27,10,1834,10,5,5
27,10,1180,6,1,5
27,10,2846,7,2,5
27,10,4064,14,9,5
27,10,4022,771,389,382
27,10,1566,2,1,1
27,10,3170,2,2,0
27,10,2230,1,0,1
27,10,4612,269,128,141
27,10,1982,0,0,0
27,10,5176,342,166,176
27,10,395,1,0,1
27,10,1718,6,3,3
27,10,3411,8,3,5
27,10,1477,5,5,0
27,10,3070,13,5,8
27,10,1510,26,13,13
27,10,1902,40,16,24
27,10,1577,8,5,3
27,10,3355,11,9,2
27,10,2572,289,154,135
27,10,2378,8,1,7
27,10,3311,9,3,6
27,10,3665,5,1,4
27,10,1982,4,2,2
27,10,2461,43,24,19
27,10,2383,10,2,8
27,11,2388,18,7,11
27,11,1562,8,4,4
27,11,1389,14,7,7
27,11,1460,26,12,14
27,11,553,2,1,1
27,11,984,24,12,12
27,11,664,23,12,11
27,11,898,21,10,11
27,11,230,19,10,9
27,11,274,0,0,0
27,11,417,1,1,0
27,11,1970,19,7,12
27,11,1020,9,5,4
27,11,1881,6,3,3
27,11,1136,2,1,1
27,11,1616,2,0,2
27,11,728,4,2,2
27,11,1653,1,0,1
27,11,495,16,6,10
27,11,1411,9,5,4
27,11,730,0,0,0
27,11,792,2,1,1
27,11,2600,25,13,12
27,11,1725,13,4,9
27,11,1276,1,0,1
27,11,1099,4,4,0
27,12,2537,24,10,14
27,12,1100,12,8,4
27,12,1453,6,2,4
27,12,1278,6,2,4
27,12,1455,28,14,14
27,12,3813,20,7,13
27,12,2333,78,40,38
27,12,4194,74,37,37
27,12,1531,20,12,8
27,12,1791,23,9,14
27,12,1577,6,3,3
27,12,1715,799,437,362
27,12,3336,959,496,463
27,12,2893,6,2,4
27,12,1758,21,11,10
27,12,683,0,0,0
27,12,327,0,0,0
27,12,1868,25,12,13
27,12,3341,52,21,31
27,12,846,1,0,1
27,12,2593,7,2,5
27,12,1156,3,2,1
27,12,852,1,0,1
27,12,1248,6,2,4
27,12,1007,5,3,2
27,12,2040,1,0,1
27,12,934,4,3,1
27,12,474,4,2,2
27,12,2319,39,18,21
27,12,1813,27,18,9
27,12,1246,0,0,0
27,12,2034,5,4,1
27,12,318,2,0,2
27,12,2811,4,2,2
27,12,1163,3,3,0
27,12,3028,15,6,9
27,12,537,1,1,0
27,12,1920,2,2,0
27,12,3309,4,1,3
27,12,3401,11,4,7
27,12,1565,7,2,5
27,12,1273,13,6,7
27,12,1888,28,13,15
27,12,2405,298,152,146
27,12,1430,88,43,45
27,12,1533,59,33,26
27,12,3624,44,27,17
27,12,2600,5,3,2
27,12,446,4,1,3
27,12,263,0,0,0
27,12,3046,10,5,5
27,12,3110,48,30,18
27,12,1624,2,0,2
27,12,2363,7,2,5
27,12,463,1,1,0
27,12,1237,31,18,13
27,12,4868,16,9,7
27,12,2046,4,2,2
27,12,2196,22,11,11
27,12,2457,7,4,3
27,12,1369,4,1,3
27,12,1252,10,4,6
27,12,4544,13,6,7
27,12,1978,5,3,2
27,12,412,0,0,0
27,12,1072,6,3,3
27,12,3394,6,4,2
27,12,2919,12,9,3
27,12,1888,3,2,1
27,12,639,11,6,5
27,12,3477,28,12,16
27,12,1859,2,0,2
27,12,802,3,1,2
27,12,3710,7,4,3
27,12,2300,0,0,0
27,12,2436,13,5,8
27,12,1949,3,1,2
27,12,786,0,0,0
27,12,1568,3,0,3
27,12,1314,0,0,0
27,12,1917,3,1,2
27,12,2326,1,0,1
27,13,1215,16,6,10
27,13,1990,7,6,1
27,13,2662,7,4,3
27,13,1341,13,9,4
27,13,1608,44,23,21
27,13,2434,4,2,2
27,13,3121,18,6,12
27,13,804,1,0,1
27,13,2309,14,7,7
27,13,3232,22,12,10
27,13,4251,8,4,4
27,13,3849,8,3,5
27,13,1327,11,6,5
27,13,2670,11,9,2
27,13,2502,7,4,3
27,13,3865,6,1,5
27,13,2485,22,6,16
27,13,3845,5,2,3
27,13,3536,6,2,4
27,13,1442,6,2,4
27,13,1258,1,0,1
27,13,1940,5,3,2
27,13,1439,24,11,13
27,13,1846,14,6,8
27,13,2679,21,10,11
27,13,1046,10,5,5
27,13,3472,18,9,9
27,13,5473,24,16,8
27,13,2912,24,12,12
27,13,7547,49,28,21
27,13,18622,648,334,314
27,13,3438,28,11,17
27,13,1773,43,24,19
27,13,2186,22,11,11
27,13,3426,40,23,17
27,14,3032,0,0,0
27,14,740,10,4,6
27,14,1161,1,0,1
27,14,1462,45,24,21
27,14,1554,6,3,3
27,14,2334,2,1,1
27,14,1233,19,12,7
27,14,2948,12,5,7
27,14,1268,1,1,0
27,14,950,5,3,2
27,14,1199,9,3,6
27,14,529,0,0,0
27,14,1666,10,7,3
27,14,1664,4,2,2
27,14,2406,0,0,0
27,14,1295,1,0,1
27,14,2287,14,5,9
27,14,1945,3,1,2
27,14,1620,5,2,3
27,14,1067,5,3,2
27,14,986,3,2,1
27,14,3198,3,1,2
27,14,2315,3,2,1
27,14,3068,4,1,3
27,14,901,7,4,3
27,14,2281,0,0,0
27,14,1421,2,0,2
27,14,1385,0,0,0
27,14,2136,3,1,2
27,14,4331,11,4,7
27,14,3231,14,7,7
27,14,6426,46,21,25
27,14,3098,3,0,3
27,14,2338,10,5,5
27,14,4575,12,4,8
27,14,2099,5,5,0
27,14,3170,4,3,1
27,14,2422,3,2,1
27,14,3049,5,3,2
27,14,1816,1,0,1
27,14,861,0,0,0
27,14,2575,0,0,0
27,14,2394,7,5,2
27,14,2048,2,0,2
27,14,1646,0,0,0
27,15,2853,11,5,6
27,15,1290,8,3,5
27,15,2858,25,13,12
27,15,1340,27,11,16
27,15,1995,4,2,2
27,15,1091,4,0,4
27,15,1271,1,1,0
27,15,273,0,0,0
27,15,2101,1,0,1
27,15,909,1,1,0
27,15,1764,4,1,3
27,15,578,2,1,1
27,15,486,1,1,0
27,15,2534,3,2,1
27,15,2585,7,2,5
27,15,2814,3,0,3
27,15,2547,7,2,5
27,15,2527,9,1,8
27,15,1542,5,3,2
27,15,2394,8,6,2
27,15,2349,1,0,1
27,15,927,1,1,0
27,15,1442,2,1,1
27,15,1211,1,0,1
27,15,2009,0,0,0
27,15,2571,1,0,1
27,15,1188,1,1,0
27,16,2161,30,11,19
27,16,2944,10,9,1
27,16,2423,32,12,20
27,16,2171,80,43,37
27,16,3497,7,2,5
27,16,5537,58,22,36
27,16,1346,17,5,12
27,16,1803,3,2,1
27,16,1424,10,7,3
27,16,2139,5,2,3
27,16,1897,13,8,5
27,16,1385,10,6,4
27,16,897,3,2,1
27,16,1152,2,1,1
27,16,1607,2,1,1
27,16,1901,6,2,4
27,16,2067,5,1,4
27,16,1919,3,0,3
27,16,2378,15,8,7
27,16,5315,39,18,21
27,16,3724,3,1,2
27,16,2441,22,8,14
27,16,472,0,0,0
27,16,308,0,0,0
27,16,363,0,0,0
27,16,5447,14,8,6
27,17,834,6,2,4
27,17,2970,16,8,8
27,17,1020,9,3,6
27,17,557,13,6,7
27,17,728,4,1,3
27,17,1208,26,11,15
27,17,982,2,1,1
27,17,1446,13,3,10
27,17,1099,12,4,8
27,17,1486,44,19,25
27,17,2394,45,20,25
27,17,4137,58,32,26
27,17,2158,44,20,24
27,17,1208,5,2,3
27,17,1428,29,9,20
27,17,4037,61,34,27
27,17,2765,26,12,14
27,17,2985,143,78,65
27,17,1440,53,31,22
27,17,1261,19,8,11
27,17,817,0,0,0
27,17,342,2,2,0
27,17,1000,3,1,2
27,17,501,0,0,0
27,17,1630,1,1,0
27,17,1213,3,1,2
27,17,1537,1,1,0
27,17,1280,3,2,1
27,17,748,2,0,2
27,17,1966,35,17,18
27,17,1301,4,3,1
27,17,295,2,0,2
27,17,1606,5,2,3
27,17,831,1,1,0
27,17,1093,1,1,0
27,17,494,2,1,1
27,17,1435,1,0,1
27,17,919,32,16,16
27,17,1229,4,3,1
27,17,1583,15,7,8
27,17,301,2,1,1
27,17,2246,5,3,2
27,17,970,24,13,11
27,17,720,1,0,1
27,17,297,40,19,21
27,13,3929,16,5,11
27,13,1426,35,16,19
27,13,2193,5,1,4
27,13,3264,26,9,17
27,13,1655,17,12,5
27,13,3627,54,32,22
27,13,4210,15,8,7
27,13,3003,36,17,19
27,13,3763,14,6,8
27,13,4410,20,9,11
27,13,7361,59,30,29
27,5,3028,81,45,36
27,5,1973,8,4,4
27,5,3143,63,34,29
27,4,4123,80,44,36
27,4,1423,4,0,4
27,13,3017,20,14,6
27,13,1393,8,3,5
28,1,568,6,2,4
28,1,1187,4,0,4
28,1,629,2,0,2
28,1,1134,0,0,0
28,1,842,0,0,0
28,1,1024,0,0,0
28,1,870,0,0,0
28,1,797,0,0,0
28,1,1372,2,1,1
28,1,711,3,0,3
28,1,620,9,5,4
28,2,3351,18,10,8
28,2,2510,4,3,1
28,2,1511,4,2,2
28,2,1219,1,0,1
28,2,981,0,0,0
28,2,1913,2,1,1
28,2,4512,18,6,12
28,2,552,0,0,0
28,2,637,1,0,1
28,2,709,0,0,0
28,2,1189,13,4,9
28,2,767,4,3,1
28,2,869,0,0,0
28,2,674,2,2,0
28,2,1542,3,1,2
28,2,577,1,1,0
28,2,205,0,0,0
28,2,1434,3,1,2
28,2,803,1,1,0
28,2,983,0,0,0
28,2,1854,2,1,1
28,3,6379,87,37,50
28,3,2337,14,6,8
28,3,3274,39,20,19
28,3,1087,0,0,0
28,3,9598,67,26,41
28,3,2146,14,6,8
28,3,5478,52,22,30
28,3,2146,11,5,6
28,3,1461,14,5,9
28,3,1897,9,6,3
28,3,4109,9,3,6
28,3,7832,182,97,85
28,3,1397,6,1,5
28,3,422,0,0,0
28,3,15996,350,165,185
28,3,1220,8,3,5
28,3,909,2,2,0
28,3,1502,1,1,0
28,3,1572,7,5,2
28,3,1265,11,7,4
28,3,4662,28,12,16
28,3,996,1,0,1
28,3,984,13,3,10
28,3,1996,6,4,2
28,3,1639,0,0,0
28,3,1078,1,0,1
28,3,1310,0,0,0
28,3,1794,79,36,43
28,3,2305,6,4,2
28,3,1926,8,5,3
28,3,2428,377,175,202
28,3,727,3,1,2
28,3,775,9,6,3
28,3,2546,61,31,30
28,3,1674,4,0,4
28,3,2666,12,7,5
28,3,5794,103,55,48
28,3,9758,92,46,46
28,3,3886,26,17,9
28,3,4287,15,9,6
28,3,4333,11,6,5
28,3,3044,5,4,1
28,3,17558,393,188,205
28,3,1922,20,10,10
28,3,2371,13,6,7
28,3,15677,114,61,53
28,3,1510,97,47,50
28,3,2324,210,112,98
28,3,3059,89,40,49
28,3,1576,13,8,5
28,3,2957,25,17,8
28,3,1806,10,7,3
28,3,2949,33,14,19
28,3,1251,21,13,8
28,3,5302,54,20,34
28,3,2043,6,5,1
28,3,2168,35,21,14
28,3,4131,26,15,11
28,3,7940,35,22,13
28,3,1911,63,34,29
28,3,2244,13,8,5
28,3,3766,56,19,37
28,3,1995,33,19,14
28,3,1816,12,5,7
28,3,2045,4,2,2
28,3,523,25,10,15
28,4,1960,94,48,46
28,4,2174,13,6,7
28,4,1170,2,1,1
28,4,712,1,1,0
28,4,635,3,1,2
28,4,1809,29,10,19
28,4,381,0,0,0
28,5,1239,1,0,1
28,5,607,5,3,2
28,5,810,1,0,1
28,5,167,1,0,1
28,5,333,0,0,0
28,5,117,0,0,0
28,5,709,1,0,1
28,5,272,2,1,1
28,6,911,1,1,0
28,6,913,1,0,1
28,6,1338,0,0,0
28,6,303,2,2,0
28,6,387,1,1,0
28,6,1231,2,0,2
28,6,758,2,1,1
28,6,483,0,0,0
28,6,1111,0,0,0
28,7,3995,15,8,7
28,7,1071,1,1,0
28,7,1186,2,2,0
28,7,1587,4,2,2
28,7,879,4,1,3
28,7,547,3,3,0
28,7,1266,3,3,0
28,7,1022,4,2,2
28,7,651,1,0,1
28,7,604,3,0,3
28,7,364,1,0,1
28,7,525,0,0,0
28,7,819,2,0,2
28,7,629,0,0,0
28,7,957,1,0,1
28,7,466,6,1,5
28,8,1430,0,0,0
28,8,315,1,1,0
28,8,202,0,0,0
28,8,742,0,0,0
28,8,540,0,0,0
28,8,600,0,0,0
28,8,257,1,0,1
28,8,142,0,0,0
28,9,2527,7,3,4
28,9,3343,14,8,6
28,9,1750,20,9,11
28,9,3587,13,5,8
28,9,2827,14,7,7
28,9,1993,3,3,0
28,9,11791,62,35,27
28,9,3203,35,18,17
28,9,6960,72,40,32
28,9,2848,14,8,6
28,9,2106,8,1,7
28,9,2004,22,11,11
28,9,1228,23,10,13
28,9,1817,17,9,8
28,9,18579,127,63,64
28,9,2019,21,10,11
28,9,2246,26,11,15
28,9,2096,3,1,2
28,9,1738,6,3,3
28,9,1523,14,6,8
28,9,3362,43,18,25
28,9,1803,17,7,10
28,9,1702,19,12,7
28,9,1299,19,12,7
28,9,1656,10,3,7
28,9,2225,20,15,5
28,9,1592,38,21,17
28,9,1841,10,6,4
28,9,1237,16,9,7
28,9,1395,19,6,13
28,9,1168,10,4,6
28,9,1068,10,4,6
28,9,1235,22,13,9
28,9,1747,11,5,6
28,9,1140,5,3,2
28,9,2798,13,6,7
28,9,2439,8,2,6
28,9,5641,156,86,70
28,9,2121,15,7,8
28,9,2569,9,5,4
28,9,2833,23,8,15
28,9,2624,19,12,7
28,9,2170,6,2,4
28,9,1296,0,0,0
28,9,970,15,8,7
28,9,1406,11,4,7
28,9,1448,12,4,8
28,9,1291,8,6,2
28,9,1214,115,68,47
28,9,930,14,7,7
28,9,1230,7,3,4
28,9,1061,7,4,3
28,9,1761,10,4,6
28,9,1929,7,3,4
28,9,2073,1,1,0
28,9,1414,0,0,0
28,9,1818,20,8,12
28,9,1489,13,5,8
28,9,1368,8,3,5
28,9,1680,10,9,1
28,9,1713,12,8,4
28,9,1348,3,0,3
28,9,1426,5,3,2
28,9,1509,16,7,9
28,9,1471,6,2,4
28,9,987,8,4,4
28,9,1208,38,16,22
28,9,1312,28,12,16
28,9,1628,4,3,1
28,9,1627,18,10,8
28,9,1540,8,3,5
28,9,1442,16,10,6
28,9,1659,34,20,14
28,9,915,6,4,2
28,9,1072,19,10,9
28,9,1343,4,2,2
28,9,1417,31,16,15
28,9,1418,47,27,20
28,9,1384,15,7,8
28,9,1401,18,9,9
28,9,1281,12,5,7
28,9,2491,22,9,13
28,9,934,13,2,11
28,9,813,20,9,11
28,9,412,3,2,1
28,9,876,4,3,1
28,9,1434,15,8,7
28,9,1207,6,3,3
28,9,1263,9,4,5
28,9,1140,4,4,0
28,9,1382,12,8,4
28,9,757,9,6,3
28,9,1211,33,20,13
28,9,1094,2,0,2
28,9,1219,3,2,1
28,9,911,8,4,4
28,9,678,15,7,8
28,9,909,33,17,16
28,9,1557,14,8,6
28,9,823,3,2,1
28,9,861,3,2,1
28,9,1391,14,10,4
28,9,959,1,0,1
28,9,1136,69,38,31
28,9,1084,19,9,10
28,9,975,4,2,2
28,9,1060,4,1,3
28,10,864,0,0,0
28,10,66,0,0,0
28,10,184,0,0,0
28,10,305,0,0,0
28,10,251,0,0,0
28,11,1851,7,5,2
28,11,222,0,0,0
28,11,1609,6,3,3
28,11,897,9,4,5
28,11,910,1,0,1
28,11,1752,1,1,0
28,11,1058,0,0,0
28,12,358,2,1,1
28,12,724,4,3,1
28,12,1880,4,1,3
28,12,1619,7,5,2
28,12,1281,1,0,1
28,12,1201,2,1,1
28,12,1552,5,2,3
28,12,1664,6,3,3
28,12,902,10,6,4
28,12,724,8,2,6
28,12,406,1,1,0
28,12,314,2,1,1
28,12,647,1,1,0
28,12,784,1,0,1
28,12,1288,9,6,3
28,12,1623,2,1,1
28,12,1270,3,3,0
28,12,944,3,2,1
28,12,751,2,1,1
28,12,1900,26,18,8
28,12,1104,11,6,5
28,12,1256,13,8,5
28,12,1389,22,10,12
28,12,1018,30,17,13
28,12,1981,4,2,2
28,12,1554,1,1,0
28,12,1331,4,2,2
28,12,837,3,0,3
28,12,1136,11,6,5
28,12,1605,10,5,5
28,12,757,14,6,8
28,12,293,2,2,0
28,12,310,2,1,1
28,12,1441,0,0,0
28,12,487,0,0,0
28,12,1740,1,0,1
28,12,1500,9,3,6
28,13,987,3,1,2
28,13,881,6,3,3
28,13,809,2,1,1
28,13,944,0,0,0
28,13,897,0,0,0
28,13,2190,1,0,1
28,13,1426,10,3,7
28,13,857,5,3,2
28,13,687,0,0,0
28,13,881,3,1,2
28,13,1482,1,0,1
28,13,773,2,1,1
28,13,44,0,0,0
28,13,1416,1,1,0
28,13,709,0,0,0
28,13,357,0,0,0
28,14,986,0,0,0
28,14,1118,0,0,0
28,14,1711,38,8,30
28,15,1232,0,0,0
28,15,1972,3,2,1
28,15,1319,4,2,2
28,15,1225,7,6,1
28,15,980,0,0,0
28,15,2126,2,1,1
28,15,1017,4,1,3
28,15,2199,1,0,1
28,15,848,16,9,7
28,15,213,0,0,0
28,15,537,4,2,2
28,15,309,4,3,1
28,15,1112,2,2,0
28,15,615,1,0,1
28,16,1219,1,1,0
28,16,1099,3,1,2
28,16,1077,12,5,7
28,16,664,0,0,0
28,16,493,2,1,1
28,16,178,0,0,0
28,16,128,0,0,0
28,16,570,1,0,1
28,16,1155,7,3,4
28,16,663,0,0,0
28,16,539,8,3,5
28,16,447,1,0,1
28,16,757,11,7,4
28,16,719,2,2,0
28,16,688,7,2,5
28,16,433,1,0,1
28,16,1300,1,0,1
28,16,1622,2,0,2
28,16,911,3,2,1
28,16,969,5,2,3
28,16,1256,5,3,2
28,17,1770,4,2,2
28,17,3059,22,16,6
28,17,2356,1,1,0
28,17,689,226,100,126
28,17,1967,382,184,198
28,17,409,12,7,5
28,17,276,7,4,3
28,17,1930,0,0,0
28,17,1148,3,0,3
28,17,1313,15,9,6
28,17,921,1,1,0
28,17,158,0,0,0
28,18,1769,1,1,0
28,18,935,3,0,3
28,18,526,1,0,1
28,18,1082,5,2,3
28,18,956,0,0,0
28,18,258,0,0,0
28,18,142,0,0,0
28,18,719,0,0,0
28,19,1343,1,1,0
28,19,891,2,0,2
28,19,1688,1,1,0
28,19,562,7,4,3
28,19,897,3,1,2
28,19,506,2,0,2
28,19,1158,0,0,0
28,19,1106,0,0,0
28,19,282,0,0,0
28,19,408,0,0,0
28,19,740,5,4,1
28,19,838,1,0,1
28,19,865,0,0,0
28,19,304,7,4,3
28,19,1081,1,0,1
28,19,957,4,2,2
28,19,213,0,0,0
28,19,684,2,0,2
28,20,404,0,0,0
28,20,448,2,1,1
28,20,693,3,1,2
28,20,493,0,0,0
28,21,1331,5,4,1
28,21,2368,16,11,5
28,21,861,2,1,1
28,21,1230,3,0,3
28,21,1621,7,0,7
28,21,1280,4,3,1
28,21,2319,36,20,16
28,21,1752,6,3,3
28,21,1615,3,1,2
28,21,1167,11,7,4
28,21,1244,8,2,6
28,21,1066,48,27,21
28,21,1072,2,2,0
28,21,1180,1,1,0
28,21,2386,4,3,1
28,21,1532,5,1,4
28,21,1735,4,2,2
28,21,4732,24,12,12
28,21,1634,0,0,0
28,21,918,1,0,1
28,21,1181,6,2,4
28,21,782,11,4,7
28,21,387,4,4,0
28,21,830,2,0,2
28,21,1086,4,2,2
28,21,970,4,2,2
28,21,1778,11,7,4
28,21,1150,8,5,3
28,21,1501,2,2,0
28,21,905,11,4,7
28,21,575,0,0,0
28,21,677,5,4,1
28,21,373,1,1,0
28,21,1437,3,1,2
28,21,881,2,1,1
28,21,911,2,2,0
28,21,2570,3,2,1
28,21,1903,4,4,0
28,21,1315,32,16,16
28,21,990,1,1,0
28,21,948,5,3,2
28,21,815,6,4,2
28,21,748,4,3,1
28,21,2175,10,6,4
28,21,997,4,2,2
28,21,1029,0,0,0
28,21,2434,8,4,4
28,21,1045,5,1,4
28,21,747,1,0,1
28,21,1708,8,5,3
28,21,2994,27,19,8
28,21,2830,1,1,0
28,21,2229,16,8,8
28,21,2355,63,33,30
28,21,2293,5,4,1
28,21,575,0,0,0
28,21,1520,1,1,0
28,21,1391,1,1,0
28,21,631,4,3,1
28,21,1491,0,0,0
28,21,664,6,1,5
28,21,533,2,1,1
28,21,492,2,2,0
28,21,543,2,1,1
28,21,962,3,2,1
28,21,594,1,1,0
28,21,1214,2,1,1
28,21,1547,1,0,1
28,21,881,4,1,3
28,21,221,1,1,0
28,21,816,0,0,0
28,21,1217,1,0,1
28,21,898,0,0,0
28,21,757,1,0,1
28,21,211,0,0,0
28,21,664,9,2,7
28,21,879,10,4,6
28,21,973,1,0,1
28,21,1033,0,0,0
28,21,1042,0,0,0
28,21,651,1,0,1
28,21,557,10,6,4
28,21,510,0,0,0
28,21,424,0,0,0
28,21,1180,1,0,1
28,21,397,0,0,0
28,22,2087,152,29,123
28,22,1402,20,8,12
28,22,684,6,4,2
28,22,494,10,3,7
28,22,1572,2,0,2
28,22,1837,676,319,357
28,22,937,3,1,2
28,22,716,1,1,0
28,22,1252,11,7,4
28,22,3071,21,11,10
28,22,403,0,0,0
28,22,304,4,0,4
28,22,647,1,1,0
28,22,761,5,1,4
28,22,620,3,0,3
28,22,1030,14,5,9
28,22,5138,159,72,87
28,22,7406,177,97,80
28,22,683,4,1,3
28,22,628,4,2,2
28,22,637,4,2,2
28,22,855,1,1,0
28,22,1126,4,2,2
28,22,2630,10,7,3
28,22,524,1,0,1
28,22,500,0,0,0
28,22,459,2,1,1
28,22,405,0,0,0
28,22,846,16,10,6
28,22,986,10,5,5
28,22,498,7,3,4
28,22,349,14,7,7
28,22,315,2,1,1
28,22,496,0,0,0
28,22,694,50,30,20
28,22,628,9,1,8
28,22,925,9,5,4
28,22,1011,4,3,1
28,22,948,10,4,6
28,22,752,4,2,2
28,22,1054,15,6,9
28,22,894,10,5,5
28,22,941,13,6,7
28,22,897,11,5,6
28,22,3752,16,9,7
28,22,1072,7,6,1
28,22,2730,9,6,3
28,22,14282,111,40,71
28,22,952,11,4,7
28,22,763,8,4,4
28,22,732,22,16,6
28,22,523,8,3,5
28,22,8935,57,20,37
28,22,1444,18,12,6
28,22,832,13,12,1
28,22,959,17,8,9
28,22,779,4,3,1
28,22,1043,6,4,2
28,22,1003,7,3,4
28,22,664,12,7,5
28,22,556,0,0,0
28,22,716,3,2,1
28,22,18570,88,33,55
28,22,600,0,0,0
28,22,882,10,6,4
28,22,984,5,1,4
28,22,845,7,3,4
28,22,791,8,2,6
28,22,971,8,0,8
28,22,788,3,2,1
28,22,562,3,0,3
28,22,609,2,1,1
28,22,1159,0,0,0
28,22,572,2,1,1
28,22,290,4,3,1
28,22,772,34,18,16
28,22,455,5,3,2
28,22,646,2,1,1
28,22,843,0,0,0
28,22,756,4,2,2
28,22,1651,2,1,1
28,22,2138,2,2,0
28,22,538,0,0,0
28,22,595,3,0,3
28,22,738,1,1,0
28,22,674,5,2,3
28,22,650,9,5,4
28,22,637,1,1,0
28,22,973,6,3,3
28,22,1245,10,2,8
28,22,2788,10,5,5
28,22,1215,4,1,3
28,22,1332,20,11,9
28,22,828,3,1,2
28,22,1494,10,5,5
28,22,411,1,0,1
28,22,1425,18,7,11
28,22,718,14,6,8
28,22,743,6,2,4
28,22,551,4,1,3
28,22,7185,98,45,53
28,22,1066,22,12,10
28,22,1037,4,1,3
28,22,845,3,1,2
28,22,1118,6,4,2
28,22,1189,7,4,3
28,22,962,2,1,1
28,22,1003,12,7,5
28,22,1261,5,2,3
28,22,5464,97,17,80
28,22,4036,90,43,47
28,22,1006,3,0,3
28,22,847,7,3,4
28,22,1639,35,15,20
28,22,920,15,7,8
28,22,847,18,10,8
28,22,3217,54,29,25
28,22,1238,7,3,4
28,22,3489,12,4,8
28,22,2026,16,11,5
28,22,8834,224,121,103
28,22,1185,6,3,3
28,22,864,1,1,0
28,22,1335,0,0,0
28,22,1386,0,0,0
28,22,2050,5,1,4
28,22,2667,24,9,15
28,22,2929,5,2,3
28,22,2291,10,2,8
28,22,2260,29,11,18
28,22,1265,1,0,1
28,22,1142,1,0,1
28,22,1279,0,0,0
28,22,5863,677,364,313
28,22,2255,6,3,3
28,22,1272,4,2,2
28,22,1391,9,5,4
28,22,1436,2,1,1
28,22,8584,84,41,43
28,22,5054,19,7,12
28,22,1405,24,8,16
28,22,1273,0,0,0
28,22,1074,23,9,14
28,22,1769,13,5,8
28,22,17742,89,31,58
28,22,1617,15,6,9
28,22,20895,249,116,133
28,22,768,2,1,1
28,22,1636,25,15,10
28,22,1331,12,6,6
28,22,14722,105,53,52
28,22,1013,20,15,5
28,22,8909,55,26,29
28,22,6220,109,51,58
28,22,1119,3,2,1
28,22,949,6,4,2
28,22,6884,25,9,16
28,22,995,0,0,0
28,22,1002,28,17,11
28,22,1133,8,7,1
28,22,1116,4,3,1
28,22,2477,12,8,4
28,22,2213,9,3,6
28,22,1192,95,43,52
28,22,6140,60,24,36
28,22,1592,13,5,8
28,22,1310,0,0,0
28,22,2045,5,3,2
28,22,14680,56,19,37
28,22,4224,23,3,20
28,22,2409,22,12,10
28,22,10981,58,27,31
28,22,2477,35,19,16
28,22,1111,4,1,3
28,22,6463,179,30,149
28,22,9546,84,37,47
28,22,3356,34,15,19
28,22,1793,2,2,0
28,22,795,4,3,1
28,22,723,0,0,0
28,22,753,6,3,3
28,22,1644,27,8,19
28,22,1026,17,9,8
28,22,1336,13,7,6
28,22,1267,6,3,3
28,22,1167,2,0,2
28,22,1225,1,0,1
28,22,731,6,2,4
28,22,825,1,1,0
28,22,973,21,13,8
28,22,975,33,12,21
28,22,1036,7,3,4
28,22,1232,4,2,2
28,22,9769,105,47,58
28,22,648,15,7,8
28,22,490,16,7,9
28,22,787,86,45,41
28,22,2230,72,29,43
28,22,12977,201,94,107
28,22,381,3,0,3
28,22,518,4,2,2
28,22,519,1,1,0
28,22,661,1,0,1
28,22,672,3,1,2
28,22,712,1,1,0
28,22,811,2,1,1
28,22,149,0,0,0
28,22,342,0,0,0
28,22,3070,118,55,63
28,23,1007,2,1,1
28,23,597,0,0,0
28,23,1280,0,0,0
28,23,644,0,0,0
28,23,409,0,0,0
28,23,331,0,0,0
28,24,1213,13,4,9
28,24,1418,6,4,2
28,24,580,3,1,2
28,24,877,4,3,1
28,24,1223,3,0,3
28,24,1065,12,5,7
28,25,1386,6,2,4
28,25,1931,6,2,4
28,25,688,6,4,2
28,25,831,4,2,2
28,25,493,2,0,2
28,25,1072,30,14,16
28,25,1371,48,27,21
28,25,1424,9,3,6
28,25,1030,21,9,12
28,25,668,2,1,1
28,25,894,2,2,0
28,25,2890,39,17,22
28,25,1060,11,7,4
28,25,1356,18,9,9
28,25,1047,3,2,1
28,25,2231,6,3,3
28,25,1429,29,14,15
28,25,2689,21,9,12
28,25,741,10,3,7
28,25,154,1,1,0
28,25,548,21,9,12
28,25,286,5,1,4
28,26,1955,16,6,10
28,26,686,4,2,2
28,26,962,1,0,1
28,26,101,0,0,0
28,27,15534,118,62,56
28,27,10618,42,17,25
28,27,909,10,5,5
28,27,1732,1,0,1
28,27,1522,7,5,2
28,27,4533,17,5,12
28,27,1706,9,3,6
28,27,6366,60,33,27
28,27,2316,20,11,9
28,27,3407,8,5,3
28,27,5257,32,13,19
28,27,1017,11,7,4
28,27,1561,4,2,2
28,27,1618,2,1,1
28,27,1619,6,2,4
28,27,1291,16,10,6
28,27,10606,60,28,32
28,27,1441,4,1,3
28,27,1016,10,4,6
28,27,560,2,0,2
28,27,669,3,1,2
28,27,754,8,3,5
28,27,551,17,8,9
28,27,196,1,0,1
28,27,572,7,4,3
28,27,1270,30,16,14
28,27,859,7,4,3
28,27,408,21,10,11
28,27,491,55,32,23
28,27,1405,5,3,2
28,27,1466,0,0,0
28,27,1686,5,2,3
28,27,1655,2,0,2
28,27,1356,1,1,0
28,27,1241,6,3,3
28,27,1866,4,1,3
28,27,36,0,0,0
28,27,546,5,1,4
28,27,636,18,11,7
28,27,1016,22,11,11
28,27,439,10,5,5
28,27,415,12,6,6
28,27,1016,21,7,14
28,27,767,25,12,13
28,27,723,6,1,5
28,27,795,2,0,2
28,27,436,11,5,6
28,27,917,20,15,5
28,27,760,10,5,5
28,27,915,9,7,2
28,27,682,5,2,3
28,27,760,11,6,5
28,27,576,9,3,6
28,27,642,2,0,2
28,27,689,2,1,1
28,27,522,1,1,0
28,27,632,3,2,1
28,27,944,5,3,2
28,27,1262,7,2,5
28,27,1384,3,1,2
28,27,1220,21,8,13
28,27,2248,18,10,8
28,27,2091,3,2,1
28,27,4514,19,10,9
28,27,3222,25,13,12
28,27,3381,19,12,7
28,27,7258,32,13,19
28,27,4387,27,10,17
28,27,4984,79,43,36
28,27,1270,9,2,7
28,27,1340,28,12,16
28,27,501,10,5,5
28,27,580,3,2,1
28,27,1021,1,1,0
28,27,1047,4,0,4
28,27,1211,7,3,4
28,27,1094,9,2,7
28,27,1337,19,7,12
28,27,1444,20,9,11
28,27,959,16,6,10
28,27,816,18,8,10
28,27,381,12,9,3
28,27,979,23,11,12
28,27,424,17,5,12
28,27,493,1,1,0
28,27,900,2,1,1
28,27,548,8,5,3
28,27,1100,6,2,4
28,27,654,1,0,1
28,27,3055,14,7,7
28,27,997,1,0,1
28,27,963,26,13,13
28,27,1069,38,17,21
28,27,784,25,12,13
28,27,943,1,1,0
28,27,847,1,0,1
28,27,670,7,3,4
28,27,777,5,3,2
28,27,1155,82,41,41
28,27,788,60,26,34
28,27,627,74,44,30
28,27,359,10,7,3
28,27,2117,72,42,30
28,27,1966,143,70,73
28,27,1870,12,6,6
28,27,1036,11,9,2
28,27,669,78,40,38
28,27,792,25,13,12
28,27,429,0,0,0
28,27,1419,5,4,1
28,27,1619,17,7,10
28,27,805,38,20,18
28,27,894,7,1,6
28,27,1145,3,1,2
28,27,1167,4,2,2
28,27,1956,5,1,4
28,27,21466,245,115,130
28,27,1815,15,7,8
28,27,1483,7,3,4
28,27,1265,26,14,12
28,27,1291,8,4,4
28,27,1164,0,0,0
28,27,2045,7,2,5
28,27,3710,24,11,13
28,27,1135,11,4,7
28,27,1467,9,6,3
28,27,1179,9,2,7
28,27,1653,20,10,10
28,27,1197,7,4,3
28,27,6478,46,24,22
28,27,978,0,0,0
28,27,882,3,1,2
28,27,624,0,0,0
28,27,1085,0,0,0
28,27,1049,4,2,2
28,27,1152,0,0,0
28,27,1256,29,18,11
28,27,1207,6,2,4
28,27,1441,8,4,4
28,27,13769,37,17,20
28,27,2884,3,2,1
28,27,5890,76,45,31
28,27,1028,7,3,4
28,27,1089,15,9,6
28,27,13043,125,74,51
28,27,2277,42,15,27
28,27,15191,147,76,71
28,27,4710,40,18,22
28,27,14525,379,177,202
28,27,1441,30,15,15
28,27,8411,72,34,38
28,27,5755,54,34,20
28,27,3432,3,0,3
28,27,12135,30,10,20
28,28,1657,10,4,6
28,28,1215,4,0,4
28,28,938,0,0,0
28,29,2264,10,5,5
28,29,1533,13,6,7
28,29,2003,15,7,8
28,29,637,21,10,11
28,29,261,1,0,1
28,29,219,7,2,5
28,29,1219,11,6,5
28,29,779,8,2,6
28,29,510,0,0,0
28,29,517,0,0,0
28,29,735,0,0,0
28,29,296,0,0,0
28,29,607,3,0,3
28,29,1709,3,1,2
28,30,1833,0,0,0
28,30,947,0,0,0
28,30,2281,8,3,5
28,30,1039,0,0,0
28,30,1967,33,16,17
28,30,1255,7,3,4
28,30,1763,7,3,4
28,30,974,10,6,4
28,30,1389,6,3,3
28,31,536,0,0,0
28,31,367,0,0,0
28,31,385,1,1,0
28,31,626,0,0,0
28,32,3981,43,25,18
28,32,2736,253,130,123
28,32,858,83,52,31
28,32,407,1,0,1
28,32,470,3,0,3
28,32,651,4,3,1
28,32,1237,173,79,94
28,32,891,6,1,5
28,32,1855,0,0,0
28,32,12114,86,39,47
28,32,3699,12,2,10
28,32,1354,1,0,1
28,32,953,4,2,2
28,32,1314,7,5,2
28,32,975,25,8,17
28,32,865,6,2,4
28,32,751,18,5,13
28,32,977,93,35,58
28,32,763,19,8,11
28,32,333,2,2,0
28,32,472,3,2,1
28,32,648,14,7,7
28,32,722,2,1,1
28,32,396,5,3,2
28,32,775,7,2,5
28,32,969,8,2,6
28,32,486,1,0,1
28,32,547,4,0,4
28,32,824,22,12,10
28,32,1217,10,4,6
28,32,2351,19,12,7
28,32,15686,189,83,106
28,32,1428,3,1,2
28,32,649,9,5,4
28,32,556,4,0,4
28,32,876,7,1,6
28,32,545,18,9,9
28,32,587,2,0,2
28,32,850,6,4,2
28,32,488,3,2,1
28,32,473,4,1,3
28,32,590,7,6,1
28,32,1183,2,1,1
28,32,926,16,3,13
28,32,611,11,5,6
28,32,598,6,4,2
28,32,259,4,2,2
28,32,630,9,7,2
28,32,654,3,1,2
28,32,646,2,1,1
28,32,1297,16,6,10
28,32,1017,1,1,0
28,32,701,1,1,0
28,32,813,2,1,1
28,32,3296,26,8,18
28,32,1644,11,7,4
28,32,4296,104,47,57
28,32,288,3,1,2
28,32,508,0,0,0
28,32,323,4,1,3
28,32,1193,3,2,1
28,32,1626,12,6,6
28,32,1285,16,5,11
28,32,1311,3,1,2
28,32,2055,48,26,22
28,32,806,63,39,24
28,32,579,12,6,6
28,32,552,1,0,1
28,32,374,3,2,1
28,32,644,0,0,0
28,32,374,6,3,3
28,32,1064,23,9,14
28,32,516,1,1,0
28,32,490,7,3,4
28,32,528,0,0,0
28,32,1186,12,5,7
28,32,978,6,2,4
28,32,812,4,3,1
28,32,857,0,0,0
28,32,1469,10,6,4
28,32,1142,2,2,0
28,32,997,9,5,4
28,32,23807,550,295,255
28,32,10079,54,26,28
28,32,1350,3,1,2
28,32,1551,44,23,21
28,32,1490,8,4,4
28,32,1298,7,2,5
28,32,1833,31,14,17
28,32,1019,10,3,7
28,32,675,6,2,4
28,32,1021,2,1,1
28,32,1086,9,6,3
28,32,992,9,4,5
28,32,677,0,0,0
28,32,974,9,5,4
28,32,1291,10,1,9
28,32,777,2,2,0
28,32,849,6,3,3
28,32,1355,7,1,6
28,32,1103,10,5,5
28,32,2395,9,0,9
28,32,1513,12,4,8
28,32,1051,5,4,1
28,32,1241,19,9,10
28,32,1077,1,0,1
28,32,1097,14,5,9
28,32,1176,3,2,1
28,32,887,1,1,0
28,32,1072,7,6,1
28,32,827,6,1,5
28,32,833,7,3,4
28,32,1020,10,6,4
28,32,993,2,0,2
28,32,1282,4,2,2
28,32,1124,9,4,5
28,32,1150,9,4,5
28,32,985,7,3,4
28,32,3485,40,25,15
28,32,6014,34,17,17
28,32,1237,7,1,6
28,32,801,0,0,0
28,32,1047,7,3,4
28,32,1179,50,23,27
28,32,1555,31,12,19
28,32,1150,3,1,2
28,32,1685,3,3,0
28,32,2267,55,20,35
28,32,975,2,0,2
28,32,1120,58,26,32
28,32,1360,649,347,302
28,32,1860,6,2,4
28,32,1047,158,74,84
28,32,2605,4,2,2
28,32,8348,36,21,15
28,32,1444,4,1,3
28,32,10381,97,37,60
28,32,2516,27,12,15
28,32,2440,67,35,32
28,32,1138,0,0,0
28,32,1835,12,5,7
28,32,1092,6,3,3
28,32,1308,1,1,0
28,32,3534,11,4,7
28,32,2370,346,178,168
28,32,2868,194,110,84
28,32,2426,17,11,6
28,32,11491,84,47,37
28,32,2415,22,15,7
28,32,2133,373,191,182
28,32,1340,164,87,77
28,32,1133,56,25,31
28,32,6104,16,8,8
28,32,7894,286,111,175
28,32,4635,30,14,16
28,32,2497,4,1,3
28,32,1728,7,2,5
28,32,1691,5,2,3
28,32,1438,2,0,2
28,32,16632,144,69,75
28,32,852,9,2,7
28,32,1192,2,2,0
28,32,1115,4,1,3
28,32,1276,5,3,2
28,32,1178,1,1,0
28,32,1033,0,0,0
28,32,2277,30,10,20
28,32,3395,29,15,14
28,32,2842,51,29,22
28,32,1953,7,2,5
28,32,4237,23,13,10
28,32,836,2,1,1
28,32,867,46,22,24
28,32,1111,15,11,4
28,32,943,3,1,2
28,32,1021,5,1,4
28,32,1514,241,127,114
28,32,1298,2,0,2
28,32,1081,5,1,4
28,32,7259,60,29,31
28,32,5819,603,306,297
28,32,6880,56,27,29
28,32,29480,763,399,364
28,32,264,2,2,0
28,32,1650,34,16,18
28,32,134,1,1,0
28,32,246,0,0,0
28,32,191,0,0,0
28,32,325,3,2,1
28,32,107,0,0,0
28,32,549,0,0,0
28,32,468,1,1,0
28,32,1050,5,2,3
28,32,634,0,0,0
28,33,16250,50,25,25
28,33,5862,16,8,8
28,33,1242,19,12,7
28,33,1616,3,1,2
28,33,10179,126,65,61
28,33,1981,10,6,4
28,33,16176,72,32,40
28,33,3904,5,2,3
28,33,1582,25,15,10
28,33,1586,3,1,2
28,33,1171,8,4,4
28,33,702,0,0,0
28,33,825,6,4,2
28,33,1317,2,0,2
28,33,386,1,1,0
28,33,533,0,0,0
28,33,772,0,0,0
28,33,989,2,2,0
28,33,1872,40,21,19
28,33,1795,2,0,2
28,33,1726,33,19,14
28,33,1550,16,8,8
28,33,1775,84,52,32
28,33,1007,56,24,32
28,33,1213,129,62,67
28,33,1059,46,22,24
28,33,555,15,8,7
28,33,852,12,6,6
28,33,485,5,3,2
28,33,514,2,1,1
28,33,875,6,1,5
28,33,973,10,4,6
28,33,1284,19,11,8
28,33,3300,34,15,19
28,33,1729,28,14,14
28,33,6887,30,15,15
28,33,2201,4,0,4
28,33,1698,1,0,1
28,33,1271,4,3,1
28,33,1433,5,3,2
28,33,396,2,1,1
28,33,582,1,0,1
28,33,567,2,0,2
28,33,371,0,0,0
28,33,704,2,2,0
28,33,897,22,16,6
28,33,819,5,3,2
28,33,463,9,6,3
28,33,1254,89,51,38
28,33,1624,33,18,15
28,33,1228,66,34,32
28,33,546,0,0,0
28,33,1463,13,8,5
28,33,2283,11,7,4
28,33,2814,19,9,10
28,33,4195,20,12,8
28,33,1245,3,0,3
28,33,602,7,5,2
28,33,1287,13,5,8
28,33,145,1,1,0
28,33,322,0,0,0
28,33,620,3,1,2
28,33,378,0,0,0
28,33,426,4,2,2
28,33,552,0,0,0
28,33,894,3,1,2
28,33,597,1,0,1
28,33,642,6,4,2
28,33,478,2,2,0
28,33,205,0,0,0
28,33,879,3,1,2
28,33,330,3,0,3
28,34,680,2,1,1
28,34,605,1,1,0
28,34,81,0,0,0
28,34,326,0,0,0
28,34,340,1,0,1
28,34,793,1,0,1
28,34,559,0,0,0
28,34,388,0,0,0
28,34,646,7,3,4
28,34,665,0,0,0
28,34,1356,2,2,0
28,34,972,3,2,1
28,35,849,0,0,0
28,35,1501,1,1,0
28,35,1028,3,1,2
28,35,1254,4,2,2
28,35,1387,4,1,3
28,35,1854,0,0,0
28,35,1911,0,0,0
28,35,1032,2,1,1
28,35,847,3,1,2
28,35,1076,0,0,0
28,35,1524,2,1,1
28,35,595,0,0,0
28,35,937,5,2,3
28,35,916,0,0,0
28,35,1414,15,9,6
28,35,1527,7,1,6
28,35,2256,1,1,0
28,35,1082,2,1,1
28,35,1035,2,0,2
28,35,1649,18,6,12
28,35,1387,4,2,2
28,35,1039,13,5,8
28,35,638,1,1,0
28,35,887,0,0,0
28,35,743,0,0,0
28,35,772,6,3,3
28,35,961,1,1,0
28,35,409,0,0,0
28,35,390,2,1,1
28,35,792,2,0,2
28,35,769,1,0,1
28,35,1126,6,4,2
28,35,482,0,0,0
28,35,569,2,0,2
28,35,759,7,1,6
28,35,631,3,3,0
28,35,1448,2,0,2
28,35,1025,0,0,0
28,35,417,0,0,0
28,35,1007,1,1,0
28,35,1581,1,0,1
28,35,949,10,6,4
28,35,634,2,1,1
28,35,784,0,0,0
28,35,419,12,3,9
28,35,48,2,0,2
28,35,1094,26,11,15
28,35,1530,53,24,29
28,35,236,2,2,0
28,35,177,1,0,1
28,35,718,0,0,0
28,35,1323,2,1,1
28,36,538,1,1,0
28,36,388,0,0,0
28,37,2388,14,10,4
28,37,2277,20,7,13
28,37,2283,15,5,10
28,37,1204,4,1,3
28,37,1600,2,0,2
28,37,1928,195,89,106
28,37,1140,5,2,3
28,37,559,1,0,1
28,37,654,14,8,6
28,37,201,8,5,3
28,37,977,0,0,0
28,37,507,10,7,3
28,37,442,0,0,0
28,37,524,0,0,0
28,37,2209,11,3,8
28,37,398,0,0,0
28,37,465,0,0,0
28,37,126,0,0,0
28,37,816,0,0,0
28,37,862,3,1,2
28,37,276,3,0,3
28,37,675,7,1,6
28,37,823,1,1,0
28,37,368,1,1,0
28,38,7615,97,54,43
28,38,1979,23,15,8
28,38,1241,21,12,9
28,38,1711,26,8,18
28,38,2062,48,25,23
28,38,2095,16,10,6
28,38,3114,4,1,3
28,38,1703,20,10,10
28,38,1179,3,1,2
28,38,1484,26,15,11
28,38,6302,80,40,40
28,38,1481,3,2,1
28,38,1552,21,11,10
28,38,1727,33,19,14
28,38,2641,12,7,5
28,38,1654,9,4,5
28,38,1439,3,1,2
28,38,1604,26,13,13
28,38,1851,13,7,6
28,38,2855,17,15,2
28,38,1960,66,32,34
28,38,2275,58,27,31
28,38,2208,42,23,19
28,38,2024,34,17,17
28,38,1953,21,13,8
28,38,2766,5,2,3
28,38,4385,74,39,35
28,38,2105,54,30,24
28,38,1716,42,23,19
28,38,2664,20,11,9
28,38,2400,20,13,7
28,38,1428,13,4,9
28,38,3221,55,27,28
28,38,2486,14,4,10
28,38,2000,16,11,5
28,38,1265,2,1,1
28,38,1716,5,2,3
28,38,1272,8,5,3
28,38,1609,19,9,10
28,38,934,20,11,9
28,38,2295,16,8,8
28,38,2426,14,8,6
28,38,1529,23,11,12
28,38,4485,65,35,30
28,38,1873,32,17,15
28,38,2061,23,13,10
28,38,4366,64,32,32
28,38,3112,39,17,22
28,38,1482,16,11,5
28,38,1176,9,4,5
28,38,2282,31,12,19
28,38,1098,11,7,4
28,38,1475,8,4,4
28,38,3350,57,27,30
28,38,10398,137,60,77
28,38,4332,48,24,24
28,38,1170,18,9,9
28,38,3495,95,45,50
28,38,1182,19,6,13
28,38,1350,17,8,9
28,38,1903,23,12,11
28,38,1000,5,1,4
28,38,1612,18,9,9
28,38,1416,7,3,4
28,38,1074,12,6,6
28,38,1108,10,7,3
28,38,1250,7,4,3
28,38,1163,6,3,3
28,38,570,12,10,2
28,38,562,8,4,4
28,38,600,3,2,1
28,38,2967,69,36,33
28,38,1969,21,12,9
28,38,2190,20,11,9
28,38,1364,14,5,9
28,38,4123,36,24,12
28,38,954,0,0,0
28,38,807,0,0,0
28,38,1148,5,1,4
28,38,927,6,4,2
28,38,1288,6,2,4
28,38,1066,15,6,9
28,38,3189,47,24,23
28,38,1624,3,1,2
28,38,1282,4,3,1
28,38,947,10,10,0
28,38,1664,10,7,3
28,38,2031,38,18,20
28,38,1957,20,14,6
28,38,2470,15,10,5
28,38,799,6,2,4
28,38,966,8,4,4
28,38,1068,21,12,9
28,38,682,1,1,0
28,38,777,1,1,0
28,38,938,4,1,3
28,38,1544,13,9,4
28,38,1479,16,9,7
28,38,1018,6,0,6
28,38,946,3,1,2
28,38,875,7,3,4
28,38,956,19,6,13
28,38,753,14,10,4
28,38,1117,10,5,5
28,38,1214,15,6,9
28,38,1228,28,14,14
28,38,941,76,35,41
28,38,869,34,13,21
28,38,1500,26,11,15
28,38,1135,70,41,29
28,38,1011,7,5,2
28,38,1305,22,7,15
28,38,1390,44,22,22
28,38,1173,11,7,4
28,38,1449,6,2,4
28,38,1226,16,10,6
28,38,1320,5,2,3
28,38,759,3,3,0
28,38,993,10,7,3
28,38,1207,5,2,3
28,38,863,8,4,4
28,38,1320,8,7,1
28,38,3158,31,15,16
28,38,1748,18,10,8
28,38,1065,42,20,22
28,38,700,22,8,14
28,38,763,25,14,11
28,38,1672,11,4,7
28,38,680,0,0,0
28,38,991,7,5,2
28,38,894,14,6,8
28,38,1065,7,4,3
28,38,1202,38,15,23
28,38,525,7,4,3
28,38,988,7,3,4
28,38,938,9,4,5
28,38,2175,71,26,45
28,38,2765,743,387,356
28,38,1067,6,3,3
28,38,1235,9,5,4
28,38,899,0,0,0
28,38,994,21,11,10
28,38,1009,13,5,8
28,38,696,2,0,2
28,38,1594,20,9,11
28,38,1385,17,6,11
28,38,1812,39,24,15
28,38,1302,16,6,10
28,38,1689,47,26,21
28,38,942,4,3,1
28,38,916,5,3,2
28,38,1074,7,1,6
28,38,850,10,6,4
28,38,961,5,3,2
28,38,1098,34,18,16
28,38,1183,8,4,4
28,38,1146,30,17,13
28,38,1509,30,14,16
28,38,1363,18,6,12
28,38,1175,62,28,34
28,38,1031,28,13,15
28,38,948,24,17,7
28,38,636,6,4,2
28,38,634,14,9,5
28,38,547,8,1,7
28,38,440,2,1,1
28,38,1175,38,20,18
28,38,740,4,2,2
28,38,1333,15,9,6
28,38,728,11,5,6
28,38,824,18,7,11
28,38,206,4,4,0
28,38,1607,6,1,5
28,38,638,2,0,2
28,38,979,3,2,1
28,38,828,7,4,3
28,38,910,12,6,6
28,38,783,4,3,1
28,38,808,25,16,9
28,38,646,3,1,2
28,38,416,3,0,3
28,38,648,5,3,2
28,38,1307,33,15,18
28,38,1618,37,23,14
28,38,689,19,6,13
28,38,306,9,4,5
28,38,439,26,13,13
28,38,452,0,0,0
28,38,569,8,7,1
28,38,575,2,1,1
28,38,678,1,0,1
28,38,587,2,1,1
28,39,1724,1,0,1
28,39,2825,7,3,4
28,39,2416,9,5,4
28,39,2533,15,9,6
28,39,1439,2,2,0
28,39,1592,8,5,3
28,39,966,1,1,0
28,39,1620,8,4,4
28,39,945,0,0,0
28,39,978,3,1,2
28,39,997,3,2,1
28,39,828,1,1,0
28,39,1364,1,1,0
28,39,983,1,0,1
28,39,1914,11,4,7
28,39,1026,36,18,18
28,39,469,0,0,0
28,39,2597,1,1,0
28,39,1033,11,5,6
28,40,1632,17,10,7
28,40,1629,9,4,5
28,40,1857,3,2,1
28,40,1324,11,3,8
28,40,1632,25,11,14
28,40,2255,15,10,5
28,40,1969,9,3,6
28,40,1675,12,6,6
28,40,1019,4,3,1
28,40,505,0,0,0
28,40,536,0,0,0
28,40,1390,6,4,2
28,40,2173,12,6,6
28,40,2258,5,3,2
28,40,1937,10,5,5
28,40,1282,5,2,3
28,40,803,13,4,9
28,40,391,1,1,0
28,40,780,3,0,3
28,40,426,5,2,3
28,40,1143,6,2,4
28,40,2100,8,5,3
28,40,1506,1,1,0
28,40,959,3,0,3
28,40,1379,12,7,5
28,40,685,6,0,6
28,40,1660,9,3,6
28,40,4432,15,10,5
28,40,1967,15,9,6
28,40,988,2,1,1
28,40,791,0,0,0
28,40,214,0,0,0
28,40,909,4,1,3
28,40,95,0,0,0
28,40,1758,5,2,3
28,40,1781,7,7,0
28,40,545,0,0,0
28,40,175,0,0,0
28,40,552,2,1,1
28,40,1626,7,4,3
28,40,1271,2,1,1
28,40,5079,6,2,4
28,40,184,0,0,0
28,40,141,1,0,1
28,40,233,2,1,1
28,40,198,4,0,4
28,41,15905,88,44,44
28,41,1620,0,0,0
28,41,4767,20,4,16
28,41,1414,2,0,2
28,41,4562,18,9,9
28,41,3482,0,0,0
28,41,5081,22,11,11
28,41,5592,110,51,59
28,41,2010,8,6,2
28,41,1437,6,3,3
28,41,2415,11,3,8
28,41,8856,34,15,19
28,41,1113,0,0,0
28,41,1349,5,3,2
28,41,2457,11,6,5
28,41,9354,86,51,35
28,41,0,0,0,0
28,41,1475,12,7,5
28,41,1301,17,11,6
28,41,1387,1,0,1
28,41,1384,9,6,3
28,41,980,7,3,4
28,41,687,3,1,2
28,41,813,4,3,1
28,41,988,8,3,5
28,41,1250,4,2,2
28,41,6897,29,13,16
28,41,1746,13,5,8
28,41,4725,22,11,11
28,41,1842,6,5,1
28,41,1425,2,1,1
28,41,1575,4,1,3
28,41,1010,5,3,2
28,41,940,4,3,1
28,41,780,4,1,3
28,41,870,5,2,3
28,41,863,3,0,3
28,41,688,5,4,1
28,41,3280,5,2,3
28,41,9883,217,102,115
28,41,1219,8,5,3
28,41,1522,6,4,2
28,41,958,57,29,28
28,41,678,0,0,0
28,41,1668,4,4,0
28,41,8854,44,15,29
28,41,4676,19,9,10
28,41,1724,2,1,1
28,41,1098,4,1,3
28,41,1342,5,2,3
28,41,1339,7,2,5
28,41,869,1,0,1
28,41,821,5,1,4
28,41,846,1,1,0
28,41,964,3,1,2
28,41,1210,74,39,35
28,41,1131,8,5,3
28,41,2129,21,10,11
28,41,1727,4,2,2
28,41,1119,6,2,4
28,41,1302,4,2,2
28,41,763,4,1,3
28,41,715,4,1,3
28,41,1194,8,5,3
28,41,801,2,0,2
28,41,771,11,4,7
28,41,638,21,10,11
28,41,846,63,33,30
28,41,418,28,18,10
28,41,724,2,1,1
28,41,1438,0,0,0
28,41,1490,4,0,4
28,41,1535,10,3,7
28,41,1279,6,3,3
28,41,5958,9,5,4
28,41,5569,23,13,10
28,41,1455,3,3,0
28,41,1597,2,2,0
28,41,1878,18,7,11
28,41,1153,28,17,11
28,41,524,0,0,0
28,41,586,1,0,1
28,41,490,3,2,1
28,41,575,1,1,0
28,41,1422,3,3,0
28,41,1640,2,1,1
28,41,2660,94,50,44
28,41,7400,47,22,25
28,41,4476,8,4,4
28,41,1986,119,68,51
28,41,1482,16,12,4
28,41,879,1,1,0
28,41,216,4,1,3
28,41,676,4,2,2
28,41,820,3,2,1
28,41,881,0,0,0
28,41,1079,30,13,17
28,41,1847,6,2,4
28,41,949,24,16,8
28,41,499,230,120,110
28,41,1010,18,10,8
28,41,957,7,2,5
28,41,2122,0,0,0
28,41,1110,1,1,0
28,41,4291,21,13,8
28,41,5539,11,7,4
28,41,1350,4,1,3
28,41,3337,16,7,9
28,41,1129,4,1,3
28,41,1148,3,1,2
28,41,793,2,1,1
28,41,6405,787,424,363
28,41,1037,17,8,9
28,41,1225,7,3,4
28,41,1067,825,415,410
28,41,987,15,8,7
28,41,687,17,10,7
28,41,1023,26,15,11
28,41,2735,50,31,19
28,41,7321,17,7,10
28,41,24941,349,161,188
28,41,7139,53,26,27
28,41,2556,11,3,8
28,41,3406,13,7,6
28,41,3276,21,11,10
28,41,1348,11,6,5
28,41,1233,5,5,0
28,41,1866,10,6,4
28,41,2071,2,0,2
28,41,1541,4,2,2
28,41,2061,8,4,4
28,41,1414,32,15,17
28,41,3708,4,2,2
28,41,1701,0,0,0
28,41,1358,4,1,3
28,41,1242,19,9,10
28,41,4008,9,6,3
28,41,1780,3,3,0
28,41,1354,4,1,3
28,41,1528,197,106,91
28,41,1252,0,0,0
28,41,1305,5,3,2
28,41,1155,1,1,0
28,41,2325,16,10,6
28,41,2100,30,15,15
28,41,1684,2,1,1
28,41,4784,54,27,27
28,41,1164,2,1,1
28,41,2298,7,2,5
28,41,106,0,0,0
28,42,1053,3,1,2
28,42,1040,9,4,5
28,42,666,0,0,0
28,42,627,1,1,0
28,42,833,0,0,0
28,42,538,0,0,0
28,42,614,3,1,2
28,43,1500,12,8,4
28,43,1008,0,0,0
28,43,1890,4,3,1
28,43,1429,2,0,2
28,43,2069,14,6,8
28,43,2917,151,77,74
28,43,434,1,0,1
28,43,576,0,0,0
28,43,116,0,0,0
28,43,422,3,2,1
28,43,1180,0,0,0
28,43,1275,3,1,2
28,43,610,0,0,0
28,43,899,1,0,1
28,43,559,0,0,0
28,43,496,2,0,2
28,43,1001,0,0,0
28,43,709,0,0,0
28,43,1614,0,0,0
28,43,1114,1,1,0
28,43,424,1,1,0
28,32,662,19,9,10
28,32,580,0,0,0
28,32,2419,16,5,11
28,32,700,1,0,1
28,32,770,4,2,2
28,32,534,3,1,2
28,32,961,3,3,0
28,32,663,7,2,5
28,32,645,9,2,7
28,32,747,6,4,2
28,32,982,8,4,4
28,32,853,7,4,3
28,32,807,2,2,0
28,32,894,7,2,5
28,32,989,102,55,47
28,32,1932,17,12,5
28,32,1297,1,0,1
28,32,1295,158,83,75
28,32,1029,97,56,41
28,32,1257,3,0,3
28,32,999,203,101,102
28,32,679,69,34,35
28,32,893,1,1,0
28,32,778,4,3,1
28,32,763,21,11,10
28,32,928,3,1,2
28,32,739,2,1,1
28,32,928,21,9,12
28,32,4816,23,9,14
28,32,3833,44,19,25
28,32,822,9,7,2
28,32,1022,21,10,11
28,32,8671,26,10,16
28,32,1177,22,11,11
28,32,6883,56,29,27
28,32,1983,98,54,44
28,32,798,2,1,1
28,32,1108,9,5,4
28,32,1106,10,8,2
28,32,1169,16,8,8
28,32,1244,8,3,5
28,32,1339,5,3,2
28,32,943,2,1,1
28,32,919,5,1,4
28,32,739,0,0,0
28,32,1043,3,1,2
28,32,810,5,4,1
28,32,1031,10,4,6
28,32,913,0,0,0
28,32,1012,4,2,2
28,32,1124,2,0,2
28,32,1468,22,13,9
28,32,277,10,5,5
28,32,364,14,7,7
28,32,2695,16,5,11
28,32,1692,27,13,14
28,32,1172,118,52,66
28,32,1163,5,3,2
28,32,772,21,9,12
28,32,1295,78,41,37
28,32,1075,3,1,2
28,32,1353,4,4,0
28,32,1178,1,1,0
28,32,2171,3,2,1
28,32,781,1,0,1
28,32,1256,5,2,3
28,32,1662,6,0,6
28,32,1401,2,2,0
28,32,1117,0,0,0
28,32,805,10,5,5
28,32,1014,3,0,3
28,32,1371,3,2,1
28,32,1137,1,1,0
28,32,4139,17,9,8
28,32,1087,0,0,0
28,32,1455,0,0,0
28,32,808,0,0,0
28,32,1907,23,7,16
28,27,959,5,3,2
28,27,633,2,0,2
28,27,677,26,11,15
28,27,484,22,9,13
28,27,1104,30,13,17
28,27,1841,17,9,8
28,27,1040,8,4,4
28,27,607,1,1,0
28,27,639,0,0,0
28,27,763,1,0,1
28,27,672,4,3,1
28,27,455,0,0,0
28,27,519,0,0,0
28,27,634,0,0,0
28,27,694,2,2,0
28,27,847,7,4,3
28,27,712,1,0,1
28,27,747,3,1,2
28,27,1034,0,0,0
28,27,1335,21,12,9
28,27,1438,17,11,6
28,27,779,2,1,1
28,27,1552,3,0,3
28,27,709,4,2,2
28,27,710,3,2,1
28,27,1195,7,0,7
28,27,1514,809,413,396
28,27,1310,9,4,5
28,27,2429,7,4,3
28,27,1281,14,4,10
28,27,2027,70,35,35
28,27,1426,5,2,3
28,27,994,2,1,1
28,27,1897,17,8,9
28,32,1277,1,1,0
28,32,1817,10,4,6
28,32,1432,12,7,5
28,32,1087,7,3,4
28,32,720,1,1,0
28,32,824,3,3,0
28,32,406,2,0,2
28,32,995,5,4,1
28,32,976,12,6,6
28,32,828,1,1,0
28,32,690,8,3,5
28,32,1410,15,7,8
28,32,788,11,4,7
28,32,798,2,1,1
28,32,1231,1,1,0
28,32,862,15,9,6
28,32,816,3,1,2
28,32,833,6,3,3
28,32,725,0,0,0
28,32,951,4,3,1
28,32,1339,8,5,3
28,32,740,0,0,0
28,32,613,6,3,3
28,32,2058,5,3,2
28,32,5157,13,2,11
28,32,662,2,2,0
28,32,1576,1,0,1
28,32,1477,67,29,38
28,32,978,6,2,4
28,32,5423,13,8,5
28,32,2349,16,9,7
28,32,977,4,2,2
28,32,1232,3,2,1
28,32,1017,7,5,2
28,32,963,16,10,6
28,32,1145,7,3,4
28,32,1124,9,4,5
28,32,930,11,2,9
28,32,4415,36,16,20
28,32,1593,21,8,13
28,32,1612,44,21,23
28,32,1671,51,24,27
28,32,1169,0,0,0
28,32,2587,258,141,117
28,32,842,15,8,7
28,32,9119,63,30,33
28,32,1271,15,4,11
28,32,1475,74,38,36
28,32,1678,11,7,4
28,32,1782,39,17,22
28,32,1835,29,19,10
28,32,1881,7,3,4
28,32,1518,23,13,10
28,32,1601,45,22,23
28,32,1173,8,2,6
28,32,1889,53,15,38
28,32,6275,154,69,85
28,32,1418,69,35,34
28,32,1629,6,3,3
28,32,1617,16,10,6
28,32,2225,13,5,8
28,32,1590,135,64,71
28,32,2555,45,19,26
28,32,781,19,8,11
28,32,431,9,5,4
28,32,502,6,2,4
28,32,429,0,0,0
28,32,430,3,0,3
28,32,699,4,0,4
28,32,763,2,0,2
28,32,402,0,0,0
28,32,741,3,3,0
28,32,375,29,16,13
28,32,515,2,2,0
28,32,892,20,11,9
28,32,466,2,1,1
28,32,573,31,15,16
28,32,1150,6,2,4
28,32,650,3,2,1
28,32,473,17,9,8
28,32,1427,0,0,0
28,32,1561,5,2,3
28,32,416,30,18,12
28,32,634,1,0,1
28,32,815,8,7,1
28,32,578,5,4,1
28,32,1081,6,3,3
28,32,449,6,2,4
28,32,1023,25,16,9
28,32,2037,7,5,2
28,32,3241,53,26,27
28,32,1310,5,2,3
28,32,1238,3,0,3
28,32,984,3,2,1
28,32,1029,27,15,12
28,32,1723,12,7,5
28,32,1606,8,4,4
28,32,1123,121,65,56
28,32,887,1,1,0
28,32,833,4,3,1
28,32,1041,3,1,2
28,32,1253,10,6,4
28,32,2310,21,8,13
28,32,588,3,2,1
28,32,633,15,8,7
28,32,943,3,2,1
28,32,734,5,1,4
28,32,1120,5,2,3
28,32,679,0,0,0
28,32,707,6,2,4
28,32,437,3,2,1
28,32,1342,6,4,2
28,32,558,2,1,1
28,32,732,0,0,0
28,32,631,4,2,2
28,32,776,5,2,3
28,32,1037,14,9,5
28,32,1457,5,2,3
28,32,748,25,12,13
28,32,475,7,3,4
28,32,517,11,2,9
28,32,679,36,16,20
28,32,628,4,3,1
28,32,435,5,2,3
28,32,1077,7,4,3
28,32,565,1,1,0
28,32,320,12,6,6
28,27,257,1,1,0
28,27,1788,4,3,1
28,27,3162,7,2,5
28,27,2275,19,8,11
28,27,1708,6,3,3
28,27,2140,5,2,3
28,27,1509,4,0,4
28,27,1339,8,4,4
28,27,1489,3,1,2
28,27,1461,10,5,5
28,27,1443,9,5,4
28,27,1823,6,0,6
28,27,1508,5,1,4
28,27,4233,34,15,19
28,27,3297,24,12,12
28,27,2011,0,0,0
28,27,1946,3,1,2
28,27,2501,7,5,2
28,22,2750,10,4,6
28,22,4101,18,10,8
28,22,2373,27,15,12
28,22,2390,38,15,23
28,22,3096,114,63,51
28,22,2127,5,2,3
28,22,2461,9,2,7
28,22,3361,37,15,22
28,22,1096,4,1,3
28,22,2397,5,1,4
28,22,8862,86,42,44
28,22,3293,361,174,187
28,22,2819,17,8,9
28,22,2631,6,4,2
28,3,3039,29,15,14
28,3,8829,127,59,68
28,3,2090,31,14,17
28,3,1710,34,17,17
28,3,1925,16,6,10
28,3,1485,6,2,4
28,3,1513,17,10,7
28,3,2473,22,8,14
28,3,2491,66,33,33
28,3,3452,54,30,24
28,3,2072,10,6,4
28,3,3370,41,17,24
28,3,1719,34,14,20
28,3,1403,26,12,14
28,3,1830,29,17,12
28,3,1756,9,3,6
28,3,2699,31,12,19
28,3,2378,10,3,7
28,22,3174,10,3,7
28,22,3073,25,8,17
28,22,1582,8,4,4
28,22,4574,46,20,26
28,22,5890,87,44,43
28,22,4514,29,14,15
28,22,3782,11,5,6
28,22,3688,5,4,1
28,22,2145,21,10,11
28,22,1780,0,0,0
28,32,461,0,0,0
28,32,3031,11,4,7
28,32,3859,18,11,7
28,32,4165,32,14,18
28,32,4174,7,3,4
28,32,2328,25,13,12
28,32,4591,56,25,31
28,32,4839,27,12,15
28,32,3906,9,4,5
28,32,3058,14,8,6
28,22,2452,19,7,12
28,22,2403,7,3,4
29,1,1954,20,10,10
29,1,4861,77,37,40
29,1,4129,18,6,12
29,1,1094,1,1,0
29,2,3765,28,16,12
29,2,1170,11,5,6
29,2,411,1,1,0
29,2,3087,15,8,7
29,2,2787,76,35,41
29,2,4462,24,14,10
29,2,1213,4,3,1
29,3,1127,53,31,22
29,3,2824,34,21,13
29,3,7232,45,19,26
29,3,1936,0,0,0
29,3,1939,27,11,16
29,3,1193,12,10,2
29,3,1016,5,2,3
29,3,1001,6,0,6
29,3,1493,5,1,4
29,3,525,1,1,0
29,3,1525,6,2,4
29,3,512,2,1,1
29,3,724,6,4,2
29,3,1580,45,26,19
29,3,1608,2,2,0
29,3,1722,20,12,8
29,3,1352,85,45,40
29,3,1961,10,5,5
29,3,8737,223,119,104
29,3,3654,19,9,10
29,3,2613,37,15,22
29,3,2916,12,5,7
29,3,949,8,3,5
29,3,1525,44,23,21
29,3,1872,34,19,15
29,3,1306,14,6,8
29,3,1584,0,0,0
29,3,1504,2,1,1
29,3,3660,16,9,7
29,3,4354,73,38,35
29,3,926,9,4,5
29,3,5172,85,46,39
29,3,3331,28,16,12
29,3,626,8,4,4
29,3,2822,59,26,33
29,3,3454,98,55,43
29,3,579,12,8,4
29,4,1000,3,1,2
29,4,447,0,0,0
29,4,538,0,0,0
29,4,171,0,0,0
29,4,1601,6,2,4
29,4,642,0,0,0
29,4,365,7,5,2
29,4,1734,6,4,2
29,4,593,6,4,2
29,34,291,0,0,0
29,5,1345,86,41,45
29,5,1156,18,8,10
29,5,593,0,0,0
29,5,445,2,0,2
29,5,510,2,0,2
29,5,309,25,11,14
29,5,307,5,2,3
29,5,683,3,1,2
29,5,274,0,0,0
29,5,2995,32,13,19
29,5,1177,0,0,0
29,5,770,2,0,2
29,5,1384,0,0,0
29,5,1102,0,0,0
29,5,437,0,0,0
29,5,1649,74,35,39
29,5,680,4,2,2
29,5,173,0,0,0
29,5,2022,44,15,29
29,6,6990,78,35,43
29,6,2792,44,29,15
29,6,1681,57,36,21
29,6,2673,58,30,28
29,6,3561,82,35,47
29,6,3241,18,11,7
29,6,926,6,2,4
29,6,2645,60,31,29
29,6,2787,20,11,9
29,6,1301,8,6,2
29,6,1536,20,9,11
29,6,2907,20,12,8
29,6,5000,16,8,8
29,6,1142,0,0,0
29,6,3124,10,6,4
29,6,1979,3,2,1
29,6,1258,2,0,2
29,6,664,158,77,81
29,6,1053,0,0,0
29,6,1416,0,0,0
29,6,2515,73,35,38
29,7,4744,9,5,4
29,7,2896,27,14,13
29,7,2721,6,3,3
29,7,1745,0,0,0
29,7,4022,19,11,8
29,7,687,0,0,0
29,7,354,0,0,0
29,8,4137,20,15,5
29,8,2429,60,34,26
29,8,3541,60,24,36
29,8,2237,10,4,6
29,8,358,0,0,0
29,8,258,0,0,0
29,8,523,47,20,27
29,8,1437,2,2,0
29,8,752,8,3,5
29,8,698,0,0,0
29,9,1812,14,7,7
29,9,1402,4,2,2
29,9,798,2,1,1
29,9,383,3,0,3
29,9,1613,2,0,2
29,10,2043,6,2,4
29,10,2314,22,10,12
29,10,2506,0,0,0
29,10,2532,16,9,7
29,10,3586,16,6,10
29,10,3480,26,17,9
29,10,1490,30,17,13
29,10,1243,2,2,0
29,10,614,6,4,2
29,10,1270,6,4,2
29,10,1409,18,7,11
29,10,1195,2,1,1
29,10,1084,13,5,8
29,10,1585,10,5,5
29,10,510,20,14,6
29,10,2992,27,13,14
29,10,1239,16,4,12
29,10,2990,39,17,22
29,10,2860,18,10,8
29,10,5670,54,33,21
29,10,3256,58,32,26
29,10,2090,88,39,49
29,10,5749,44,26,18
29,10,2946,11,7,4
29,10,2287,17,6,11
29,10,2244,3,0,3
29,10,3071,6,3,3
29,10,4388,293,148,145
29,10,1195,12,7,5
29,52,7320,64,30,34
29,52,4146,23,10,13
29,52,2192,35,21,14
29,52,2364,13,7,6
29,52,2835,30,16,14
29,10,2733,96,47,49
29,10,1580,134,67,67
29,51,4447,165,84,81
29,51,3484,19,12,7
29,51,4063,162,82,80
29,11,2507,37,21,16
29,11,1365,4,4,0
29,11,643,6,3,3
29,11,656,4,1,3
29,12,3177,10,5,5
29,12,323,1,1,0
29,12,1079,1,0,1
29,12,324,0,0,0
29,12,975,7,4,3
29,12,461,0,0,0
29,12,433,0,0,0
29,12,486,1,0,1
29,12,340,0,0,0
29,12,751,4,3,1
29,12,507,8,6,2
29,12,471,1,1,0
29,13,5661,42,21,21
29,13,6019,36,18,18
29,13,6558,17,7,10
29,13,2452,9,5,4
29,13,2077,13,6,7
29,13,3191,7,5,2
29,13,2363,2,1,1
29,13,1759,17,9,8
29,13,1257,0,0,0
29,13,2276,5,4,1
29,13,7119,28,7,21
29,13,1689,4,0,4
29,13,1064,5,1,4
29,13,1706,10,4,6
29,13,2918,10,4,6
29,13,541,2,0,2
29,13,3651,3,1,2
29,13,3127,16,6,10
29,13,1666,3,1,2
29,13,355,1,0,1
29,13,792,1,1,0
29,13,1128,3,2,1
29,13,2078,1,0,1
29,13,5808,50,24,26
29,13,827,35,18,17
29,13,3224,20,7,13
29,13,4119,136,64,72
29,13,487,0,0,0
29,13,1879,52,30,22
29,13,1107,20,12,8
29,13,1269,5,2,3
29,13,1238,0,0,0
29,13,426,7,1,6
29,13,1446,0,0,0
29,13,816,8,2,6
29,13,4522,15,6,9
29,13,3484,10,6,4
29,13,491,1,1,0
29,13,1684,4,2,2
29,13,1486,2,1,1
29,13,982,0,0,0
29,13,2136,14,6,8
29,14,3096,42,18,24
29,14,2814,30,17,13
29,14,1773,8,2,6
29,14,512,0,0,0
29,14,961,0,0,0
29,14,426,1,0,1
29,14,712,3,2,1
29,14,891,0,0,0
29,14,2821,7,2,5
29,14,135,0,0,0
29,14,714,24,13,11
29,14,340,8,5,3
29,15,2895,31,17,14
29,15,1962,10,3,7
29,15,1534,8,5,3
29,15,269,1,0,1
29,15,365,0,0,0
29,15,420,17,5,12
29,15,318,1,0,1
29,15,558,17,10,7
29,15,1217,8,2,6
29,15,2638,22,6,16
29,15,2174,12,7,5
29,15,401,1,0,1
29,15,670,1,0,1
29,15,3310,34,19,15
29,15,1058,6,4,2
29,15,2130,27,11,16
29,15,1651,2,0,2
29,15,861,15,6,9
29,15,1510,11,7,4
29,15,4212,11,6,5
29,15,2993,11,5,6
29,15,2108,48,26,22
29,58,4245,269,137,132
29,58,3687,49,29,20
29,15,2005,6,2,4
29,15,1075,2,1,1
29,15,637,0,0,0
29,16,2126,3,2,1
29,16,1709,5,3,2
29,16,2065,11,7,4
29,16,1611,51,27,24
29,17,2636,42,20,22
29,17,3654,449,214,235
29,17,3164,144,63,81
29,17,2080,35,16,19
29,18,2494,41,23,18
29,18,3617,49,28,21
29,18,2257,4,1,3
29,18,2386,8,4,4
29,18,1898,6,2,4
29,18,4162,148,75,73
29,18,2817,18,9,9
29,18,1778,14,8,6
29,18,2431,19,8,11
29,18,3006,23,10,13
29,18,1153,17,10,7
29,18,957,7,3,4
29,18,2272,83,40,43
29,18,692,22,12,10
29,18,2725,27,11,16
29,18,782,2,1,1
29,18,2071,34,16,18
29,19,1931,13,9,4
29,19,1546,5,3,2
29,19,3194,43,22,21
29,19,2698,15,6,9
29,19,5714,7,1,6
29,19,2042,0,0,0
29,19,3995,7,4,3
29,19,1137,5,2,3
29,20,2089,19,15,4
29,20,137,1,1,0
29,20,3170,43,20,23
29,60,3874,27,13,14
29,60,2362,8,5,3
29,20,1890,28,17,11
29,20,2121,26,11,15
29,21,3859,17,7,10
29,21,2253,3,1,2
29,21,3059,8,3,5
29,21,3441,38,19,19
29,21,1078,11,6,5
29,21,1380,9,6,3
29,21,560,1,1,0
29,21,282,1,0,1
29,21,886,40,22,18
29,21,1869,4,1,3
29,22,1758,7,4,3
29,22,2157,14,9,5
29,22,1680,2,1,1
29,22,996,11,7,4
29,46,2756,32,16,16
29,46,2656,14,11,3
29,46,2172,22,11,11
29,45,2150,21,11,10
29,45,2316,24,10,14
29,23,942,3,2,1
29,23,4025,41,20,21
29,23,671,1,1,0
29,23,1408,2,0,2
29,23,1476,58,32,26
29,23,2723,13,8,5
29,23,1218,20,9,11
29,23,1857,6,1,5
29,23,3072,19,16,3
29,23,2199,7,5,2
29,23,1205,4,2,2
29,23,2588,9,5,4
29,23,1214,17,10,7
29,23,2008,38,17,21
29,24,534,0,0,0
29,24,1947,16,11,5
29,24,1349,4,1,3
29,24,807,0,0,0
29,24,4260,173,136,37
29,24,2381,51,28,23
29,24,3627,18,8,10
29,24,906,12,7,5
29,24,853,31,14,17
29,24,159,1,1,0
29,24,2500,10,4,6
29,24,978,3,3,0
29,24,1067,51,24,27
29,24,2167,10,4,6
29,24,2285,23,10,13
29,24,2537,50,23,27
29,25,5540,41,13,28
29,25,6284,49,28,21
29,25,7559,55,26,29
29,25,5410,41,21,20
29,25,3203,16,10,6
29,25,5369,211,98,113
29,25,4455,24,10,14
29,25,3319,15,9,6
29,25,4935,9,6,3
29,25,3421,10,6,4
29,25,4121,21,12,9
29,25,3741,8,1,7
29,25,3286,50,23,27
29,25,4032,178,75,103
29,25,6549,59,31,28
29,25,7463,28,15,13
29,25,4194,4,2,2
29,26,5252,85,44,41
29,26,3447,83,44,39
29,26,2782,37,18,19
29,26,2542,14,6,8
29,26,2952,29,17,12
29,26,2256,26,16,10
29,26,3794,48,25,23
29,27,1807,1,0,1
29,27,1636,17,9,8
29,27,1609,28,14,14
29,27,3049,23,13,10
29,27,2322,28,11,17
29,27,2524,35,16,19
29,28,2607,19,12,7
29,28,3344,16,6,10
29,28,6084,25,9,16
29,28,2514,9,5,4
29,28,2170,17,11,6
29,28,2335,15,5,10
29,28,2579,20,7,13
29,28,751,4,1,3
29,28,2579,20,12,8
29,29,2335,38,22,16
29,29,1811,11,6,5
29,29,1085,7,6,1
29,29,1293,9,4,5
29,49,2251,27,14,13
29,49,2059,26,16,10
29,29,1472,2,0,2
29,29,3224,10,4,6
29,47,4262,55,28,27
29,47,3378,183,103,80
29,29,2461,18,9,9
29,30,3874,13,5,8
29,30,2330,30,17,13
29,54,119,0,0,0
29,54,175,1,0,1
29,55,399,0,0,0
29,30,1604,1,1,0
29,30,3673,68,38,30
29,30,373,10,6,4
29,30,577,0,0,0
29,30,1084,1,1,0
29,30,1964,4,0,4
29,31,1874,170,87,83
29,31,2089,22,10,12
29,31,3889,66,32,34
29,31,4829,73,42,31
29,31,1526,22,12,10
29,31,1177,5,3,2
29,31,1126,30,15,15
29,31,1598,2,2,0
29,31,512,5,2,3
29,31,678,101,51,50
29,31,924,23,9,14
29,31,3095,8,6,2
29,31,3977,15,7,8
29,31,6868,40,17,23
29,31,451,3,1,2
29,32,2295,4,3,1
29,32,1879,16,6,10
29,32,1899,25,16,9
29,32,2767,26,13,13
29,32,2117,36,17,19
29,53,2719,57,25,32
29,53,3155,324,164,160
29,32,1618,19,14,5
29,56,1808,7,5,2
29,56,2289,86,45,41
29,32,887,0,0,0
29,33,2241,16,8,8
29,33,2783,8,5,3
29,33,1966,28,15,13
29,33,2251,151,73,78
29,33,2985,11,7,4
29,33,2166,26,14,12
29,33,738,12,6,6
29,33,1075,11,6,5
29,33,446,6,3,3
29,33,5367,45,23,22
29,33,1883,21,10,11
29,33,594,9,5,4
29,33,583,2,2,0
29,33,2853,21,13,8
29,33,1218,23,17,6
29,33,600,4,2,2
29,33,2087,43,27,16
29,33,1731,12,6,6
29,33,10795,80,40,40
29,33,953,31,17,14
29,33,849,17,5,12
29,33,2593,22,8,14
29,33,1454,2,1,1
29,33,8452,49,21,28
29,33,2272,20,10,10
29,33,1447,22,13,9
29,33,2509,29,15,14
29,33,3296,26,9,17
29,33,2044,25,11,14
29,33,7162,117,62,55
29,33,6396,118,67,51
29,33,7381,74,42,32
29,33,2104,39,23,16
29,33,3204,85,42,43
29,33,1981,17,8,9
29,34,1612,6,4,2
29,34,2270,2,1,1
29,34,1901,8,3,5
29,34,1409,2,1,1
29,34,2905,4,3,1
29,34,1356,1,0,1
29,34,4712,16,12,4
29,34,1189,5,3,2
29,34,620,4,2,2
29,34,501,0,0,0
29,34,258,0,0,0
29,34,2580,9,4,5
29,34,2756,7,3,4
29,34,152,2,1,1
29,34,2608,9,2,7
29,34,924,0,0,0
29,34,776,5,2,3
29,34,182,3,1,2
29,34,1866,3,2,1
29,34,106,3,1,2
29,34,262,0,0,0
29,34,3641,13,7,6
29,34,617,1,1,0
29,34,657,7,2,5
29,34,1221,1,0,1
29,34,1177,4,2,2
29,34,860,1,1,0
29,34,665,2,1,1
29,34,263,2,2,0
29,34,1598,18,10,8
29,34,666,1,0,1
29,34,1851,9,2,7
29,34,544,2,0,2
29,34,220,0,0,0
29,34,356,0,0,0
29,35,2403,3,2,1
29,35,3034,24,8,16
29,35,786,0,0,0
29,36,1106,3,1,2
29,36,1439,15,6,9
29,36,1556,1,1,0
29,36,1652,13,5,8
29,36,2461,89,51,38
29,36,2831,367,191,176
29,36,1146,55,23,32
29,36,2522,30,15,15
29,36,2364,4,2,2
29,36,2122,36,17,19
29,36,2262,25,12,13
29,36,1217,31,20,11
29,37,1964,5,5,0
29,37,1550,2,1,1
29,37,1830,3,1,2
29,37,1584,1,0,1
29,37,943,2,1,1
29,37,1336,8,3,5
29,37,0,0,0,0
29,38,2099,28,14,14
29,38,1895,26,15,11
29,50,1872,12,8,4
29,50,1081,5,3,2
29,50,890,9,6,3
29,50,1694,8,3,5
29,50,884,0,0,0
29,38,1001,0,0,0
29,38,313,1,1,0
29,39,3448,56,27,29
29,39,3265,48,17,31
29,39,4775,206,104,102
29,39,3980,54,26,28
29,39,3884,73,37,36
29,39,3076,680,342,338
29,39,1058,10,6,4
29,39,1086,1,1,0
29,39,1155,3,0,3
29,40,1033,6,4,2
29,40,2593,20,13,7
29,40,1846,19,10,9
29,40,1771,68,36,32
29,57,1813,4,3,1
29,57,1243,2,2,0
29,40,510,0,0,0
29,40,196,0,0,0
29,40,871,1,1,0
29,40,1042,2,2,0
29,40,890,16,8,8
29,41,3727,20,9,11
29,41,1950,11,5,6
29,41,3458,25,15,10
29,41,3788,24,12,12
29,41,3236,23,11,12
29,41,2800,61,38,23
29,41,2546,23,8,15
29,41,2074,7,5,2
29,41,2014,6,2,4
29,41,1976,5,1,4
29,41,2933,7,4,3
29,41,1745,0,0,0
29,42,3682,35,18,17
29,42,1982,9,4,5
29,42,2392,64,33,31
29,42,2302,286,153,133
29,42,4502,437,244,193
29,43,2704,21,12,9
29,43,2473,10,2,8
29,43,995,3,3,0
29,43,1535,8,4,4
29,43,1433,8,3,5
29,43,4343,11,4,7
29,43,6369,46,25,21
29,43,8148,106,48,58
29,43,6109,31,13,18
29,43,2190,7,2,5
29,43,3932,41,18,23
29,59,2388,608,309,299
29,59,2325,243,108,135
29,44,1943,8,3,5
29,44,2982,94,50,44
29,44,4704,117,48,69
29,44,3014,31,13,18
29,44,5641,20,7,13
29,44,2763,67,32,35
29,44,3473,9,6,3
29,44,2989,21,11,10
29,44,1613,54,30,24
29,44,2162,49,25,24
29,44,3152,12,7,5
29,44,3628,82,42,40
29,44,4991,184,100,84
29,44,3619,34,17,17
29,48,2650,12,5,7
29,48,2184,4,4,0
29,48,3599,55,22,33
29,48,1622,18,8,10
29,55,3120,2,1,1
29,54,3429,7,3,4
29,54,1224,0,0,0
29,26,1460,13,6,7
29,12,89,2,1,1
29,36,46,4,2,2
29,33,254,8,2,6
29,38,3836,60,29,31
29,38,2894,8,4,4
29,38,3525,37,15,22
29,38,2435,21,7,14
30,1,2842,12,5,7
30,1,2372,32,18,14
30,1,3487,8,4,4
30,1,1084,1,1,0
30,2,1826,114,59,55
30,2,1918,43,22,21
30,3,5821,74,40,34
30,3,1861,43,19,24
30,3,2888,20,8,12
30,3,2828,6,2,4
30,3,1149,8,2,6
30,3,979,11,6,5
30,3,912,9,3,6
30,3,2960,64,37,27
30,3,1661,119,57,62
30,3,935,16,7,9
30,3,340,0,0,0
30,3,905,10,7,3
30,3,695,13,5,8
30,3,919,20,10,10
30,3,719,13,9,4
30,3,3471,21,13,8
30,3,1978,26,17,9
30,3,1806,6,3,3
30,3,1948,21,9,12
30,3,2285,15,6,9
30,3,2342,16,6,10
30,3,888,16,8,8
30,3,884,27,15,12
30,3,1279,11,6,5
30,3,2664,9,5,4
30,3,2513,8,4,4
30,3,1320,15,3,12
30,3,2032,13,3,10
30,3,1542,31,14,17
30,3,2289,15,11,4
30,3,2728,6,3,3
30,3,2564,6,2,4
30,3,2168,6,2,4
30,3,1383,106,58,48
30,3,1512,6,2,4
30,3,2941,47,19,28
30,3,4366,46,14,32
30,3,2675,16,10,6
30,3,3465,4,3,1
30,3,1305,12,3,9
30,4,2510,9,4,5
30,4,1664,0,0,0
30,4,1377,7,3,4
30,4,1366,10,6,4
30,4,1973,38,28,10
30,4,2819,2296,1213,1083
30,4,1376,1,0,1
30,4,390,0,0,0
30,4,823,8,2,6
30,4,600,0,0,0
30,4,941,2,1,1
30,4,368,29,12,17
30,4,530,30,17,13
30,4,1102,14,4,10
30,4,1278,26,12,14
30,4,432,3,2,1
30,4,1078,26,13,13
30,4,444,6,4,2
30,4,748,0,0,0
30,4,934,0,0,0
30,4,1004,5,1,4
30,4,1121,6,3,3
30,4,2458,5,3,2
30,4,1899,14,7,7
30,4,1040,12,6,6
30,4,684,1,0,1
30,4,637,16,9,7
30,4,1192,27,14,13
30,4,1224,7,2,5
30,4,1992,5,2,3
30,4,1166,1,0,1
30,4,229,0,0,0
30,4,579,7,5,2
30,4,315,4,0,4
30,4,402,0,0,0
30,4,297,0,0,0
30,4,1029,6,3,3
30,4,1374,5,2,3
30,5,1596,24,10,14
30,5,1270,28,12,16
30,5,280,1,1,0
30,5,541,0,0,0
30,5,418,2,1,1
30,5,33,0,0,0
30,5,904,2,0,2
30,6,3912,21,11,10
30,6,1809,6,2,4
30,6,1635,0,0,0
30,6,1949,3,2,1
30,6,721,1,0,1
30,6,1929,6,4,2
30,6,2403,3,2,1
30,6,836,2,2,0
30,6,1252,2,1,1
30,6,2194,2,1,1
30,6,441,0,0,0
30,6,730,4,3,1
30,6,1174,1,1,0
30,6,1892,20,11,9
30,7,2677,36,19,17
30,7,2859,1,0,1
30,7,1027,1,1,0
30,8,1461,6,4,2
30,8,3196,25,11,14
30,8,1257,7,3,4
30,8,1460,7,3,4
30,8,932,28,13,15
30,8,1735,2,2,0
30,8,1557,0,0,0
30,8,1813,4,3,1
30,8,1239,25,15,10
30,8,2109,1,0,1
30,8,1441,7,3,4
30,8,2161,45,26,19
30,8,5798,60,35,25
30,8,874,0,0,0
30,8,1127,3,1,2
30,8,671,2,2,0
30,8,712,1,1,0
30,8,772,1,0,1
30,8,184,0,0,0
30,8,1197,4,3,1
30,8,2113,7,2,5
30,8,2511,13,9,4
30,8,1381,7,4,3
30,8,922,6,3,3
30,8,1327,3,1,2
30,8,598,0,0,0
30,8,2203,12,6,6
30,8,1984,18,6,12
30,8,1286,0,0,0
30,8,704,5,2,3
30,8,1696,5,4,1
30,8,2290,8,5,3
30,8,1474,0,0,0
30,8,1956,10,5,5
30,8,1386,4,1,3
30,8,707,0,0,0
30,8,1232,6,2,4
30,8,1630,11,6,5
30,8,1448,19,12,7
30,8,1048,16,8,8
30,8,833,2,0,2
30,8,1550,0,0,0
30,8,852,7,5,2
30,8,2386,60,29,31
30,8,3194,38,27,11
30,8,1083,28,14,14
30,8,2164,105,58,47
30,8,1064,1,0,1
30,8,2386,0,0,0
30,8,1491,586,283,303
30,8,1188,7,2,5
30,8,2098,2,2,0
30,8,1396,4,2,2
30,8,2702,3,1,2
30,8,1799,16,9,7
30,8,1496,0,0,0
30,8,1359,8,6,2
30,8,763,1,1,0
30,8,1968,19,10,9
30,8,2324,18,11,7
30,8,1443,13,4,9
30,8,1273,360,173,187
30,8,2392,198,97,101
30,8,911,1,0,1
30,8,1314,2,0,2
30,8,1157,2,0,2
30,8,1683,5,1,4
30,8,1019,2,1,1
30,8,611,497,267,230
30,9,2707,17,8,9
30,9,1570,2,2,0
30,9,2669,9,7,2
30,9,1484,2,1,1
30,9,1908,0,0,0
30,10,1059,37,23,14
30,10,1773,59,33,26
30,10,998,1,1,0
30,10,1408,0,0,0
30,10,829,2,1,1
30,10,356,0,0,0
30,10,146,0,0,0
30,10,245,0,0,0
30,10,418,8,3,5
30,10,899,5,1,4
30,10,407,1,1,0
30,10,366,1,1,0
30,10,1897,44,24,20
30,10,1113,3,1,2
30,10,446,0,0,0
30,10,583,1,0,1
30,10,394,0,0,0
30,10,1423,1,0,1
30,10,324,0,0,0
30,10,534,1,0,1
30,10,123,0,0,0
30,10,1281,1,1,0
30,10,1046,2,1,1
30,10,811,0,0,0
30,10,560,1,0,1
30,10,837,3,2,1
30,10,994,0,0,0
30,10,714,0,0,0
30,10,612,0,0,0
30,10,538,0,0,0
30,10,1580,1,0,1
30,10,1712,22,17,5
30,10,1727,43,18,25
30,11,7588,28,17,11
30,11,7262,23,8,15
30,11,2057,7,4,3
30,11,154,0,0,0
30,11,2100,10,6,4
30,11,2667,10,6,4
30,11,1236,6,4,2
30,11,1002,1,0,1
30,11,487,0,0,0
30,11,1267,3,1,2
30,11,1652,3,2,1
30,11,1858,3,2,1
30,11,1539,1,0,1
30,11,902,0,0,0
30,11,604,2,0,2
30,11,1710,1,0,1
30,11,1555,4,2,2
30,11,1573,1,1,0
30,11,1491,3,2,1
30,11,2993,2,1,1
30,11,3273,3,1,2
30,11,5833,20,12,8
30,11,2545,0,0,0
30,11,1665,2,1,1
30,11,2219,12,7,5
30,11,2418,3,2,1
30,11,2256,4,1,3
30,11,1858,0,0,0
30,11,674,4,2,2
30,12,2288,566,314,252
30,12,660,287,155,132
30,12,1709,82,46,36
30,12,994,49,25,24
30,12,2531,123,63,60
30,12,1646,30,18,12
30,12,274,42,20,22
30,12,1440,82,44,38
30,12,1386,248,135,113
30,12,183,1,0,1
30,12,1064,14,6,8
30,12,723,7,4,3
30,12,798,11,8,3
30,12,1480,39,23,16
30,12,597,1,0,1
30,12,640,1,1,0
30,12,712,2,0,2
30,12,274,0,0,0
30,12,863,9,4,5
30,12,2634,38,18,20
30,12,2845,29,15,14
30,12,8876,239,124,115
30,12,879,5,4,1
30,12,757,34,14,20
30,12,2733,34,11,23
30,12,3526,86,38,48
30,12,1309,7,3,4
30,12,1229,38,20,18
30,12,646,2,1,1
30,12,1649,75,35,40
30,12,512,7,6,1
30,12,485,194,97,97
30,12,514,180,86,94
30,12,1410,149,83,66
30,12,646,11,7,4
30,12,1828,12,4,8
30,12,2455,13,4,9
30,12,1352,6,4,2
30,12,481,0,0,0
30,12,353,27,9,18
30,13,1323,76,31,45
30,13,1468,17,7,10
30,13,1245,3,1,2
30,13,964,10,4,6
30,13,1127,4,2,2
30,13,636,0,0,0
30,13,1309,195,86,109
30,14,2312,30,16,14
30,14,2552,17,8,9
30,14,2392,16,10,6
30,14,2536,67,31,36
30,14,1142,7,2,5
30,14,893,1,0,1
30,14,1112,12,11,1
30,14,1891,20,8,12
30,14,325,0,0,0
30,14,833,26,15,11
30,14,1030,27,14,13
30,14,2614,47,20,27
30,14,2508,14,8,6
30,14,2816,94,43,51
30,14,1510,69,37,32
30,14,1526,21,11,10
30,14,3190,28,17,11
30,14,558,7,6,1
30,14,1300,0,0,0
30,14,4605,20,9,11
30,14,859,16,9,7
30,14,1759,70,34,36
30,14,753,26,12,14
30,14,1510,30,16,14
30,14,2212,23,12,11
30,14,382,3,1,2
30,15,1035,15,10,5
30,15,1347,27,16,11
30,15,1329,115,61,54
30,15,950,156,85,71
30,15,1742,36,13,23
30,15,1333,31,19,12
30,15,321,18,8,10
30,15,738,57,31,26
30,15,2640,199,102,97
30,15,1657,25,15,10
30,15,3122,18,9,9
30,15,1121,9,5,4
30,15,1516,14,7,7
30,15,773,3,1,2
30,15,1112,8,5,3
30,15,2292,72,43,29
30,15,1678,11,6,5
30,15,608,28,15,13
30,15,1302,1,0,1
30,16,2621,132,76,56
30,16,1296,6,3,3
30,16,934,13,6,7
30,16,2075,9,3,6
30,16,2206,12,3,9
30,16,2023,90,44,46
30,16,1322,17,10,7
30,16,1838,13,5,8
30,16,267,1,1,0
30,16,765,8,4,4
30,16,2218,14,5,9
30,16,1399,7,4,3
30,16,782,2,0,2
30,16,1268,5,2,3
30,16,1537,43,24,19
30,16,2432,6,4,2
30,16,1191,28,14,14
30,16,1183,6,4,2
30,16,765,0,0,0
30,16,1368,1,0,1
30,16,348,1,0,1
30,16,1760,12,6,6
30,16,819,0,0,0
30,16,1101,3,1,2
30,17,923,21,11,10
30,17,1949,49,20,29
30,17,888,23,15,8
30,17,624,9,5,4
30,17,1001,32,15,17
30,17,1561,38,17,21
30,17,2510,158,78,80
30,17,630,259,136,123
30,17,662,0,0,0
30,17,409,7,3,4
30,17,769,8,4,4
30,17,1584,9,8,1
30,17,2999,67,32,35
30,17,4485,188,97,91
30,17,1783,120,52,68
30,17,802,12,6,6
30,17,1214,374,200,174
30,17,729,4,2,2
30,17,3440,149,78,71
30,17,915,2,0,2
30,17,945,68,39,29
30,18,833,29,17,12
30,18,1630,24,12,12
30,18,945,33,16,17
30,18,844,8,4,4
30,18,414,9,3,6
30,19,1978,455,230,225
30,20,1978,7,2,5
30,20,3081,114,57,57
30,20,1823,4,2,2
30,21,2941,57,30,27
30,21,293,0,0,0
30,21,655,1,0,1
30,21,1114,9,7,2
30,21,2705,14,8,6
30,22,1101,6,3,3
30,22,2134,14,10,4
30,22,1445,5,3,2
30,22,851,0,0,0
30,22,630,0,0,0
30,22,958,9,5,4
30,22,477,31,14,17
30,22,2511,25,12,13
30,22,1153,181,97,84
30,22,1263,16,8,8
30,22,2377,77,36,41
30,22,1228,25,10,15
30,22,2270,65,36,29
30,22,2758,18,6,12
30,22,1198,236,122,114
30,22,714,3,1,2
30,23,1647,15,9,6
30,23,2191,24,8,16
30,23,1621,14,3,11
30,23,2119,35,21,14
30,23,1942,14,8,6
30,23,2611,5,2,3
30,23,2308,121,65,56
30,23,1795,1,0,1
30,23,1121,0,0,0
30,23,3465,121,53,68
30,23,1871,1,0,1
30,24,1847,1,1,0
30,24,1099,0,0,0
30,24,2148,4,2,2
30,24,3614,10,4,6
30,24,1169,34,14,20
30,24,1286,0,0,0
30,24,832,1,1,0
30,24,2162,0,0,0
30,24,2529,20,11,9
30,24,2517,0,0,0
30,24,1363,1,0,1
30,24,1264,0,0,0
30,24,1452,0,0,0
30,24,1643,0,0,0
30,24,958,5,2,3
30,24,1426,0,0,0
30,24,906,1,0,1
30,24,1016,0,0,0
30,24,1054,1,1,0
30,24,623,0,0,0
30,24,1482,3,2,1
30,24,1572,2,1,1
30,24,1868,1,0,1
30,24,711,1,1,0
30,24,1134,0,0,0
30,24,2904,4,3,1
30,24,1260,1,1,0
30,24,1627,4,2,2
30,24,578,2,1,1
30,24,1048,0,0,0
30,24,1791,0,0,0
30,24,104,0,0,0
30,24,1307,1,0,1
30,24,710,1,1,0
30,25,4237,18,10,8
30,25,1943,8,5,3
30,25,1829,0,0,0
30,25,1276,7,5,2
30,25,2456,9,4,5
30,25,4750,28,11,17
30,26,2827,17,10,7
30,26,3914,80,50,30
30,26,3966,172,92,80
30,26,2858,159,89,70
30,26,3375,9,5,4
30,26,3055,2,1,1
30,26,4259,15,5,10
30,26,2955,9,4,5
30,27,3432,68,41,27
30,27,3327,97,50,47
30,27,4043,32,19,13
30,27,1899,15,6,9
30,27,2087,42,22,20
30,27,1979,33,20,13
30,27,2895,79,46,33
30,27,2608,139,71,68
30,27,3843,99,52,47
30,28,3068,1097,576,521
30,28,1331,6,2,4
30,28,1867,601,314,287
30,28,1428,130,69,61
30,28,1139,33,19,14
30,28,1519,87,50,37
30,28,1607,196,96,100
30,28,1254,65,38,27
30,28,2429,697,346,351
30,28,1354,234,131,103
30,29,786,82,43,39
30,29,927,122,65,57
30,29,894,6,3,3
30,29,919,75,45,30
30,29,727,71,35,36
30,29,839,21,13,8
30,29,809,42,19,23
30,29,849,23,14,9
30,29,802,35,16,19
30,29,819,56,26,30
30,29,736,16,6,10
30,29,681,8,4,4
30,29,773,1,0,1
30,29,825,10,4,6
30,29,1424,85,43,42
30,29,1278,105,48,57
30,29,1489,85,42,43
30,29,1268,20,9,11
30,29,2520,108,57,51
30,29,3294,49,25,24
30,29,1748,4,3,1
30,29,870,45,25,20
30,29,2229,104,48,56
30,29,1297,55,28,27
30,29,1427,58,27,31
30,29,1217,93,41,52
30,29,1077,251,124,127
30,29,1214,36,20,16
30,29,1631,177,101,76
30,29,1251,88,46,42
30,29,1231,67,38,29
30,29,1238,79,44,35
30,29,1113,46,26,20
30,29,1239,83,42,41
30,29,1114,16,7,9
30,29,2698,34,20,14
30,29,550,4,2,2
30,29,1568,77,39,38
30,29,1301,33,26,7
30,29,680,26,10,16
30,29,881,69,37,32
30,29,1187,88,45,43
30,29,963,36,20,16
30,29,813,2,1,1
30,29,1517,48,27,21
30,29,1281,85,47,38
30,29,1025,56,25,31
30,29,1038,16,8,8
30,29,1347,72,41,31
30,29,1516,38,19,19
30,29,445,9,6,3
30,29,951,6,4,2
30,29,954,10,3,7
30,29,822,16,7,9
30,29,1466,59,37,22
30,29,1704,112,61,51
30,29,1767,23,15,8
30,29,1914,53,29,24
30,29,880,32,14,18
30,29,2067,55,29,26
30,29,3479,112,56,56
30,29,1904,46,22,24
30,29,1129,57,27,30
30,29,707,3,1,2
30,29,1157,130,66,64
30,29,1279,17,7,10
30,29,1072,128,70,58
30,29,1391,81,42,39
30,29,2017,525,270,255
30,29,3108,338,163,175
30,29,3641,90,51,39
30,29,1166,22,10,12
30,29,1566,15,9,6
30,29,1417,33,20,13
30,29,1056,4,2,2
30,29,1404,17,9,8
30,29,1850,51,27,24
30,29,1152,45,30,15
30,29,5104,52,27,25
30,29,2782,14,3,11
30,29,921,10,6,4
30,29,4313,33,15,18
30,29,1893,786,407,379
30,29,1206,254,127,127
30,29,2020,48,22,26
30,29,6970,257,128,129
30,29,764,23,15,8
30,29,812,28,14,14
30,29,757,11,5,6
30,29,2939,372,205,167
30,29,1079,76,45,31
30,29,934,15,9,6
30,29,1687,250,123,127
30,29,1644,26,16,10
30,29,3022,36,22,14
30,29,1318,171,95,76
30,30,2523,26,12,14
30,30,1942,4,0,4
30,30,3027,6,3,3
30,30,2594,6,2,4
30,30,3615,63,34,29
30,31,3396,251,135,116
30,31,2232,226,128,98
30,31,2086,67,29,38
30,31,1472,58,32,26
30,31,983,43,25,18
30,31,1569,38,21,17
30,31,748,0,0,0
30,31,1600,63,33,30
30,31,2292,122,63,59
30,31,1924,36,23,13
30,31,1467,28,15,13
30,31,1976,37,21,16
30,31,935,4,2,2
30,31,436,5,2,3
30,31,2070,7,6,1
30,31,4911,7,2,5
30,32,2675,83,42,41
30,32,2827,53,22,31
30,32,1194,4,2,2
30,32,1569,13,8,5
30,32,2085,7,3,4
30,32,2882,76,37,39
30,32,3454,233,118,115
30,32,2054,6,2,4
30,33,1904,7,3,4
30,33,1619,9,6,3
30,33,1471,10,4,6
30,33,1168,28,12,16
30,33,1628,26,13,13
30,33,869,5,1,4
30,33,993,13,5,8
30,33,2004,3,1,2
30,33,1830,17,6,11
30,33,802,2,2,0
30,33,759,2,1,1
30,33,826,3,1,2
30,33,1832,13,4,9
30,33,1261,179,90,89
30,33,1243,5,1,4
30,34,3080,10,7,3
30,34,3854,36,22,14
30,34,1670,4,2,2
30,34,1303,18,9,9
30,34,2077,10,6,4
30,34,2760,12,8,4
30,34,3782,43,23,20
30,34,2546,6,4,2
30,34,1452,0,0,0
30,34,1093,0,0,0
30,34,1492,33,15,18
30,34,1581,3,2,1
30,34,1555,4,2,2
30,34,1365,3,2,1
30,34,2438,32,18,14
30,34,752,5,3,2
30,34,1101,4,3,1
30,34,1379,16,6,10
30,34,1404,0,0,0
30,34,1966,27,15,12
30,34,1891,7,3,4
30,34,2078,45,20,25
30,34,2466,5,4,1
30,35,2178,16,8,8
30,35,2104,18,8,10
30,35,1045,25,13,12
30,35,2065,36,19,17
30,35,977,44,19,25
30,35,2155,11,6,5
30,35,554,8,4,4
30,35,1150,17,10,7
30,35,480,16,6,10
30,35,1350,0,0,0
30,35,2080,3,1,2
30,35,3231,12,6,6
30,35,1701,4,2,2
30,35,2255,7,4,3
30,35,1021,2,0,2
30,36,1140,26,12,14
30,36,1519,31,18,13
30,36,1404,26,12,14
30,36,961,28,14,14
30,36,1033,6,1,5
30,36,1048,12,5,7
30,36,744,11,6,5
30,36,1077,55,27,28
30,36,889,101,51,50
30,36,1531,14,9,5
30,36,330,5,2,3
30,36,821,20,6,14
30,36,470,3,2,1
30,36,619,14,9,5
30,36,1109,4,3,1
30,36,862,72,42,30
30,36,769,174,95,79
30,36,2174,53,32,21
30,36,1112,17,10,7
30,36,1570,14,5,9
30,36,474,11,5,6
30,36,791,1,0,1
30,36,716,3,2,1
30,36,1449,23,12,11
30,37,1923,19,11,8
30,37,551,2,1,1
30,37,120,5,2,3
30,37,2465,5,1,4
30,37,977,3,1,2
30,37,2058,16,10,6
30,37,1083,51,23,28
30,37,855,8,6,2
30,37,1584,4,2,2
30,38,4746,469,230,239
30,38,3258,447,219,228
30,38,1043,93,51,42
30,38,1287,9,4,5
30,38,733,72,31,41
30,39,3005,2,2,0
30,39,3225,15,9,6
30,39,1946,4,1,3
30,40,2090,73,40,33
30,40,599,19,7,12
30,40,2796,143,78,65
30,40,64,0,0,0
30,40,394,3,3,0
30,40,499,10,9,1
30,40,946,36,16,20
30,40,3838,93,46,47
30,40,602,8,4,4
30,40,88,0,0,0
30,40,887,16,7,9
30,40,1025,12,5,7
30,40,463,0,0,0
30,40,877,38,19,19
30,40,449,29,15,14
30,40,123,8,4,4
30,40,321,1,1,0
30,40,1210,12,5,7
30,40,2540,15,8,7
30,40,2024,22,11,11
30,40,1155,20,14,6
30,40,607,5,2,3
30,40,316,16,10,6
30,40,261,16,8,8
30,40,1955,47,23,24
30,40,1509,22,11,11
30,40,199,1,0,1
30,40,4657,48,22,26
30,40,6634,121,58,63
30,40,4778,98,46,52
30,40,10063,416,205,211
30,40,468,1,1,0
30,40,3722,60,33,27
30,40,1818,47,24,23
30,40,2538,106,56,50
30,40,2429,18,7,11
30,40,1087,46,26,20
30,40,2066,38,19,19
30,40,2419,13,5,8
30,40,2835,92,50,42
30,40,1462,12,8,4
30,40,3561,89,48,41
30,40,2236,77,44,33
30,40,1588,38,18,20
30,40,2842,155,80,75
30,40,1957,30,16,14
30,40,618,47,21,26
30,40,1668,46,17,29
30,40,3241,41,27,14
30,40,507,17,9,8
30,40,773,0,0,0
30,41,1671,10,5,5
30,41,642,0,0,0
30,41,505,24,14,10
30,41,4340,208,108,100
30,41,505,7,4,3
30,41,1670,164,100,64
30,41,736,19,11,8
30,41,820,24,13,11
30,41,869,28,14,14
30,41,802,7,2,5
30,41,1284,16,6,10
30,41,1697,19,8,11
30,41,1739,94,46,48
30,41,1290,83,37,46
30,41,942,21,9,12
30,41,776,14,7,7
30,41,572,8,5,3
30,41,831,4,1,3
30,41,439,2,1,1
30,41,586,9,5,4
30,41,434,6,3,3
30,41,1287,29,18,11
30,41,907,15,7,8
30,41,1193,56,28,28
30,41,1033,24,16,8
30,41,893,5,3,2
30,41,770,8,4,4
30,41,942,21,13,8
30,41,981,31,15,16
30,41,1321,11,6,5
30,41,1204,9,2,7
30,41,1263,22,14,8
30,41,1309,38,21,17
30,41,743,17,10,7
30,41,939,15,11,4
30,41,772,10,7,3
30,41,597,10,4,6
30,41,588,1,1,0
30,41,344,10,4,6
30,41,318,8,5,3
30,41,459,13,6,7
30,41,344,1,1,0
30,41,683,6,1,5
30,41,607,6,2,4
30,41,966,13,7,6
30,41,909,15,4,11
30,41,771,6,2,4
30,41,355,8,5,3
30,41,1399,8,2,6
30,41,1110,12,7,5
30,41,985,11,5,6
30,41,1665,11,5,6
30,41,1109,41,26,15
30,41,652,29,12,17
30,41,917,6,4,2
30,41,1156,5,3,2
30,41,1428,5,3,2
30,41,1086,13,3,10
30,41,733,5,3,2
30,41,340,1,0,1
30,41,862,7,3,4
30,41,911,16,9,7
30,41,966,23,12,11
30,41,858,21,13,8
30,41,587,7,3,4
30,41,731,4,4,0
30,41,525,2,0,2
30,41,642,11,5,6
30,41,827,8,4,4
30,41,697,2,1,1
30,41,830,3,2,1
30,41,801,22,11,11
30,41,1069,44,17,27
30,41,1092,9,3,6
30,41,760,21,16,5
30,41,940,21,11,10
30,41,635,11,8,3
30,41,560,12,4,8
30,41,801,13,8,5
30,41,967,5,2,3
30,41,823,16,5,11
30,41,438,10,4,6
30,41,1939,135,66,69
30,41,1910,9,5,4
30,41,879,50,27,23
30,41,3533,41,27,14
30,41,1851,340,190,150
30,41,2578,41,21,20
30,41,788,0,0,0
30,41,1622,14,4,10
30,41,801,9,5,4
30,41,770,21,12,9
30,41,756,10,6,4
30,41,751,16,10,6
30,41,1218,17,11,6
30,41,506,4,1,3
30,41,1634,20,10,10
30,41,1033,6,2,4
30,41,910,4,1,3
30,41,1485,6,4,2
30,41,523,5,2,3
30,41,699,7,2,5
30,41,850,13,7,6
30,41,978,88,40,48
30,41,1517,30,16,14
30,41,1114,8,4,4
30,41,1187,4,1,3
30,41,872,24,10,14
30,41,1119,11,6,5
30,41,1435,9,4,5
30,41,1032,8,4,4
30,41,1108,32,9,23
30,41,966,2,1,1
30,41,1144,31,18,13
30,41,1071,47,24,23
30,41,1383,39,23,16
30,41,1343,80,39,41
30,41,1099,71,38,33
30,41,2356,140,78,62
30,41,1503,19,10,9
30,41,1400,2,2,0
30,41,2339,12,5,7
30,41,2776,31,12,19
30,41,1341,12,5,7
30,41,3063,24,11,13
30,41,1738,12,5,7
30,41,1117,93,49,44
30,41,1368,52,22,30
30,41,1611,50,21,29
30,41,1893,35,20,15
30,41,1189,145,74,71
30,41,1432,9,3,6
30,41,1306,19,10,9
30,41,2011,3,1,2
30,41,912,42,25,17
30,41,2151,399,211,188
30,41,1095,45,21,24
30,41,1284,17,9,8
30,41,1071,2,0,2
30,41,908,2,1,1
30,41,1709,16,7,9
30,41,3233,58,30,28
30,41,984,18,7,11
30,41,770,15,6,9
30,41,1354,39,18,21
30,41,318,3,2,1
30,41,2488,8,3,5
30,41,553,8,6,2
30,41,988,10,7,3
30,41,1055,36,17,19
30,41,1145,13,3,10
30,41,667,71,32,39
30,41,952,17,10,7
30,41,1365,2,1,1
30,41,856,74,42,32
30,41,461,31,16,15
30,41,1045,3,1,2
30,42,1630,10,7,3
30,42,8970,107,59,48
30,42,857,2,0,2
30,42,1549,14,4,10
30,42,2251,12,6,6
30,42,1616,4,1,3
30,42,1718,7,5,2
30,42,885,1,1,0
30,42,1565,10,4,6
30,42,1284,10,7,3
30,42,829,0,0,0
30,42,1480,6,3,3
30,42,514,2,2,0
30,42,1041,3,3,0
30,42,4316,42,25,17
30,42,968,3,2,1
30,42,14459,91,54,37
30,42,676,2,1,1
30,42,1766,13,8,5
30,42,209,3,1,2
30,42,2204,11,6,5
30,42,374,1,1,0
30,42,525,2,2,0
30,42,2386,29,20,9
30,42,374,0,0,0
30,42,332,4,4,0
30,42,796,0,0,0
30,42,782,2,1,1
30,42,937,1,0,1
30,43,1381,20,10,10
30,43,974,3,2,1
30,44,1440,76,35,41
30,44,1278,12,4,8
30,44,758,0,0,0
30,44,606,0,0,0
30,44,458,0,0,0
30,44,1223,0,0,0
30,45,2169,4,4,0
30,45,1603,2,1,1
30,45,1768,25,15,10
30,45,3623,31,13,18
30,45,1532,5,4,1
30,45,702,4,3,1
30,45,2285,23,14,9
30,45,1703,2,1,1
30,45,1448,11,5,6
30,45,3043,116,53,63
30,46,5884,87,39,48
30,46,1122,9,2,7
30,46,2309,20,12,8
30,46,5058,320,170,150
30,46,1420,13,10,3
30,46,1283,5,3,2
30,46,1261,71,38,33
30,46,1199,28,16,12
30,46,1567,88,51,37
30,46,2252,17,9,8
30,46,1359,17,11,6
30,46,1175,118,63,55
30,46,1024,32,17,15
30,46,794,4,2,2
30,46,979,17,13,4
30,46,910,16,8,8
30,46,1743,13,7,6
30,46,971,7,1,6
30,46,1032,6,4,2
30,46,775,9,4,5
30,46,774,17,8,9
30,46,1448,14,11,3
30,46,1767,8,5,3
30,46,790,5,1,4
30,46,454,6,2,4
30,46,336,21,9,12
30,46,736,5,3,2
30,46,716,6,3,3
30,46,941,21,13,8
30,46,2626,48,21,27
30,46,1866,73,37,36
30,46,1027,61,34,27
30,46,3312,152,72,80
30,46,780,30,17,13
30,46,971,11,7,4
30,46,517,24,13,11
30,46,479,26,10,16
30,46,702,8,2,6
30,46,344,11,5,6
30,46,1138,5,3,2
30,46,425,3,1,2
30,46,561,0,0,0
30,46,668,4,1,3
30,46,411,14,11,3
30,46,362,0,0,0
30,46,458,4,2,2
30,46,687,15,7,8
30,46,821,12,8,4
30,46,1247,15,6,9
30,46,1542,17,6,11
30,46,7273,78,36,42
30,46,1664,17,8,9
30,46,2019,46,22,24
30,46,2086,49,29,20
30,46,1498,5,2,3
30,46,1226,19,15,4
30,46,877,11,6,5
30,46,817,26,11,15
30,46,1097,21,9,12
30,46,889,13,10,3
30,46,553,0,0,0
30,46,602,25,15,10
30,46,549,4,4,0
30,46,821,18,11,7
30,46,488,5,2,3
30,46,2253,26,15,11
30,46,521,13,7,6
30,46,824,10,4,6
30,46,883,7,1,6
30,46,1301,4,2,2
30,46,1561,6,4,2
30,46,2003,36,19,17
30,46,673,11,6,5
30,46,453,7,5,2
30,46,836,17,7,10
30,46,1522,58,29,29
30,46,935,2,2,0
30,46,919,10,4,6
30,46,933,25,11,14
30,46,2249,62,33,29
30,46,5360,73,29,44
30,46,1140,11,4,7
30,46,5270,121,50,71
30,46,1951,65,32,33
30,46,1329,6,1,5
30,46,1994,46,26,20
30,46,3756,92,55,37
30,46,961,4,1,3
30,46,2284,146,76,70
30,46,844,3,1,2
30,46,1576,4,0,4
30,46,1188,12,5,7
30,46,5761,144,79,65
30,46,1329,52,28,24
30,46,913,10,6,4
30,46,2387,4,2,2
30,46,2364,5,2,3
30,46,1560,22,9,13
30,46,1131,1,0,1
30,46,2852,7,4,3
30,46,1467,4,2,2
30,46,2561,6,3,3
30,46,3201,21,9,12
30,46,3706,234,121,113
30,46,5576,1116,589,527
30,46,2254,3,2,1
30,46,1825,24,11,13
30,46,3408,33,17,16
30,46,1400,53,27,26
30,46,16427,542,277,265
30,46,2238,8,5,3
30,46,4976,133,71,62
30,46,1396,24,12,12
30,46,3409,119,61,58
30,47,2155,31,17,14
30,47,3064,40,23,17
30,47,1814,28,12,16
30,47,2243,77,46,31
30,47,1039,75,45,30
30,47,974,18,11,7
30,47,825,1,1,0
30,47,897,13,6,7
30,47,937,17,10,7
30,47,775,4,3,1
30,47,863,50,31,19
30,47,575,9,5,4
30,47,1132,24,14,10
30,47,1862,13,9,4
30,47,893,67,37,30
30,47,524,5,3,2
30,47,621,32,18,14
30,47,2153,11,6,5
30,47,1658,43,16,27
30,47,746,82,48,34
30,47,1722,22,10,12
30,47,1976,32,19,13
30,47,1082,1,1,0
30,47,1579,1,0,1
30,208,921,23,13,10
30,208,950,9,4,5
30,208,1762,5,1,4
30,208,396,0,0,0
30,208,401,1,1,0
30,208,1640,8,4,4
30,208,1059,8,3,5
30,208,1417,0,0,0
30,208,1847,3,2,1
30,208,1851,15,10,5
30,208,1603,29,13,16
30,208,903,13,8,5
30,208,1279,31,18,13
30,208,1469,130,62,68
30,208,1760,10,7,3
30,47,1828,77,38,39
30,47,1899,41,23,18
30,47,375,0,0,0
30,47,281,8,5,3
30,47,2465,31,11,20
30,47,841,40,18,22
30,47,995,32,21,11
30,47,1921,88,50,38
30,47,1312,19,8,11
30,47,1212,18,7,11
30,208,1339,88,53,35
30,208,358,17,7,10
30,208,1048,11,5,6
30,47,1115,10,6,4
30,47,1286,12,4,8
30,47,3190,536,285,251
30,47,1065,16,7,9
30,47,813,15,6,9
30,47,1348,56,31,25
30,47,856,180,86,94
30,48,960,4,2,2
30,48,1374,5,1,4
30,48,1777,4,3,1
30,48,2755,4,2,2
30,48,1553,0,0,0
30,48,2369,0,0,0
30,48,1171,1,1,0
30,48,1998,3,2,1
30,48,2210,3,0,3
30,49,3168,81,40,41
30,49,954,28,12,16
30,49,921,16,10,6
30,49,2709,13,6,7
30,49,724,6,4,2
30,49,1019,5,2,3
30,49,2755,191,104,87
30,49,7183,319,164,155
30,49,2381,0,0,0
30,49,2139,20,9,11
30,49,2158,4,2,2
30,49,1434,1,1,0
30,49,4158,454,215,239
30,49,2095,827,437,390
30,49,3089,1,1,0
30,49,3473,187,94,93
30,49,2180,1,1,0
30,49,3382,15,8,7
30,49,2490,3,2,1
30,49,4006,11,7,4
30,49,4729,11,3,8
30,49,2486,6,4,2
30,50,1940,36,21,15
30,50,700,1,1,0
30,50,1591,5,2,3
30,50,1113,10,6,4
30,50,949,2,1,1
30,50,1995,11,6,5
30,50,683,12,6,6
30,50,647,5,3,2
30,50,940,134,70,64
30,50,1190,32,19,13
30,50,734,5,4,1
30,50,681,12,7,5
30,50,1003,10,5,5
30,50,852,1,1,0
30,50,3486,56,30,26
30,50,1035,29,15,14
30,50,5713,57,26,31
30,50,1263,13,7,6
30,50,1256,13,6,7
30,50,992,2,1,1
30,50,1485,3,3,0
30,50,1055,6,4,2
30,50,2813,38,19,19
30,50,9715,103,45,58
30,50,459,4,0,4
30,50,295,1,1,0
30,50,736,4,2,2
30,50,638,6,2,4
30,50,4398,139,75,64
30,50,1109,3,1,2
30,50,473,5,4,1
30,50,1087,45,29,16
30,50,1077,25,9,16
30,50,1235,30,14,16
30,50,1039,43,23,20
30,50,2017,26,12,14
30,50,4475,55,27,28
30,50,3558,39,20,19
30,50,82,8,7,1
30,50,3055,19,12,7
30,50,0,0,0,0
30,50,767,7,4,3
30,50,254,0,0,0
30,50,3215,56,33,23
30,50,804,13,4,9
30,50,535,0,0,0
30,50,107,1,0,1
30,50,1288,25,8,17
30,50,199,5,4,1
30,50,1763,18,8,10
30,50,871,18,11,7
30,50,954,8,4,4
30,50,192,1,0,1
30,50,2618,11,7,4
30,50,2240,13,7,6
30,50,344,0,0,0
30,50,885,4,1,3
30,50,9523,81,47,34
30,50,7402,56,28,28
30,50,1584,24,9,15
30,50,1724,5,2,3
30,50,1404,3,2,1
30,50,1476,6,2,4
30,50,1541,2,1,1
30,50,741,1,1,0
30,50,1034,4,3,1
30,50,1450,4,3,1
30,51,2580,33,16,17
30,51,916,4,2,2
30,51,991,2,2,0
30,51,937,0,0,0
30,51,1327,13,8,5
30,51,1163,88,45,43
30,51,1585,30,14,16
30,51,3341,11,7,4
30,51,1321,5,0,5
30,51,1541,47,18,29
30,51,783,12,5,7
30,51,1373,9,3,6
30,51,1348,5,4,1
30,51,2744,21,14,7
30,52,1976,10,4,6
30,52,3179,55,34,21
30,52,915,2,2,0
30,52,1091,1,0,1
30,52,1105,1,0,1
30,52,1588,18,12,6
30,52,3495,96,48,48
30,52,1931,162,81,81
30,52,1767,2,0,2
30,53,2662,34,20,14
30,53,2308,36,21,15
30,53,2549,8,4,4
30,53,1412,2,0,2
30,53,607,0,0,0
30,53,1987,1,1,0
30,53,1116,1,1,0
30,53,2498,13,6,7
30,53,2826,12,5,7
30,53,2489,10,5,5
30,53,2895,6,3,3
30,54,1851,20,10,10
30,54,2000,38,18,20
30,54,1728,36,23,13
30,54,2154,93,50,43
30,54,1509,50,24,26
30,54,1945,36,18,18
30,54,993,36,19,17
30,55,2971,312,153,159
30,55,1899,184,101,83
30,55,5409,510,259,251
30,55,663,55,29,26
30,55,633,27,13,14
30,55,506,58,25,33
30,55,568,80,39,41
30,55,2198,39,18,21
30,55,3223,282,129,153
30,55,2519,1425,740,685
30,55,2129,698,355,343
30,55,622,174,89,85
30,55,1640,171,88,83
30,55,1618,142,72,70
30,55,1261,321,150,171
30,55,99,3,2,1
30,55,715,95,49,46
30,56,1179,23,14,9
30,56,1016,0,0,0
30,56,749,2,0,2
30,56,1017,4,2,2
30,56,858,4,2,2
30,56,502,0,0,0
30,56,1457,9,4,5
30,56,1551,35,17,18
30,56,1558,11,8,3
30,56,1562,2,1,1
30,57,1901,1,0,1
30,57,1357,5,4,1
30,57,1734,33,17,16
30,57,1402,13,5,8
30,57,1713,16,7,9
30,57,779,4,1,3
30,57,790,15,7,8
30,57,945,0,0,0
30,57,3133,3,1,2
30,58,1574,14,7,7
30,58,590,4,3,1
30,58,1024,4,4,0
30,58,632,1,1,0
30,58,1513,0,0,0
30,58,1215,3,1,2
30,59,2248,17,11,6
30,59,2535,13,7,6
30,59,2240,10,1,9
30,59,1202,2,1,1
30,59,955,3,0,3
30,59,2177,9,3,6
30,59,827,0,0,0
30,59,1631,8,4,4
30,60,1811,28,15,13
30,60,2685,158,98,60
30,60,995,77,44,33
30,60,1252,0,0,0
30,60,2156,8,4,4
30,60,797,1,0,1
30,60,290,0,0,0
30,60,1103,2,0,2
30,60,1863,2,2,0
30,60,1984,11,5,6
30,60,1042,57,31,26
30,60,608,4,2,2
30,60,931,0,0,0
30,60,520,2,0,2
30,60,627,2,2,0
30,60,1319,10,5,5
30,60,2030,1,0,1
30,60,1807,8,2,6
30,60,1260,32,15,17
30,60,1322,7,5,2
30,60,1070,1,0,1
30,60,608,0,0,0
30,60,1745,8,4,4
30,60,1342,1,0,1
30,60,620,3,2,1
30,60,1116,0,0,0
30,60,1687,2,2,0
30,60,820,1,0,1
30,60,1238,0,0,0
30,60,646,3,2,1
30,60,902,8,5,3
30,60,1093,5,3,2
30,60,1167,0,0,0
30,60,1477,1,1,0
30,60,696,0,0,0
30,60,1357,0,0,0
30,60,373,2,1,1
30,60,1421,1,1,0
30,60,956,0,0,0
30,60,409,0,0,0
30,60,988,3,2,1
30,60,462,2,2,0
30,60,1624,3,0,3
30,60,523,0,0,0
30,60,582,0,0,0
30,60,1141,1,0,1
30,60,1062,0,0,0
30,61,1822,98,51,47
30,61,615,43,22,21
30,61,1206,22,13,9
30,61,4895,258,125,133
30,61,1301,8,6,2
30,61,157,78,36,42
30,61,2002,718,375,343
30,61,1378,487,247,240
30,61,1491,832,430,402
30,61,1090,393,202,191
30,61,1004,29,19,10
30,61,708,7,2,5
30,61,431,12,7,5
30,62,1655,21,9,12
30,62,977,34,22,12
30,62,1605,2,1,1
30,62,1738,23,13,10
30,62,292,0,0,0
30,62,2306,45,23,22
30,62,1258,121,54,67
30,62,1096,8,3,5
30,62,1183,33,16,17
30,62,4120,91,36,55
30,63,1724,5,3,2
30,63,4031,62,31,31
30,63,1326,0,0,0
30,63,2187,26,11,15
30,63,1851,15,8,7
30,63,1449,12,8,4
30,63,1817,25,18,7
30,63,872,0,0,0
30,63,1186,4,3,1
30,63,1212,12,7,5
30,63,604,7,3,4
30,63,2839,8,4,4
30,63,1896,11,7,4
30,63,729,4,2,2
30,63,1105,12,5,7
30,63,942,20,8,12
30,63,1179,2,1,1
30,63,1078,0,0,0
30,63,1362,6,1,5
30,63,1310,3,0,3
30,63,1566,7,3,4
30,63,3898,76,38,38
30,63,2788,8,2,6
30,63,3739,28,18,10
30,63,4075,26,14,12
30,63,1785,26,15,11
30,63,944,10,6,4
30,63,1136,0,0,0
30,63,1603,8,5,3
30,63,1310,4,4,0
30,63,1642,2,0,2
30,63,2118,0,0,0
30,63,2156,5,2,3
30,63,3340,12,6,6
30,63,1728,3,1,2
30,63,1836,49,22,27
30,63,966,3,2,1
30,63,765,0,0,0
30,63,1870,1,0,1
30,63,1677,0,0,0
30,63,2780,11,3,8
30,63,2465,2,1,1
30,63,3182,31,15,16
30,64,2768,58,29,29
30,64,3074,34,16,18
30,64,3736,62,31,31
30,64,3597,13,6,7
30,64,2042,1,1,0
30,64,1815,5,3,2
30,64,3517,6,0,6
30,65,1097,4,3,1
30,65,1201,0,0,0
30,65,580,0,0,0
30,65,593,0,0,0
30,65,1762,3,0,3
30,65,1480,6,4,2
30,65,1175,0,0,0
30,65,1566,25,17,8
30,65,1625,21,10,11
30,65,2275,1,1,0
30,66,2122,29,14,15
30,66,1886,190,91,99
30,67,1664,67,30,37
30,67,1385,0,0,0
30,67,1404,9,5,4
30,67,1321,13,6,7
30,67,3165,154,70,84
30,67,30763,1681,915,766
30,67,4029,179,93,86
30,67,2231,85,38,47
30,67,1673,47,25,22
30,67,1513,62,35,27
30,67,6968,405,218,187
30,67,684,16,9,7
30,67,3491,50,25,25
30,67,2259,15,8,7
30,67,271,0,0,0
30,67,889,2,0,2
30,67,1962,49,31,18
30,67,265,0,0,0
30,67,1566,5,5,0
30,67,647,18,10,8
30,67,2238,10,6,4
30,67,749,0,0,0
30,67,1375,15,7,8
30,67,1074,5,2,3
30,67,1595,14,6,8
30,67,498,3,1,2
30,67,509,4,3,1
30,67,1457,99,50,49
30,67,1028,16,6,10
30,67,1506,84,39,45
30,67,1631,9,4,5
30,67,2033,27,17,10
30,67,1020,21,12,9
30,67,2004,74,42,32
30,67,1499,29,16,13
30,68,1509,26,14,12
30,68,1299,2,1,1
30,68,1139,661,343,318
30,68,1520,7,5,2
30,68,3489,317,154,163
30,68,1876,806,409,397
30,68,2660,85,50,35
30,68,3849,108,56,52
30,68,1825,66,38,28
30,68,1856,6,2,4
30,68,471,4,3,1
30,68,1114,1,1,0
30,68,1502,16,6,10
30,68,2150,47,17,30
30,69,1003,1,0,1
30,69,3508,17,6,11
30,69,1320,0,0,0
30,69,1710,0,0,0
30,69,11899,38,26,12
30,70,1679,2,1,1
30,70,3295,24,15,9
30,70,1239,86,49,37
30,70,1579,10,8,2
30,70,1328,18,11,7
30,70,1325,14,7,7
30,70,712,6,1,5
30,70,1075,2,1,1
30,70,1252,13,7,6
30,70,714,11,4,7
30,70,2915,28,18,10
30,70,1906,9,4,5
30,70,2687,18,9,9
30,70,3294,23,7,16
30,70,2228,9,5,4
30,70,2279,12,5,7
30,70,5406,36,18,18
30,70,12074,323,165,158
30,70,1342,7,2,5
30,70,3799,107,50,57
30,70,2180,89,48,41
30,70,935,9,5,4
30,70,958,35,17,18
30,70,6734,109,59,50
30,70,4625,112,52,60
30,70,777,18,7,11
30,70,1313,7,1,6
30,71,736,12,7,5
30,71,1046,20,13,7
30,71,266,0,0,0
30,71,838,11,6,5
30,71,1290,18,7,11
30,71,580,0,0,0
30,71,1361,1,1,0
30,71,957,4,4,0
30,71,1532,7,4,3
30,71,3957,31,18,13
30,71,1742,20,11,9
30,71,692,0,0,0
30,71,462,1,0,1
30,71,469,2,1,1
30,71,669,5,3,2
30,71,549,5,1,4
30,71,1410,4,2,2
30,71,1138,3,0,3
30,71,1012,12,6,6
30,71,709,2,2,0
30,71,479,2,2,0
30,71,609,0,0,0
30,71,753,9,5,4
30,72,1330,11,6,5
30,72,1168,50,29,21
30,72,1589,24,11,13
30,72,1150,144,54,90
30,72,1290,5,5,0
30,72,1885,8,6,2
30,72,2223,15,6,9
30,72,1387,158,71,87
30,72,784,4,0,4
30,72,1460,6,4,2
30,72,1726,229,105,124
30,72,1509,6,4,2
30,209,819,27,13,14
30,209,2020,8,4,4
30,209,1276,0,0,0
30,209,668,172,86,86
30,209,3563,570,286,284
30,209,1065,30,13,17
30,73,2110,22,15,7
30,73,2427,29,16,13
30,73,1887,6,3,3
30,73,1471,22,10,12
30,73,1055,10,5,5
30,73,521,0,0,0
30,73,638,21,13,8
30,73,2430,7,4,3
30,73,2405,2,1,1
30,73,1827,19,8,11
30,73,10133,297,137,160
30,73,3657,13,5,8
30,73,2165,18,10,8
30,73,1998,8,2,6
30,73,2336,11,3,8
30,73,1077,3,2,1
30,73,1518,0,0,0
30,73,4109,15,4,11
30,73,1794,1,1,0
30,73,1795,6,4,2
30,73,1597,39,20,19
30,73,803,0,0,0
30,73,3690,71,31,40
30,73,1964,10,4,6
30,73,1195,11,8,3
30,73,2506,32,14,18
30,74,3582,20,12,8
30,74,1754,38,1,37
30,74,2563,12,9,3
30,74,812,1,0,1
30,74,639,1,0,1
30,74,525,8,3,5
30,74,192,1,1,0
30,74,1237,8,3,5
30,74,212,0,0,0
30,74,253,15,9,6
30,74,1044,4,3,1
30,74,716,6,4,2
30,74,624,16,7,9
30,74,2266,218,117,101
30,74,1938,24,10,14
30,74,1693,11,7,4
30,74,718,21,11,10
30,74,1009,9,3,6
30,75,1874,326,154,172
30,75,1877,42,23,19
30,75,1068,32,14,18
30,75,849,49,25,24
30,75,2001,84,45,39
30,75,1746,15,10,5
30,75,1953,628,316,312
30,75,2668,497,263,234
30,75,1160,2,1,1
30,75,1169,12,9,3
30,75,1892,560,276,284
30,75,1831,478,250,228
30,75,1728,7,1,6
30,75,785,13,6,7
30,75,1451,4,2,2
30,75,831,18,8,10
30,75,1421,114,51,63
30,75,1357,37,15,22
30,75,861,14,5,9
30,75,968,2,1,1
30,75,1053,21,11,10
30,75,1323,396,202,194
30,75,598,28,9,19
30,75,1169,103,45,58
30,75,3116,18,7,11
30,75,3167,26,18,8
30,75,1978,531,265,266
30,76,973,54,31,23
30,76,1133,75,39,36
30,76,359,15,8,7
30,76,8125,101,58,43
30,77,1125,14,7,7
30,77,1085,44,23,21
30,77,1343,9,4,5
30,77,1122,21,10,11
30,77,789,18,10,8
30,77,1278,7,3,4
30,77,734,0,0,0
30,77,703,22,15,7
30,77,1570,381,170,211
30,77,863,1,0,1
30,77,812,9,4,5
30,77,222,0,0,0
30,77,1519,21,12,9
30,77,1660,90,52,38
30,77,1361,78,42,36
30,77,306,0,0,0
30,78,724,3,1,2
30,78,1981,12,5,7
30,78,531,0,0,0
30,78,828,1,1,0
30,78,589,0,0,0
30,78,1344,0,0,0
30,78,1147,0,0,0
30,78,1452,13,4,9
30,78,817,172,81,91
30,78,1914,768,387,381
30,78,147,0,0,0
30,78,616,0,0,0
30,78,1287,2,1,1
30,79,3481,18,10,8
30,79,2249,136,70,66
30,79,6469,1069,561,508
30,79,2260,41,21,20
30,79,1968,29,17,12
30,79,1942,31,11,20
30,79,2446,7,3,4
30,79,1928,3,1,2
30,79,2793,20,9,11
30,79,2168,8,0,8
30,79,1995,23,9,14
30,79,2681,172,88,84
30,79,1895,14,7,7
30,79,2537,301,151,150
30,79,2180,11,6,5
30,79,1474,301,139,162
30,79,2647,80,31,49
30,80,2338,14,5,9
30,80,2099,24,13,11
30,80,1463,3,2,1
30,80,839,0,0,0
30,80,812,4,4,0
30,80,1100,1,0,1
30,80,2033,5,5,0
30,80,1517,4,2,2
30,81,1712,60,26,34
30,81,2049,95,47,48
30,81,2671,21,11,10
30,81,3549,310,157,153
30,81,1406,14,7,7
30,82,1880,48,22,26
30,82,1801,9,4,5
30,82,1669,5,3,2
30,82,1317,24,10,14
30,82,1451,55,27,28
30,82,1537,11,6,5
30,82,1883,9,4,5
30,82,2614,70,39,31
30,82,1845,426,217,209
30,82,1787,172,93,79
30,82,759,98,51,47
30,82,2867,346,180,166
30,82,1547,75,46,29
30,82,2795,40,19,21
30,82,961,25,11,14
30,82,1979,17,8,9
30,82,936,17,8,9
30,82,1697,55,28,27
30,82,1613,5,1,4
30,82,1629,183,95,88
30,82,814,8,3,5
30,82,547,0,0,0
30,82,1629,202,113,89
30,82,2144,20,10,10
30,82,760,155,78,77
30,82,866,15,9,6
30,82,1064,3,1,2
30,82,1087,2,2,0
30,82,725,1,0,1
30,82,1287,39,22,17
30,82,744,310,158,152
30,82,675,27,15,12
30,82,3385,884,455,429
30,83,3142,36,18,18
30,83,875,8,2,6
30,83,1047,4,2,2
30,83,2069,26,15,11
30,83,2919,12,5,7
30,83,3816,89,45,44
30,83,1774,25,14,11
30,83,2505,11,2,9
30,83,1402,12,6,6
30,83,1920,41,21,20
30,83,2078,15,6,9
30,84,4713,13,3,10
30,84,2253,58,26,32
30,84,996,0,0,0
30,84,2643,15,4,11
30,84,107,0,0,0
30,84,2826,26,17,9
30,84,750,6,1,5
30,84,1292,9,4,5
30,85,2007,26,12,14
30,85,1165,2,0,2
30,85,1322,5,2,3
30,85,1113,4,3,1
30,85,10789,171,79,92
30,85,10452,263,143,120
30,85,181,4,2,2
30,86,1865,1,1,0
30,86,174,0,0,0
30,86,495,11,4,7
30,86,865,7,3,4
30,86,272,0,0,0
30,86,819,2,2,0
30,86,668,12,6,6
30,87,1924,12,6,6
30,87,3524,36,18,18
30,87,1983,28,18,10
30,87,610,2,1,1
30,87,1940,5,2,3
30,87,2656,12,6,6
30,87,2297,2,1,1
30,87,1071,1,1,0
30,87,2125,29,16,13
30,87,2382,14,7,7
30,87,3378,8,3,5
30,87,2888,9,5,4
30,87,6796,100,46,54
30,87,2953,128,62,66
30,87,3568,14,9,5
30,87,1456,40,21,19
30,87,4172,104,50,54
30,87,1678,4,2,2
30,87,1121,1,0,1
30,87,1498,2,1,1
30,87,1608,5,3,2
30,87,385,6,2,4
30,87,734,3,2,1
30,87,849,0,0,0
30,87,3245,11,4,7
30,87,2459,8,1,7
30,87,3388,25,13,12
30,87,1111,4,2,2
30,87,303,1,1,0
30,87,1032,0,0,0
30,87,3227,7,4,3
30,87,1908,0,0,0
30,88,5069,24,5,19
30,88,3646,114,64,50
30,88,1388,0,0,0
30,88,877,0,0,0
30,88,967,0,0,0
30,88,343,1,0,1
30,88,1819,1,0,1
30,88,3356,84,38,46
30,88,2175,158,77,81
30,88,5205,24,12,12
30,88,1792,19,12,7
30,88,1345,3,2,1
30,88,3174,11,6,5
30,88,1662,4,2,2
30,88,5242,10,6,4
30,88,2842,2,2,0
30,88,293,0,0,0
30,89,4337,169,87,82
30,89,5470,192,101,91
30,89,7023,217,113,104
30,89,6342,241,128,113
30,89,4792,128,69,59
30,89,1998,40,21,19
30,89,1660,68,30,38
30,89,1555,4,3,1
30,89,1639,40,24,16
30,89,1581,58,35,23
30,89,2447,12,7,5
30,89,1554,40,23,17
30,89,2850,12,6,6
30,89,2915,21,13,8
30,89,3578,24,14,10
30,89,1611,0,0,0
30,89,725,10,3,7
30,89,1897,35,15,20
30,89,1777,22,11,11
30,89,1689,11,5,6
30,89,1498,13,7,6
30,89,2031,112,58,54
30,89,1890,88,51,37
30,89,1390,201,117,84
30,89,5807,182,91,91
30,89,1962,20,10,10
30,89,5917,145,70,75
30,89,5221,314,169,145
30,89,1868,37,25,12
30,89,1963,11,4,7
30,89,1747,52,25,27
30,89,1942,80,45,35
30,89,1287,45,22,23
30,89,1514,14,4,10
30,89,2381,80,41,39
30,89,1461,45,25,20
30,89,1800,22,10,12
30,89,1927,18,11,7
30,89,1675,43,23,20
30,89,2003,12,8,4
30,89,1522,35,17,18
30,89,1682,99,57,42
30,89,1309,15,7,8
30,89,1496,55,31,24
30,89,1219,40,20,20
30,89,1530,33,21,12
30,89,1949,15,10,5
30,89,5572,1162,610,552
30,89,4601,85,42,43
30,89,1426,38,13,25
30,89,1703,23,12,11
30,89,994,37,16,21
30,89,964,6,3,3
30,89,1465,29,14,15
30,89,1262,26,17,9
30,89,2028,113,63,50
30,89,1982,123,62,61
30,89,21295,124,62,62
30,89,5602,82,43,39
30,89,6958,265,141,124
30,89,9107,183,90,93
30,89,2178,144,62,82
30,89,3406,167,87,80
30,89,2256,86,39,47
30,89,1439,76,40,36
30,89,1413,43,32,11
30,89,1432,33,19,14
30,89,1305,26,15,11
30,89,1610,9,4,5
30,89,1156,27,14,13
30,89,1087,38,20,18
30,89,1078,12,7,5
30,89,1129,36,19,17
30,89,2476,20,10,10
30,89,2459,24,14,10
30,89,2914,59,32,27
30,89,1960,43,26,17
30,89,2013,57,33,24
30,89,1114,96,48,48
30,89,1066,10,6,4
30,89,1414,81,40,41
30,89,995,11,5,6
30,89,848,35,20,15
30,89,741,63,26,37
30,89,1159,62,34,28
30,89,1160,74,38,36
30,89,612,23,10,13
30,89,1215,42,16,26
30,89,822,29,14,15
30,89,1248,48,29,19
30,89,1295,33,18,15
30,89,1269,7,5,2
30,89,1313,46,26,20
30,89,772,20,12,8
30,89,1137,23,12,11
30,89,751,33,23,10
30,89,1240,45,20,25
30,89,777,30,13,17
30,89,930,18,10,8
30,89,1187,16,9,7
30,89,1326,30,15,15
30,89,1175,11,5,6
30,89,763,76,46,30
30,89,6343,158,84,74
30,89,710,48,24,24
30,89,927,39,18,21
30,89,708,26,13,13
30,89,1103,9,5,4
30,89,1287,5,3,2
30,89,1558,10,6,4
30,89,2488,73,36,37
30,89,2693,110,64,46
30,89,2376,62,35,27
30,89,1303,23,13,10
30,89,1098,8,2,6
30,89,441,1,1,0
30,89,759,43,25,18
30,89,805,38,18,20
30,89,970,21,10,11
30,89,640,47,25,22
30,89,1089,32,15,17
30,89,1122,24,12,12
30,89,4558,88,49,39
30,89,3646,55,28,27
30,89,2601,45,24,21
30,89,1449,33,24,9
30,89,964,8,4,4
30,89,855,22,11,11
30,89,999,27,11,16
30,89,583,12,7,5
30,89,859,25,14,11
30,89,550,9,5,4
30,89,490,16,5,11
30,89,646,53,27,26
30,89,589,32,17,15
30,89,975,1,1,0
30,89,987,6,4,2
30,89,1898,21,12,9
30,89,1530,40,22,18
30,89,2460,18,9,9
30,89,836,19,9,10
30,89,954,33,20,13
30,89,563,24,15,9
30,89,608,21,13,8
30,89,771,69,37,32
30,89,668,33,14,19
30,89,997,34,18,16
30,89,591,18,7,11
30,89,901,38,16,22
30,89,824,39,20,19
30,89,901,26,18,8
30,89,1061,20,11,9
30,89,1068,42,27,15
30,89,1009,53,33,20
30,89,1050,38,22,16
30,89,1696,58,31,27
30,89,2354,12,5,7
30,89,6904,153,73,80
30,89,1061,57,31,26
30,89,812,152,79,73
30,89,970,27,13,14
30,89,621,12,4,8
30,89,601,25,16,9
30,89,680,6,4,2
30,89,828,12,5,7
30,89,868,16,11,5
30,89,1707,36,18,18
30,89,1962,15,8,7
30,89,968,7,5,2
30,89,1114,24,17,7
30,89,660,38,21,17
30,89,1064,70,34,36
30,89,1203,49,25,24
30,89,922,52,27,25
30,89,455,23,14,9
30,89,907,54,27,27
30,89,1117,31,17,14
30,89,1030,18,9,9
30,89,1093,19,13,6
30,89,1846,45,25,20
30,89,1430,25,10,15
30,89,980,25,12,13
30,89,758,24,15,9
30,89,1013,23,14,9
30,89,762,64,33,31
30,89,534,38,22,16
30,89,734,54,26,28
30,89,893,52,30,22
30,89,977,22,12,10
30,89,489,27,14,13
30,89,1293,63,35,28
30,89,1452,242,116,126
30,89,1380,55,27,28
30,89,974,27,15,12
30,89,1017,17,13,4
30,89,617,30,18,12
30,89,605,48,16,32
30,89,524,49,25,24
30,89,505,36,18,18
30,89,492,34,21,13
30,89,884,81,49,32
30,89,1011,13,6,7
30,89,898,9,4,5
30,89,850,17,11,6
30,89,1895,44,23,21
30,89,5048,136,77,59
30,89,2254,44,17,27
30,89,2114,43,19,24
30,89,924,181,93,88
30,89,426,37,20,17
30,89,581,58,35,23
30,89,1137,74,34,40
30,89,688,63,32,31
30,89,951,40,16,24
30,89,701,19,13,6
30,89,814,26,13,13
30,89,1958,41,25,16
30,89,949,15,10,5
30,89,892,28,14,14
30,89,1080,52,29,23
30,89,924,64,32,32
30,89,908,27,15,12
30,89,9011,541,281,260
30,89,785,85,43,42
30,89,8389,193,99,94
30,89,765,14,7,7
30,89,202,0,0,0
30,89,1578,49,24,25
30,89,1292,19,11,8
30,89,1048,48,27,21
30,89,557,16,5,11
30,89,1022,43,23,20
30,89,1132,75,34,41
30,89,1875,34,18,16
30,89,3713,234,125,109
30,89,2320,84,39,45
30,89,1212,145,81,64
30,89,1769,53,22,31
30,89,4086,113,51,62
30,89,4174,285,148,137
30,89,2850,27,14,13
30,89,2677,45,17,28
30,89,1465,8,4,4
30,89,1230,40,22,18
30,89,14279,255,114,141
30,89,2451,28,13,15
30,89,1919,53,32,21
30,89,4087,60,33,27
30,89,4117,97,45,52
30,89,521,0,0,0
30,89,494,6,5,1
30,89,15244,1133,572,561
30,89,2379,51,25,26
30,90,1627,87,42,45
30,90,1567,13,9,4
30,90,205,0,0,0
30,90,1707,81,42,39
30,91,670,19,12,7
30,91,1119,14,8,6
30,91,1177,38,24,14
30,91,1110,17,11,6
30,91,769,67,42,25
30,91,885,8,6,2
30,91,565,4,0,4
30,91,2265,29,12,17
30,91,1234,10,5,5
30,91,1868,34,18,16
30,91,1690,48,21,27
30,91,1438,59,29,30
30,91,417,9,6,3
30,91,1370,46,22,24
30,91,1483,6,4,2
30,91,2607,20,12,8
30,91,587,16,7,9
30,91,1305,25,14,11
30,91,1015,17,7,10
30,91,1540,24,16,8
30,91,1214,5,3,2
30,91,1781,8,5,3
30,91,1270,20,10,10
30,91,1411,9,4,5
30,91,896,2,2,0
30,91,1739,7,3,4
30,91,702,5,2,3
30,91,1039,7,0,7
30,91,634,10,3,7
30,91,107,12,5,7
30,91,516,2,1,1
30,91,944,2,1,1
30,91,1254,18,6,12
30,92,1789,88,40,48
30,92,1051,27,18,9
30,92,2931,49,21,28
30,92,900,26,15,11
30,92,1487,9,4,5
30,92,202,6,2,4
30,92,1424,102,55,47
30,92,1117,6,2,4
30,93,1864,34,17,17
30,93,665,11,5,6
30,93,508,4,3,1
30,93,767,0,0,0
30,93,386,43,21,22
30,93,260,0,0,0
30,93,1091,12,9,3
30,93,2374,23,10,13
30,93,917,13,4,9
30,93,3763,53,23,30
30,93,1405,10,4,6
30,93,1790,31,19,12
30,93,659,5,2,3
30,93,1288,19,7,12
30,93,953,8,4,4
30,93,736,17,10,7
30,93,1906,32,19,13
30,93,2131,10,4,6
30,93,1525,12,5,7
30,93,784,43,18,25
30,93,1380,10,5,5
30,93,1905,42,19,23
30,209,1432,92,49,43
30,209,2727,417,195,222
30,94,2454,49,25,24
30,94,1855,8,5,3
30,94,1536,4,2,2
30,94,1798,5,1,4
30,94,1955,34,16,18
30,94,2273,56,26,30
30,94,2353,61,35,26
30,94,950,3,2,1
30,94,2141,54,24,30
30,95,2386,35,25,10
30,95,3035,20,9,11
30,95,3264,39,21,18
30,95,1483,28,15,13
30,95,2067,21,9,12
30,95,1782,21,8,13
30,95,1512,1,0,1
30,95,925,16,8,8
30,95,851,3,1,2
30,95,2658,11,6,5
30,95,1223,5,4,1
30,95,1491,3,2,1
30,95,1289,0,0,0
30,95,1070,1,1,0
30,95,947,0,0,0
30,95,1173,1,0,1
30,95,1700,3,1,2
30,95,1454,10,4,6
30,95,2001,2,1,1
30,95,1880,0,0,0
30,95,2397,9,4,5
30,95,1789,9,6,3
30,96,1317,21,12,9
30,96,1507,39,23,16
30,96,1302,2,2,0
30,96,1002,3,2,1
30,96,830,0,0,0
30,96,874,0,0,0
30,96,485,4,2,2
30,96,671,1,0,1
30,96,1365,2,2,0
30,96,672,1,0,1
30,96,552,0,0,0
30,96,430,0,0,0
30,96,663,3,1,2
30,96,436,5,2,3
30,96,1073,12,8,4
30,96,895,32,17,15
30,96,577,16,8,8
30,96,408,5,2,3
30,97,610,0,0,0
30,97,620,2,0,2
30,98,1401,25,16,9
30,98,2142,19,10,9
30,98,886,5,3,2
30,98,1988,45,21,24
30,98,2036,84,42,42
30,98,406,0,0,0
30,98,261,0,0,0
30,98,407,4,2,2
30,98,1156,23,14,9
30,98,1551,45,26,19
30,98,406,9,6,3
30,98,524,38,25,13
30,98,477,15,10,5
30,98,3154,68,33,35
30,98,926,4,2,2
30,98,1395,8,3,5
30,99,2311,9,6,3
30,99,586,1,1,0
30,99,475,2,1,1
30,100,2371,144,69,75
30,100,2523,28,14,14
30,100,2908,59,31,28
30,100,2387,59,32,27
30,100,3652,182,101,81
30,100,2369,222,118,104
30,100,1663,76,40,36
30,100,392,132,67,65
30,100,92,2,2,0
30,101,1819,3,3,0
30,101,1306,10,5,5
30,101,1260,5,2,3
30,101,1711,27,16,11
30,101,1555,1,0,1
30,101,2096,7,2,5
30,101,1341,16,9,7
30,101,787,0,0,0
30,101,1263,1,0,1
30,101,1471,2,0,2
30,101,1475,7,4,3
30,101,1064,30,13,17
30,101,1243,7,3,4
30,101,2397,49,29,20
30,101,1720,8,3,5
30,101,1976,3,0,3
30,102,4286,8,6,2
30,102,2246,13,8,5
30,102,2543,0,0,0
30,102,2475,0,0,0
30,102,1645,5,4,1
30,102,2553,4,2,2
30,102,2084,1,0,1
30,102,4729,134,65,69
30,102,3073,16,9,7
30,102,273,2,0,2
30,102,811,38,22,16
30,102,721,5,4,1
30,102,2627,16,11,5
30,102,2361,35,22,13
30,102,991,23,9,14
30,102,5395,108,55,53
30,103,3048,48,22,26
30,103,1738,5,3,2
30,103,3756,8,3,5
30,103,4089,30,16,14
30,103,2734,15,7,8
30,103,18070,204,112,92
30,103,1312,3,2,1
30,103,1546,12,7,5
30,103,1776,3,1,2
30,103,1619,4,3,1
30,103,1009,16,11,5
30,103,813,0,0,0
30,103,2238,32,19,13
30,103,975,5,1,4
30,103,981,1,1,0
30,103,2868,12,6,6
30,103,2329,6,1,5
30,103,1346,5,2,3
30,103,458,2,1,1
30,103,509,0,0,0
30,103,1586,8,5,3
30,103,1453,8,3,5
30,103,497,1,0,1
30,103,751,13,8,5
30,103,1294,4,2,2
30,103,1035,1,0,1
30,103,1669,16,8,8
30,103,1068,4,1,3
30,103,4831,15,6,9
30,103,657,2,1,1
30,103,1041,4,0,4
30,103,1182,10,5,5
30,103,1407,7,2,5
30,103,3208,21,11,10
30,103,1121,8,6,2
30,103,5053,33,14,19
30,103,474,1,0,1
30,103,416,25,13,12
30,211,822,0,0,0
30,211,133,10,5,5
30,211,537,0,0,0
30,211,289,0,0,0
30,211,504,3,2,1
30,211,676,0,0,0
30,211,1446,1,0,1
30,103,1474,0,0,0
30,103,208,1,1,0
30,103,662,2,1,1
30,103,1510,7,6,1
30,103,1609,4,2,2
30,211,450,0,0,0
30,211,805,0,0,0
30,211,418,3,1,2
30,211,888,2,1,1
30,211,304,4,1,3
30,211,947,0,0,0
30,211,2812,8,3,5
30,211,1236,6,4,2
30,211,2790,11,5,6
30,211,1914,5,3,2
30,211,1588,3,1,2
30,211,1561,9,6,3
30,211,485,0,0,0
30,211,248,0,0,0
30,103,2057,62,29,33
30,103,1555,3,3,0
30,103,1209,17,6,11
30,211,1309,3,1,2
30,211,1385,16,6,10
30,211,1376,21,7,14
30,211,1129,2,1,1
30,211,1238,2,2,0
30,211,593,2,0,2
30,211,1857,9,2,7
30,103,2722,15,4,11
30,103,1646,6,2,4
30,103,3010,11,5,6
30,103,587,6,3,3
30,103,776,0,0,0
30,103,1829,17,11,6
30,103,867,3,0,3
30,103,729,0,0,0
30,103,943,20,10,10
30,103,1636,4,3,1
30,103,830,1,1,0
30,103,403,0,0,0
30,103,194,0,0,0
30,103,448,3,0,3
30,103,706,9,4,5
30,103,710,1,0,1
30,104,3020,3,2,1
30,104,2629,5,5,0
30,104,2685,9,4,5
30,104,1508,5,3,2
30,104,2211,93,41,52
30,105,2931,45,24,21
30,105,2427,324,175,149
30,105,1841,5,1,4
30,210,933,35,20,15
30,105,1505,51,25,26
30,210,2794,7,3,4
30,210,2320,63,32,31
30,210,3561,104,53,51
30,105,2971,548,264,284
30,105,3209,29,16,13
30,105,2235,7,3,4
30,106,3604,325,165,160
30,106,2610,200,89,111
30,106,1692,1,1,0
30,106,1947,17,13,4
30,106,718,0,0,0
30,106,2545,6,1,5
30,106,2106,52,26,26
30,106,5789,150,71,79
30,106,1078,24,15,9
30,106,1561,55,21,34
30,106,2402,35,16,19
30,106,930,5,3,2
30,106,1514,144,79,65
30,106,1659,24,14,10
30,106,3605,33,16,17
30,106,3531,76,43,33
30,106,1248,16,9,7
30,106,866,0,0,0
30,106,2540,7,3,4
30,106,860,1,1,0
30,106,2177,10,7,3
30,106,409,10,4,6
30,106,752,1,1,0
30,106,662,3,1,2
30,107,1375,37,20,17
30,107,2402,3,0,3
30,107,1478,13,6,7
30,108,1608,1,1,0
30,108,1345,1,0,1
30,109,542,5,3,2
30,109,1593,23,13,10
30,109,1666,19,9,10
30,109,1243,14,7,7
30,109,895,10,4,6
30,109,341,2,1,1
30,109,581,7,4,3
30,109,1573,52,26,26
30,109,1175,29,14,15
30,109,1209,13,6,7
30,109,1269,6,2,4
30,109,1044,10,6,4
30,109,707,34,17,17
30,109,3215,15,8,7
30,109,2037,48,23,25
30,109,380,19,8,11
30,109,714,11,7,4
30,109,2369,14,7,7
30,109,687,9,6,3
30,109,1444,77,44,33
30,109,1079,7,5,2
30,109,395,11,4,7
30,109,609,1,0,1
30,109,556,20,11,9
30,109,271,0,0,0
30,109,2756,27,12,15
30,109,872,6,3,3
30,109,731,25,13,12
30,109,907,7,4,3
30,109,551,13,9,4
30,109,249,6,5,1
30,109,334,10,4,6
30,109,404,1,0,1
30,109,397,10,9,1
30,109,653,1,0,1
30,109,91,1,0,1
30,109,684,0,0,0
30,109,1173,11,7,4
30,109,320,3,1,2
30,109,344,26,12,14
30,109,69,0,0,0
30,109,198,0,0,0
30,109,788,28,17,11
30,109,1317,11,8,3
30,109,713,13,8,5
30,109,744,9,4,5
30,109,924,8,3,5
30,109,541,4,2,2
30,109,437,1,1,0
30,109,852,8,6,2
30,109,510,8,6,2
30,109,81,1,0,1
30,109,34,0,0,0
30,109,405,0,0,0
30,109,11321,145,77,68
30,109,409,0,0,0
30,109,1721,47,21,26
30,109,844,19,8,11
30,109,1083,30,12,18
30,109,1561,22,7,15
30,109,2186,7,3,4
30,109,602,11,5,6
30,109,887,9,3,6
30,109,517,1,1,0
30,109,1618,56,31,25
30,109,599,6,4,2
30,109,4424,81,41,40
30,109,1563,26,14,12
30,109,4919,39,19,20
30,109,13143,218,117,101
30,109,9109,122,55,67
30,109,1743,35,20,15
30,109,1971,37,14,23
30,109,837,35,15,20
30,109,977,8,4,4
30,109,1456,0,0,0
30,109,1549,8,3,5
30,109,1615,14,4,10
30,109,1376,0,0,0
30,109,2220,11,4,7
30,109,1118,6,3,3
30,109,1656,6,3,3
30,109,545,1,1,0
30,109,603,1,0,1
30,109,1052,6,3,3
30,109,1755,7,0,7
30,109,1225,10,2,8
30,109,1125,4,2,2
30,109,878,4,2,2
30,109,1732,10,1,9
30,109,2223,2,2,0
30,109,1611,4,0,4
30,109,2649,10,2,8
30,109,2633,2,2,0
30,109,1863,24,7,17
30,109,1295,6,0,6
30,109,2452,29,14,15
30,209,1817,28,11,17
30,209,676,50,26,24
30,209,4524,112,60,52
30,209,498,1,1,0
30,209,2127,11,5,6
30,209,4539,52,32,20
30,110,1657,29,16,13
30,110,1666,27,14,13
30,110,2767,37,20,17
30,110,2313,5,2,3
30,110,1234,5,2,3
30,110,1477,21,14,7
30,110,988,5,3,2
30,110,2073,22,10,12
30,110,1676,14,7,7
30,110,1745,44,19,25
30,110,823,0,0,0
30,110,1986,44,20,24
30,110,3325,13,4,9
30,110,865,0,0,0
30,110,777,3,2,1
30,110,1161,1,0,1
30,110,1240,6,2,4
30,110,757,2,1,1
30,110,1940,4,2,2
30,110,1362,13,5,8
30,110,1644,1,1,0
30,110,884,0,0,0
30,110,1280,3,1,2
30,110,681,19,6,13
30,110,521,4,1,3
30,110,473,0,0,0
30,110,748,2,0,2
30,110,798,1,0,1
30,110,1626,0,0,0
30,110,478,0,0,0
30,110,608,0,0,0
30,110,1075,0,0,0
30,110,1628,9,3,6
30,110,387,0,0,0
30,110,710,0,0,0
30,110,468,1,0,1
30,110,774,0,0,0
30,110,1285,47,31,16
30,110,1194,3,3,0
30,110,895,0,0,0
30,110,1202,1,0,1
30,110,670,1,1,0
30,110,1261,5,2,3
30,110,852,0,0,0
30,110,1331,0,0,0
30,110,420,3,2,1
30,110,1276,0,0,0
30,110,618,0,0,0
30,110,930,0,0,0
30,110,1042,0,0,0
30,110,909,5,1,4
30,111,1646,1,1,0
30,111,3047,5,3,2
30,111,2328,288,153,135
30,111,1802,10,4,6
30,111,4059,12,3,9
30,112,2133,36,18,18
30,112,1737,10,2,8
30,112,2032,3,1,2
30,112,1511,0,0,0
30,112,784,0,0,0
30,112,2136,34,19,15
30,112,1222,16,11,5
30,112,1977,17,10,7
30,112,778,0,0,0
30,112,2140,27,16,11
30,112,562,3,1,2
30,113,1994,54,25,29
30,113,2981,66,27,39
30,113,3068,134,68,66
30,113,768,20,5,15
30,113,990,36,19,17
30,113,1749,4,4,0
30,113,692,4,2,2
30,113,1832,14,7,7
30,113,960,41,17,24
30,113,2050,281,134,147
30,113,1018,16,5,11
30,113,3108,519,259,260
30,113,1547,42,23,19
30,114,2329,361,198,163
30,114,1666,35,24,11
30,114,619,5,3,2
30,115,1198,4,3,1
30,115,1626,7,3,4
30,115,867,1,1,0
30,115,1025,8,4,4
30,115,975,0,0,0
30,115,487,2,1,1
30,115,255,2,1,1
30,115,1126,4,1,3
30,115,943,0,0,0
30,115,516,0,0,0
30,115,1117,8,4,4
30,116,1530,8,2,6
30,116,1252,6,4,2
30,116,1017,5,3,2
30,116,1915,25,13,12
30,116,438,3,1,2
30,116,217,3,1,2
30,116,1104,12,6,6
30,116,2485,12,10,2
30,116,2557,51,23,28
30,116,825,11,6,5
30,116,1211,6,3,3
30,116,990,1,0,1
30,116,5711,91,44,47
30,116,5824,60,33,27
30,116,2758,6,3,3
30,116,3031,39,23,16
30,116,2221,2,1,1
30,116,4528,53,34,19
30,116,2057,11,7,4
30,117,1714,8,2,6
30,117,2020,86,46,40
30,117,2444,34,13,21
30,117,1260,55,26,29
30,117,2052,29,14,15
30,117,1772,32,10,22
30,117,1944,5,3,2
30,117,3137,6,3,3
30,117,1134,3,1,2
30,117,486,2,1,1
30,118,1941,27,12,15
30,118,1735,33,19,14
30,118,1247,32,25,7
30,118,981,4,1,3
30,118,648,1,1,0
30,118,1353,1,1,0
30,118,1503,53,31,22
30,118,1351,24,10,14
30,118,1290,19,9,10
30,118,635,4,3,1
30,118,2018,64,31,33
30,118,2190,117,56,61
30,118,1233,36,14,22
30,118,1670,72,27,45
30,118,2236,71,36,35
30,118,1565,181,86,95
30,119,2074,66,32,34
30,119,1210,32,16,16
30,119,7985,333,184,149
30,119,4120,111,57,54
30,119,1466,19,12,7
30,119,2125,72,40,32
30,119,830,13,10,3
30,119,1491,37,21,16
30,119,1405,40,20,20
30,119,1259,64,42,22
30,119,1597,74,39,35
30,119,2468,43,27,16
30,119,1002,14,6,8
30,119,686,5,1,4
30,119,751,11,5,6
30,119,1401,37,21,16
30,119,248,0,0,0
30,119,736,4,4,0
30,119,727,41,23,18
30,119,2398,12,4,8
30,119,1691,3,2,1
30,119,754,27,16,11
30,119,771,6,4,2
30,119,808,7,4,3
30,119,634,2,0,2
30,119,645,1,0,1
30,119,739,6,3,3
30,119,1944,9,2,7
30,119,1257,26,14,12
30,119,840,4,1,3
30,119,1066,7,4,3
30,119,401,1,1,0
30,119,522,2,1,1
30,119,1103,29,16,13
30,119,546,6,1,5
30,119,846,8,5,3
30,119,705,1,0,1
30,119,712,18,6,12
30,119,1149,6,3,3
30,119,741,10,3,7
30,119,299,5,3,2
30,119,388,7,5,2
30,119,1723,22,11,11
30,119,880,11,5,6
30,119,1071,17,7,10
30,119,810,10,5,5
30,119,1011,11,5,6
30,119,883,18,12,6
30,119,511,4,2,2
30,119,813,15,11,4
30,119,1666,30,16,14
30,119,1201,17,13,4
30,119,2222,22,8,14
30,119,1721,24,11,13
30,119,919,13,8,5
30,119,1764,38,20,18
30,119,780,3,0,3
30,119,761,14,7,7
30,119,2203,100,50,50
30,119,1100,14,6,8
30,119,1447,40,23,17
30,119,289,6,4,2
30,119,421,16,10,6
30,119,1572,22,8,14
30,119,297,2,0,2
30,119,819,54,28,26
30,119,1203,11,5,6
30,119,696,15,11,4
30,119,970,19,13,6
30,119,274,5,2,3
30,119,776,28,14,14
30,119,91,6,2,4
30,119,397,17,10,7
30,119,709,28,18,10
30,119,667,4,1,3
30,119,299,17,11,6
30,119,1254,8,3,5
30,119,2905,41,24,17
30,119,751,2,1,1
30,119,939,5,1,4
30,119,699,1,0,1
30,119,1621,84,50,34
30,119,973,26,17,9
30,119,542,12,7,5
30,119,517,2,0,2
30,119,1232,11,7,4
30,119,1204,8,3,5
30,119,295,7,3,4
30,119,478,11,3,8
30,119,1041,14,10,4
30,119,847,2,0,2
30,119,2077,48,27,21
30,119,1663,40,17,23
30,119,1173,16,9,7
30,119,999,0,0,0
30,119,987,25,14,11
30,119,2856,29,9,20
30,119,3055,29,12,17
30,120,1323,72,40,32
30,120,1195,88,40,48
30,120,1475,95,42,53
30,120,1444,44,22,22
30,120,165,8,3,5
30,121,127,7,2,5
30,121,2017,830,419,411
30,121,1337,251,140,111
30,121,1544,262,147,115
30,121,4462,533,306,227
30,121,4911,392,195,197
30,122,1895,94,46,48
30,122,2802,30,17,13
30,122,432,0,0,0
30,122,505,0,0,0
30,122,289,10,1,9
30,122,1022,10,5,5
30,122,203,0,0,0
30,122,477,0,0,0
30,122,489,10,4,6
30,122,539,3,2,1
30,122,765,7,2,5
30,122,1016,12,6,6
30,122,1362,5,2,3
30,122,347,28,13,15
30,122,1538,14,8,6
30,122,395,2,1,1
30,122,708,19,10,9
30,122,498,23,12,11
30,122,746,3,0,3
30,122,821,3,3,0
30,122,166,1,0,1
30,122,1296,4,2,2
30,122,790,3,2,1
30,122,444,3,3,0
30,122,396,2,1,1
30,122,611,197,91,106
30,122,1311,383,192,191
30,122,452,117,59,58
30,122,459,1,0,1
30,123,2354,7,5,2
30,123,2708,69,27,42
30,123,2094,9,5,4
30,123,3093,102,51,51
30,123,905,10,5,5
30,123,1788,11,7,4
30,123,1850,2,1,1
30,123,1940,101,48,53
30,123,1351,340,167,173
30,124,537,4,1,3
30,124,1464,15,10,5
30,124,726,1,0,1
30,124,1712,24,17,7
30,124,562,0,0,0
30,124,3074,40,22,18
30,124,1226,1,0,1
30,124,392,2,1,1
30,124,476,2,2,0
30,124,1171,3,1,2
30,124,1788,8,2,6
30,124,1899,11,5,6
30,124,3484,30,15,15
30,124,1257,4,3,1
30,124,643,8,6,2
30,124,750,2,1,1
30,124,927,9,4,5
30,124,1256,34,22,12
30,124,770,0,0,0
30,124,2499,25,12,13
30,124,1484,14,4,10
30,124,4394,68,30,38
30,124,3580,40,23,17
30,124,1077,2,1,1
30,124,1161,5,2,3
30,124,1241,0,0,0
30,124,1386,12,5,7
30,124,759,1,1,0
30,124,312,0,0,0
30,124,404,0,0,0
30,124,173,2,1,1
30,124,895,0,0,0
30,124,134,1,1,0
30,124,168,0,0,0
30,124,390,0,0,0
30,124,324,0,0,0
30,124,846,9,7,2
30,124,464,1,0,1
30,124,408,3,2,1
30,124,356,0,0,0
30,124,447,0,0,0
30,124,501,0,0,0
30,124,260,0,0,0
30,124,183,1,1,0
30,124,569,0,0,0
30,124,3120,2,1,1
30,124,8358,70,42,28
30,124,1914,20,14,6
30,124,1299,6,3,3
30,124,235,10,4,6
30,124,289,2,1,1
30,124,222,12,4,8
30,124,404,1,0,1
30,124,755,1,0,1
30,124,1457,3,2,1
30,124,1282,3,0,3
30,124,787,1,1,0
30,124,1483,4,4,0
30,124,388,0,0,0
30,124,1238,6,3,3
30,124,308,0,0,0
30,124,1148,0,0,0
30,124,1663,11,6,5
30,124,629,0,0,0
30,124,427,1,1,0
30,124,635,0,0,0
30,124,441,1,0,1
30,124,601,1,0,1
30,124,1429,3,2,1
30,124,1018,0,0,0
30,124,1868,4,2,2
30,124,2062,3,1,2
30,124,4022,22,12,10
30,124,424,1,0,1
30,124,1126,5,2,3
30,124,632,5,2,3
30,124,716,0,0,0
30,124,302,0,0,0
30,124,1518,25,12,13
30,124,568,0,0,0
30,124,1446,2,1,1
30,124,446,0,0,0
30,124,893,5,3,2
30,125,3707,21,14,7
30,125,2924,51,29,22
30,125,1759,6,4,2
30,125,1564,19,11,8
30,125,1428,8,6,2
30,125,1286,20,13,7
30,125,1331,15,10,5
30,125,1482,35,22,13
30,125,1963,21,12,9
30,125,1099,4,1,3
30,125,2188,83,42,41
30,125,1344,512,274,238
30,125,1413,54,27,27
30,125,1244,6,4,2
30,125,2214,39,19,20
30,125,2960,19,10,9
30,125,1268,19,7,12
30,125,1222,21,13,8
30,125,2850,202,99,103
30,125,1394,25,16,9
30,125,1142,15,10,5
30,125,784,5,2,3
30,125,1995,13,7,6
30,125,5328,61,25,36
30,125,1568,4,2,2
30,125,2088,35,20,15
30,125,2450,203,108,95
30,125,1796,619,338,281
30,125,1419,1,0,1
30,125,1747,2,1,1
30,125,1668,5,2,3
30,125,2457,4,2,2
30,125,2215,1,1,0
30,125,678,0,0,0
30,125,1364,4,1,3
30,125,1120,145,73,72
30,125,936,7,3,4
30,125,1262,0,0,0
30,125,742,3,1,2
30,125,5225,37,18,19
30,125,4073,28,13,15
30,125,1364,11,6,5
30,125,880,0,0,0
30,125,958,3,2,1
30,125,1638,8,7,1
30,125,391,15,9,6
30,125,2374,4,2,2
30,125,1953,4,1,3
30,125,1175,4,2,2
30,125,1075,2,1,1
30,125,1032,22,15,7
30,125,1580,1,1,0
30,125,1597,47,22,25
30,125,1774,34,18,16
30,125,2035,84,37,47
30,125,2057,4,1,3
30,125,1284,17,6,11
30,125,3183,78,43,35
30,125,2847,2,1,1
30,125,1363,38,20,18
30,125,2334,17,7,10
30,125,1686,0,0,0
30,125,1619,2,2,0
30,125,1405,0,0,0
30,125,1037,1,1,0
30,125,2320,5,3,2
30,125,1852,5,4,1
30,125,896,0,0,0
30,125,1852,2,2,0
30,125,1185,0,0,0
30,125,1934,0,0,0
30,125,1258,13,9,4
30,125,2399,3,3,0
30,125,1768,10,6,4
30,125,782,0,0,0
30,125,956,4,1,3
30,125,935,7,5,2
30,125,1924,1,0,1
30,125,1386,16,8,8
30,125,1070,4,2,2
30,125,1474,1,1,0
30,125,1797,8,3,5
30,125,568,3,2,1
30,125,2253,11,5,6
30,125,1229,9,2,7
30,125,917,0,0,0
30,125,1518,1,1,0
30,125,2019,2,0,2
30,125,1738,27,11,16
30,125,2595,13,5,8
30,125,1919,0,0,0
30,126,3495,52,27,25
30,126,1802,35,18,17
30,126,2016,26,14,12
30,126,2355,20,12,8
30,126,3479,30,19,11
30,126,2308,82,39,43
30,126,1619,11,5,6
30,126,2087,8,3,5
30,126,1452,624,313,311
30,126,2653,9,3,6
30,126,1946,13,4,9
30,126,1943,71,31,40
30,126,2046,80,41,39
30,126,2776,11,8,3
30,127,968,3,1,2
30,127,1848,1,0,1
30,127,1234,7,2,5
30,127,788,11,5,6
30,127,586,1,0,1
30,127,1869,5,2,3
30,127,1048,6,4,2
30,127,2318,30,18,12
30,127,1693,13,10,3
30,127,517,1,0,1
30,127,1349,16,8,8
30,127,2229,22,10,12
30,127,1703,14,7,7
30,127,290,1,1,0
30,127,1624,4,2,2
30,127,1447,0,0,0
30,127,1089,2,1,1
30,127,1688,2,1,1
30,127,1675,7,1,6
30,127,952,1,0,1
30,127,1129,2,2,0
30,127,1782,15,9,6
30,127,1031,2,1,1
30,127,1330,1,0,1
30,128,4430,32,18,14
30,128,2505,121,62,59
30,128,2228,32,22,10
30,128,1867,4,2,2
30,128,5036,18,10,8
30,128,5392,54,26,28
30,128,3527,6,3,3
30,128,3113,8,4,4
30,129,4030,8,4,4
30,129,1514,8,3,5
30,129,3479,33,17,16
30,129,3242,31,20,11
30,129,1628,20,6,14
30,129,1847,16,8,8
30,129,612,5,3,2
30,129,10043,488,263,225
30,129,1674,8,5,3
30,129,7365,38,17,21
30,129,5294,48,28,20
30,129,3037,27,11,16
30,129,688,0,0,0
30,129,2150,11,6,5
30,129,517,4,3,1
30,129,5787,18,9,9
30,129,2699,3,1,2
30,129,1209,17,8,9
30,129,134,1,0,1
30,129,490,0,0,0
30,129,1230,0,0,0
30,129,2579,18,8,10
30,129,3016,13,6,7
30,129,1850,50,26,24
30,129,1210,4,2,2
30,129,2411,5,3,2
30,129,2730,20,11,9
30,129,1218,2,1,1
30,129,1003,0,0,0
30,129,1887,16,6,10
30,129,850,0,0,0
30,130,3374,2,1,1
30,130,1448,1,0,1
30,130,1130,1,0,1
30,130,1784,3,2,1
30,130,1607,2,1,1
30,130,1687,2,2,0
30,130,367,0,0,0
30,130,2022,1,1,0
30,130,322,1,1,0
30,130,2044,9,3,6
30,130,332,1,0,1
30,130,578,1,1,0
30,130,774,2,1,1
30,130,432,0,0,0
30,131,4206,122,63,59
30,131,3306,106,52,54
30,131,1189,22,11,11
30,131,1100,120,70,50
30,131,1592,638,336,302
30,131,1334,615,322,293
30,131,1078,441,221,220
30,131,833,237,119,118
30,131,1756,94,46,48
30,131,920,738,380,358
30,131,1064,475,248,227
30,131,1313,7,4,3
30,131,2392,7,4,3
30,131,1950,230,114,116
30,131,1747,17,7,10
30,131,657,7,5,2
30,131,1021,0,0,0
30,131,1740,10,4,6
30,131,2469,8,6,2
30,212,3810,13,5,8
30,212,2026,78,39,39
30,131,1060,6,3,3
30,131,2586,14,7,7
30,131,1858,8,5,3
30,131,1665,13,5,8
30,131,536,0,0,0
30,212,1861,1,1,0
30,212,3085,1,0,1
30,132,2510,175,99,76
30,132,1576,164,82,82
30,132,4036,59,31,28
30,132,2312,55,29,26
30,132,1490,60,33,27
30,132,1289,12,7,5
30,132,2003,20,11,9
30,132,1463,16,9,7
30,132,1618,17,7,10
30,132,4084,31,19,12
30,132,3954,25,14,11
30,132,2502,18,8,10
30,132,993,14,4,10
30,132,872,6,4,2
30,132,1115,230,129,101
30,132,1558,22,15,7
30,132,1551,8,3,5
30,132,801,7,3,4
30,132,843,81,39,42
30,132,954,9,6,3
30,132,3702,86,52,34
30,132,2323,21,11,10
30,132,1891,35,19,16
30,132,1654,29,13,16
30,132,749,2,0,2
30,132,613,4,1,3
30,132,754,6,3,3
30,132,862,11,4,7
30,132,1488,27,13,14
30,132,876,17,9,8
30,132,2993,23,13,10
30,132,2233,80,43,37
30,132,734,10,6,4
30,132,856,7,4,3
30,132,635,5,4,1
30,132,4845,16,9,7
30,132,2233,75,39,36
30,132,1544,12,8,4
30,132,1621,17,11,6
30,132,452,8,7,1
30,132,1021,22,7,15
30,132,9260,315,180,135
30,132,2812,28,19,9
30,132,1813,19,8,11
30,132,1305,13,4,9
30,132,803,15,6,9
30,132,1034,32,21,11
30,132,1664,12,5,7
30,132,1112,12,7,5
30,132,1447,17,9,8
30,132,2409,16,9,7
30,132,967,9,5,4
30,132,1171,27,20,7
30,132,411,6,3,3
30,132,576,4,3,1
30,132,1001,11,7,4
30,132,1707,11,4,7
30,132,1495,9,4,5
30,132,3,0,0,0
30,132,1719,90,42,48
30,132,1432,12,8,4
30,132,2391,12,8,4
30,132,1945,9,4,5
30,132,1479,3,1,2
30,132,874,4,1,3
30,132,481,0,0,0
30,132,1072,12,5,7
30,132,915,5,3,2
30,132,556,3,0,3
30,132,344,1,1,0
30,132,544,1,0,1
30,132,702,11,9,2
30,132,657,20,12,8
30,132,876,12,7,5
30,132,1955,12,8,4
30,132,1448,11,6,5
30,132,2918,36,19,17
30,132,1788,8,4,4
30,132,560,1,0,1
30,132,3158,9,4,5
30,132,1120,12,9,3
30,132,2704,17,11,6
30,132,1838,9,6,3
30,132,1158,29,14,15
30,132,936,9,7,2
30,132,652,1,0,1
30,132,299,0,0,0
30,132,2686,4,2,2
30,132,2499,9,5,4
30,132,1801,6,3,3
30,132,1026,11,6,5
30,132,2748,15,9,6
30,132,1950,14,6,8
30,132,1248,3,3,0
30,132,1208,8,2,6
30,132,1849,12,8,4
30,132,894,20,12,8
30,132,543,0,0,0
30,132,1120,0,0,0
30,132,1101,18,8,10
30,132,645,13,6,7
30,132,2280,37,19,18
30,132,2172,19,14,5
30,132,4504,46,24,22
30,132,2326,17,11,6
30,132,2337,13,5,8
30,132,2739,27,17,10
30,132,2520,8,4,4
30,132,2150,8,1,7
30,132,4172,38,19,19
30,133,1403,5,2,3
30,133,919,0,0,0
30,133,3452,2,1,1
30,133,1047,4,2,2
30,133,1212,2,0,2
30,133,634,0,0,0
30,133,2602,12,5,7
30,133,678,0,0,0
30,133,2838,1,1,0
30,133,906,2,1,1
30,133,2302,8,6,2
30,133,317,18,12,6
30,133,8,0,0,0
30,133,47,2,0,2
30,133,671,3,3,0
30,133,9631,86,40,46
30,133,439,3,2,1
30,133,729,2,2,0
30,133,1369,14,7,7
30,133,1450,3,2,1
30,133,1517,2,0,2
30,133,1334,14,6,8
30,133,1698,14,7,7
30,133,1358,13,5,8
30,133,1209,4,2,2
30,133,1406,14,7,7
30,133,3447,28,16,12
30,133,647,1,1,0
30,133,495,1,0,1
30,133,553,1,0,1
30,133,1407,7,5,2
30,133,116,0,0,0
30,133,2978,17,7,10
30,133,3062,14,7,7
30,133,1091,13,5,8
30,133,805,0,0,0
30,133,875,3,3,0
30,133,522,1,0,1
30,133,756,0,0,0
30,133,129,0,0,0
30,134,1105,5,2,3
30,134,253,1,0,1
30,134,4297,110,59,51
30,134,1250,12,4,8
30,134,2765,95,46,49
30,134,1805,25,11,14
30,134,3202,32,14,18
30,134,1138,24,9,15
30,134,2012,27,15,12
30,134,645,0,0,0
30,134,1240,7,3,4
30,134,1164,0,0,0
30,134,686,1,0,1
30,134,1776,2,1,1
30,134,1213,2,0,2
30,135,2321,8,5,3
30,135,2606,16,8,8
30,135,2097,62,33,29
30,135,3287,118,54,64
30,135,5286,51,26,25
30,135,2351,5,1,4
30,135,3185,30,11,19
30,135,2300,11,4,7
30,135,2523,14,7,7
30,136,2618,111,62,49
30,136,3139,271,138,133
30,136,2758,16,8,8
30,137,4157,21,12,9
30,137,3925,37,15,22
30,137,1948,142,71,71
30,137,3094,75,39,36
30,137,1015,8,5,3
30,137,1574,8,3,5
30,137,2178,8,4,4
30,137,2227,3,2,1
30,138,4780,777,398,379
30,138,1279,73,45,28
30,138,1478,51,20,31
30,139,123,0,0,0
30,139,2104,20,11,9
30,139,5993,29,20,9
30,139,3401,157,85,72
30,139,2042,64,36,28
30,139,4680,52,25,27
30,139,2058,23,14,9
30,139,3590,37,20,17
30,139,459,5,3,2
30,139,871,5,3,2
30,139,1317,9,4,5
30,139,913,12,6,6
30,139,1494,31,19,12
30,139,1494,21,14,7
30,139,2104,9,5,4
30,139,3594,71,35,36
30,139,5560,32,14,18
30,139,1667,4,2,2
30,139,1058,8,5,3
30,139,1124,25,11,14
30,139,1520,20,10,10
30,139,1064,32,20,12
30,139,3689,30,23,7
30,139,2963,20,7,13
30,140,971,2,1,1
30,140,1174,13,7,6
30,140,1696,6,2,4
30,140,1753,1,1,0
30,140,487,2,2,0
30,141,2955,38,20,18
30,141,381,0,0,0
30,142,2532,28,12,16
30,142,4357,45,27,18
30,142,3452,18,9,9
30,142,1929,6,3,3
30,142,1998,1,0,1
30,142,2100,11,4,7
30,142,848,3,0,3
30,142,2147,44,24,20
30,142,1009,2,1,1
30,142,330,3,3,0
30,142,877,0,0,0
30,142,2258,7,2,5
30,142,2243,15,6,9
30,142,572,9,3,6
30,142,1244,0,0,0
30,142,1389,9,2,7
30,142,2945,51,23,28
30,142,1336,39,20,19
30,142,1573,18,10,8
30,142,1497,21,9,12
30,142,1046,13,6,7
30,142,1603,29,13,16
30,142,5009,49,23,26
30,142,1745,26,12,14
30,142,1758,13,8,5
30,142,1303,7,5,2
30,142,1549,15,10,5
30,142,1673,6,1,5
30,142,2280,7,4,3
30,142,749,19,12,7
30,142,1119,14,8,6
30,142,1286,21,10,11
30,142,1364,7,4,3
30,142,1026,10,3,7
30,142,2182,17,9,8
30,142,832,13,7,6
30,142,591,2,1,1
30,142,3912,13,7,6
30,142,4330,14,10,4
30,142,3115,6,3,3
30,142,3571,15,9,6
30,142,1679,7,5,2
30,142,2480,8,4,4
30,142,1915,47,26,21
30,142,2574,44,21,23
30,142,2294,11,6,5
30,142,2741,4,2,2
30,142,4332,6,3,3
30,142,1349,4,1,3
30,142,3528,47,23,24
30,142,4743,34,14,20
30,142,2483,6,5,1
30,142,2222,3,0,3
30,142,1431,1,0,1
30,142,1635,5,1,4
30,142,1528,4,2,2
30,142,2680,6,2,4
30,142,1399,0,0,0
30,142,1334,0,0,0
30,142,2001,3,2,1
30,142,2921,14,6,8
30,142,2229,3,3,0
30,142,996,1,0,1
30,142,1847,0,0,0
30,142,591,1,0,1
30,142,2128,2,1,1
30,142,939,0,0,0
30,142,1957,1,1,0
30,142,2103,7,4,3
30,142,2345,3,1,2
30,142,2118,3,3,0
30,142,1061,0,0,0
30,142,1224,0,0,0
30,142,2784,6,1,5
30,142,2811,12,6,6
30,142,3149,11,5,6
30,142,659,0,0,0
30,142,1600,9,6,3
30,142,1278,18,7,11
30,142,618,0,0,0
30,143,899,20,8,12
30,143,986,4,2,2
30,143,1008,9,4,5
30,143,1059,15,7,8
30,143,1270,8,3,5
30,143,2620,4,0,4
30,143,1523,1,0,1
30,143,2523,5,3,2
30,143,1525,3,0,3
30,143,866,3,1,2
30,143,1029,6,4,2
30,143,814,192,96,96
30,143,1762,5,3,2
30,143,1866,6,2,4
30,143,928,194,100,94
30,143,1053,8,5,3
30,143,553,8,4,4
30,143,602,1,1,0
30,143,665,1,0,1
30,143,2338,17,6,11
30,143,711,1,0,1
30,143,1184,1,0,1
30,143,479,0,0,0
30,143,1179,4,3,1
30,143,875,2,0,2
30,143,1555,6,3,3
30,143,707,4,4,0
30,144,2589,3,3,0
30,144,1591,11,5,6
30,144,1204,1,1,0
30,144,1421,0,0,0
30,144,509,0,0,0
30,144,849,3,1,2
30,144,1506,40,23,17
30,144,638,24,12,12
30,144,1299,21,12,9
30,144,1473,33,20,13
30,144,2987,46,28,18
30,144,1759,10,4,6
30,144,643,4,1,3
30,144,1153,4,2,2
30,144,671,2,1,1
30,144,1643,51,24,27
30,144,2852,12,3,9
30,144,1579,3,1,2
30,144,1730,13,6,7
30,144,2155,18,8,10
30,144,891,0,0,0
30,144,1993,18,11,7
30,144,1841,2,1,1
30,144,1537,6,4,2
30,144,2079,8,4,4
30,144,1288,1,1,0
30,144,1616,9,7,2
30,144,801,6,2,4
30,144,1928,6,2,4
30,144,2003,7,4,3
30,144,1675,19,11,8
30,144,1762,1,1,0
30,144,461,3,3,0
30,144,961,17,7,10
30,144,2122,53,27,26
30,144,1956,8,6,2
30,144,604,4,1,3
30,144,1541,5,3,2
30,145,3629,37,19,18
30,145,1722,227,118,109
30,145,2120,270,130,140
30,145,2051,6,3,3
30,145,2618,80,43,37
30,145,2666,176,94,82
30,145,1884,800,436,364
30,145,770,89,44,45
30,145,980,85,34,51
30,145,946,6,6,0
30,145,1603,191,101,90
30,145,1299,172,83,89
30,145,2338,349,177,172
30,145,1265,9,3,6
30,145,1548,19,8,11
30,145,1856,78,42,36
30,145,1232,25,14,11
30,145,1087,11,3,8
30,145,861,41,24,17
30,146,1711,18,10,8
30,146,1951,18,13,5
30,146,2598,22,15,7
30,146,754,0,0,0
30,146,829,2,0,2
30,146,1104,3,2,1
30,146,937,1,0,1
30,146,6742,173,94,79
30,147,1416,8,3,5
30,147,2509,76,37,39
30,148,3804,74,38,36
30,148,6177,112,61,51
30,148,3663,3,3,0
30,148,3394,9,6,3
30,148,2770,81,34,47
30,148,971,10,5,5
30,148,3058,8,4,4
30,148,2365,14,8,6
30,148,2834,5,4,1
30,149,2990,35,19,16
30,149,1736,29,13,16
30,149,2161,30,11,19
30,149,2337,43,17,26
30,149,651,2,2,0
30,149,1006,19,11,8
30,149,1013,56,37,19
30,149,1471,9,3,6
30,149,1553,55,30,25
30,149,1706,140,66,74
30,149,1177,403,208,195
30,149,1344,4,3,1
30,149,1596,25,13,12
30,149,1766,2,1,1
30,149,1204,7,3,4
30,149,2247,11,7,4
30,149,1667,4,1,3
30,150,2286,59,28,31
30,150,3004,223,123,100
30,150,2100,58,29,29
30,150,4098,12,6,6
30,210,1881,12,8,4
30,210,2140,8,4,4
30,150,3625,11,4,7
30,150,1225,38,21,17
30,150,3396,7,4,3
30,150,4761,19,8,11
30,150,3676,12,5,7
30,150,2795,16,9,7
30,150,3400,13,6,7
30,151,1952,17,8,9
30,151,2270,30,14,16
30,151,1373,6,2,4
30,151,1711,2,1,1
30,151,861,4,2,2
30,151,941,11,3,8
30,151,1898,6,4,2
30,151,1133,480,245,235
30,152,1494,806,419,387
30,152,856,576,284,292
30,152,1062,791,429,362
30,152,612,356,184,172
30,152,654,458,211,247
30,152,808,123,61,62
30,152,1041,160,82,78
30,152,1631,1181,554,627
30,152,639,49,27,22
30,152,929,49,27,22
30,152,1033,757,389,368
30,152,389,109,65,44
30,152,2190,1147,591,556
30,152,1784,728,353,375
30,152,578,6,4,2
30,152,1029,4,2,2
30,152,1149,5,2,3
30,152,2431,150,76,74
30,152,683,2,1,1
30,152,711,8,3,5
30,152,276,23,8,15
30,153,761,18,10,8
30,153,2051,15,9,6
30,153,258,0,0,0
30,153,163,1,1,0
30,153,913,34,13,21
30,153,341,1,0,1
30,153,655,2,1,1
30,153,295,1,0,1
30,153,733,1,1,0
30,153,780,8,3,5
30,153,147,0,0,0
30,153,295,2,1,1
30,153,252,0,0,0
30,153,659,9,2,7
30,153,968,4,2,2
30,153,430,0,0,0
30,153,408,8,2,6
30,153,609,24,10,14
30,153,613,10,5,5
30,154,565,0,0,0
30,154,887,10,3,7
30,154,229,0,0,0
30,154,314,7,3,4
30,154,1423,124,70,54
30,154,1533,10,5,5
30,154,973,3,2,1
30,155,1742,19,13,6
30,155,1969,2,1,1
30,155,664,4,2,2
30,155,661,0,0,0
30,155,508,1,0,1
30,155,1507,5,1,4
30,155,1953,14,7,7
30,155,110,0,0,0
30,155,682,2,1,1
30,155,688,0,0,0
30,155,1005,0,0,0
30,156,2818,5,5,0
30,156,1215,1,1,0
30,156,3169,38,19,19
30,156,2057,2,0,2
30,156,2475,11,6,5
30,156,3485,13,7,6
30,156,1921,4,4,0
30,156,1602,1,0,1
30,156,1379,7,5,2
30,156,2220,11,3,8
30,156,1982,7,4,3
30,156,1337,2,1,1
30,156,2555,22,14,8
30,156,1547,4,3,1
30,156,1346,10,5,5
30,156,1649,1,0,1
30,156,600,1,1,0
30,156,408,0,0,0
30,156,333,1,0,1
30,156,1954,5,1,4
30,156,1142,0,0,0
30,156,974,0,0,0
30,156,1361,2,1,1
30,156,1966,4,3,1
30,156,2648,246,129,117
30,156,1722,12,6,6
30,156,1827,2,1,1
30,156,2979,38,16,22
30,156,2313,11,6,5
30,156,1106,1,0,1
30,156,2426,58,30,28
30,156,2083,22,12,10
30,156,1816,0,0,0
30,156,1380,6,2,4
30,156,2338,6,5,1
30,156,991,4,2,2
30,156,1974,726,371,355
30,156,1126,454,223,231
30,156,1762,8,2,6
30,156,2197,1,0,1
30,156,1059,8,2,6
30,156,1665,9,4,5
30,156,1162,7,3,4
30,156,1115,26,10,16
30,156,1107,4,4,0
30,156,2460,2,1,1
30,156,1776,13,6,7
30,156,1006,6,4,2
30,156,1825,5,3,2
30,156,980,1,0,1
30,156,1217,6,2,4
30,156,1450,9,6,3
30,156,2065,4,1,3
30,156,322,1,0,1
30,156,2811,1,1,0
30,156,1954,2,1,1
30,156,1218,5,2,3
30,156,876,2,2,0
30,156,1588,8,3,5
30,156,944,7,4,3
30,157,1628,5,3,2
30,157,2311,4,3,1
30,157,1494,6,4,2
30,157,839,1,0,1
30,158,1349,14,9,5
30,158,1080,15,8,7
30,158,597,0,0,0
30,158,1237,0,0,0
30,158,727,3,2,1
30,158,810,14,8,6
30,158,383,13,5,8
30,158,1690,17,9,8
30,158,418,4,3,1
30,158,216,1,1,0
30,158,1251,8,1,7
30,158,852,9,4,5
30,158,2119,530,280,250
30,158,1419,16,6,10
30,158,860,11,3,8
30,158,1242,2,1,1
30,158,518,26,13,13
30,158,1083,22,10,12
30,158,844,12,8,4
30,158,797,17,10,7
30,159,5278,20,10,10
30,159,3954,12,9,3
30,159,4378,51,29,22
30,159,1629,2,0,2
30,159,2240,0,0,0
30,159,3114,8,5,3
30,159,8788,34,15,19
30,160,820,26,15,11
30,160,2601,1,1,0
30,160,1200,3,2,1
30,160,365,0,0,0
30,160,2056,6,4,2
30,160,1737,2,2,0
30,160,2052,10,4,6
30,160,1226,12,5,7
30,160,1830,20,15,5
30,160,988,1,1,0
30,160,882,0,0,0
30,160,639,4,1,3
30,160,1372,4,1,3
30,160,1213,4,3,1
30,160,487,0,0,0
30,160,632,0,0,0
30,160,552,0,0,0
30,160,1332,1,1,0
30,160,1037,7,3,4
30,160,1776,2,1,1
30,160,973,0,0,0
30,160,1237,0,0,0
30,160,196,0,0,0
30,160,2717,5,3,2
30,160,933,4,1,3
30,160,696,30,17,13
30,160,980,6,2,4
30,160,330,1,0,1
30,160,701,32,18,14
30,160,760,9,6,3
30,161,2800,14,7,7
30,161,867,1,0,1
30,161,2661,83,41,42
30,162,1412,2,2,0
30,162,1271,1,1,0
30,162,559,5,3,2
30,162,1432,25,13,12
30,162,304,0,0,0
30,162,278,0,0,0
30,163,2776,19,13,6
30,163,1385,2,1,1
30,163,1776,10,4,6
30,163,1966,26,12,14
30,163,2842,32,15,17
30,163,1292,4,2,2
30,163,1435,5,2,3
30,163,1675,19,9,10
30,163,1818,2,1,1
30,164,3035,28,14,14
30,164,2340,14,4,10
30,164,3517,56,33,23
30,165,3131,26,16,10
30,165,668,0,0,0
30,165,1805,7,3,4
30,165,723,431,205,226
30,165,2148,7,2,5
30,165,0,0,0,0
30,166,3209,15,7,8
30,166,2388,24,10,14
30,166,2169,15,4,11
30,166,1856,1,0,1
30,166,1043,0,0,0
30,166,557,1,0,1
30,166,889,0,0,0
30,166,1555,18,9,9
30,166,937,4,1,3
30,167,3112,5,3,2
30,167,3767,37,15,22
30,167,813,0,0,0
30,167,612,2,1,1
30,167,1339,9,3,6
30,167,2784,5,3,2
30,167,1393,0,0,0
30,167,1093,2,0,2
30,168,1531,1,1,0
30,168,531,1,1,0
30,168,1429,0,0,0
30,168,799,197,100,97
30,168,1281,12,7,5
30,168,547,123,69,54
30,168,1357,4,4,0
30,168,1362,18,8,10
30,168,1073,5,3,2
30,168,2029,17,13,4
30,168,1953,169,91,78
30,168,1247,1,1,0
30,168,1104,2,1,1
30,168,1547,6,4,2
30,168,707,0,0,0
30,168,1012,27,14,13
30,168,1677,604,296,308
30,168,1054,12,5,7
30,168,429,8,3,5
30,169,3008,12,5,7
30,169,3287,33,21,12
30,169,1751,2,0,2
30,169,522,0,0,0
30,169,2256,17,9,8
30,170,2735,32,18,14
30,170,2104,284,156,128
30,170,492,60,31,29
30,170,108,2,2,0
30,171,1692,33,18,15
30,171,1033,3,1,2
30,171,1311,4,2,2
30,171,1042,4,1,3
30,171,1277,10,7,3
30,171,1687,83,42,41
30,171,769,0,0,0
30,171,1875,25,11,14
30,171,707,2,0,2
30,171,1179,28,13,15
30,171,1231,14,7,7
30,171,1472,2,2,0
30,171,637,10,6,4
30,171,807,1,1,0
30,171,1523,2,1,1
30,171,1682,2,1,1
30,172,1308,4,1,3
30,172,3253,58,30,28
30,172,2004,11,6,5
30,172,1094,2,0,2
30,172,2218,3,3,0
30,172,1640,21,8,13
30,172,1300,44,20,24
30,172,1592,191,99,92
30,172,1762,10,5,5
30,172,2435,16,10,6
30,172,2793,11,7,4
30,172,40,0,0,0
30,172,1830,39,23,16
30,172,2270,30,19,11
30,172,865,1,1,0
30,172,1666,2,0,2
30,172,1385,11,6,5
30,172,696,6,2,4
30,172,274,0,0,0
30,172,2546,34,17,17
30,172,1544,14,5,9
30,172,2524,1,0,1
30,172,993,1,0,1
30,172,1161,18,10,8
30,172,483,22,12,10
30,172,2138,170,89,81
30,172,1592,2,1,1
30,172,1186,9,5,4
30,172,1821,5,2,3
30,172,965,28,13,15
30,172,843,6,3,3
30,172,2996,64,37,27
30,172,1446,51,26,25
30,172,1576,15,6,9
30,172,1008,5,0,5
30,173,2415,23,13,10
30,173,2159,78,40,38
30,173,2818,42,23,19
30,173,1792,32,18,14
30,173,1532,29,11,18
30,173,2358,79,38,41
30,173,1404,199,101,98
30,173,1419,25,8,17
30,173,1693,38,19,19
30,173,1279,122,73,49
30,173,2140,29,16,13
30,173,786,0,0,0
30,173,1336,35,21,14
30,173,608,5,3,2
30,173,1098,40,19,21
30,173,334,4,2,2
30,173,1416,23,13,10
30,173,1101,88,48,40
30,173,2917,22,10,12
30,173,1527,643,339,304
30,173,838,7,4,3
30,173,817,9,7,2
30,173,1493,30,10,20
30,173,1500,10,6,4
30,173,1721,26,15,11
30,173,1179,1,1,0
30,173,3218,7,5,2
30,173,2571,7,5,2
30,173,3136,47,23,24
30,173,1543,34,15,19
30,173,749,18,12,6
30,173,1795,11,7,4
30,173,2163,12,7,5
30,173,1762,14,9,5
30,173,1272,2,1,1
30,173,1366,1,1,0
30,173,740,5,1,4
30,173,2602,19,10,9
30,173,1332,3,2,1
30,173,1105,5,4,1
30,173,2181,21,13,8
30,173,1529,6,5,1
30,173,830,1,0,1
30,173,593,0,0,0
30,173,700,2,0,2
30,173,419,4,2,2
30,173,1029,1,1,0
30,173,1167,13,5,8
30,173,841,1,1,0
30,173,2355,6,3,3
30,173,1284,8,7,1
30,173,1113,0,0,0
30,173,1578,22,11,11
30,173,127,0,0,0
30,173,850,0,0,0
30,173,1107,23,8,15
30,173,259,2,2,0
30,173,354,0,0,0
30,173,1703,1,1,0
30,173,780,2,1,1
30,173,1599,1,0,1
30,173,840,2,0,2
30,173,2700,9,7,2
30,173,1434,25,17,8
30,173,1991,4,3,1
30,173,389,0,0,0
30,173,336,0,0,0
30,174,2701,257,132,125
30,174,1440,21,12,9
30,174,3435,224,107,117
30,174,5215,246,138,108
30,174,1760,12,5,7
30,174,1029,30,17,13
30,174,1121,12,7,5
30,174,1158,0,0,0
30,174,1088,2,1,1
30,174,1842,15,11,4
30,174,1167,0,0,0
30,174,1560,2,1,1
30,174,1794,2,1,1
30,174,1713,9,6,3
30,174,1664,17,10,7
30,174,1845,40,17,23
30,174,1523,5,1,4
30,174,1230,34,16,18
30,174,1858,47,21,26
30,174,2289,4,2,2
30,174,1967,15,9,6
30,174,667,2,2,0
30,174,1711,38,21,17
30,174,3084,15,3,12
30,174,1782,4,3,1
30,174,2675,13,6,7
30,174,1564,10,4,6
30,174,1216,3,2,1
30,174,3569,19,11,8
30,174,698,3,2,1
30,174,937,2,0,2
30,174,1460,5,2,3
30,174,1738,12,7,5
30,174,2646,58,35,23
30,174,1443,77,32,45
30,174,1129,8,4,4
30,174,2520,37,14,23
30,174,4011,27,15,12
30,174,860,8,4,4
30,174,1367,6,3,3
30,174,2406,9,6,3
30,174,1888,6,3,3
30,174,1766,9,5,4
30,174,1630,27,8,19
30,174,879,7,2,5
30,174,2398,25,10,15
30,174,2364,56,30,26
30,174,3500,24,10,14
30,174,1819,10,4,6
30,175,947,8,2,6
30,175,1711,41,20,21
30,175,1338,5,5,0
30,175,499,4,2,2
30,176,1572,34,14,20
30,176,1584,4,3,1
30,176,2387,4,3,1
30,176,3490,18,8,10
30,176,413,5,4,1
30,176,1879,12,7,5
30,177,1939,54,24,30
30,177,494,17,11,6
30,177,567,6,4,2
30,177,1447,88,51,37
30,177,1994,46,33,13
30,177,1078,17,11,6
30,177,593,26,12,14
30,177,262,0,0,0
30,177,1575,35,19,16
30,177,949,13,5,8
30,177,1203,12,7,5
30,177,596,3,0,3
30,177,432,0,0,0
30,178,2027,43,23,20
30,178,2257,58,32,26
30,179,2811,16,9,7
30,179,368,4,3,1
30,179,2177,14,5,9
30,179,905,31,16,15
30,179,1598,22,12,10
30,179,758,0,0,0
30,179,337,1,1,0
30,179,747,13,6,7
30,179,1133,3,2,1
30,180,2074,24,11,13
30,180,1443,10,7,3
30,180,2103,41,15,26
30,180,1188,1,1,0
30,180,1323,30,15,15
30,180,599,0,0,0
30,180,1657,41,21,20
30,180,1146,2,2,0
30,180,1934,97,51,46
30,180,1615,243,117,126
30,180,806,54,28,26
30,180,676,82,41,41
30,180,1569,25,14,11
30,180,1397,203,117,86
30,180,1220,19,13,6
30,180,1639,46,23,23
30,180,2008,69,38,31
30,180,1150,73,30,43
30,180,802,3,1,2
30,180,1185,2,2,0
30,180,961,1,0,1
30,180,958,6,2,4
30,180,1307,5,4,1
30,180,1956,3,2,1
30,180,1704,4,2,2
30,180,1762,40,20,20
30,180,1769,9,6,3
30,181,3531,68,37,31
30,181,3407,16,8,8
30,181,8651,483,259,224
30,181,3392,58,27,31
30,181,1221,9,4,5
30,182,2022,71,36,35
30,182,2900,22,7,15
30,182,1946,3,0,3
30,182,3070,8,7,1
30,182,1417,14,10,4
30,182,1219,39,21,18
30,182,1117,244,140,104
30,182,1157,13,5,8
30,182,1456,37,18,19
30,182,1604,342,183,159
30,182,1013,2,1,1
30,182,1825,7,1,6
30,182,2283,1,0,1
30,182,3199,6,0,6
30,182,187,0,0,0
30,182,448,2,1,1
30,182,1276,0,0,0
30,182,1894,7,3,4
30,182,2836,18,8,10
30,182,2937,0,0,0
30,182,5106,2,1,1
30,182,677,3,1,2
30,182,2123,7,0,7
30,182,1140,22,13,9
30,182,439,0,0,0
30,182,1273,1,0,1
30,182,609,2,1,1
30,182,2098,33,21,12
30,182,637,0,0,0
30,182,1503,5,2,3
30,183,5204,28,10,18
30,183,1279,3,2,1
30,183,1231,2,1,1
30,184,4097,222,112,110
30,184,1626,4,2,2
30,185,1609,14,8,6
30,185,1602,9,5,4
30,185,1416,36,18,18
30,185,2665,536,273,263
30,186,1577,7,1,6
30,186,2470,14,6,8
30,186,2041,4,2,2
30,187,3532,44,17,27
30,187,1541,13,9,4
30,187,2922,66,31,35
30,187,1089,19,7,12
30,187,1060,94,50,44
30,187,1718,257,131,126
30,187,1144,3,2,1
30,187,1886,5,1,4
30,187,799,24,11,13
30,187,1640,9,5,4
30,188,405,22,12,10
30,188,2882,12,7,5
30,188,2963,35,18,17
30,188,1962,19,8,11
30,188,13217,372,174,198
30,188,3773,103,52,51
30,188,1501,8,7,1
30,188,2192,24,12,12
30,188,3088,85,43,42
30,188,1333,9,4,5
30,188,1185,11,5,6
30,188,1725,14,9,5
30,188,1486,29,16,13
30,188,802,10,6,4
30,188,1036,11,6,5
30,188,589,39,17,22
30,188,634,3,2,1
30,188,857,0,0,0
30,188,795,16,11,5
30,188,5382,69,30,39
30,188,4600,126,77,49
30,188,4101,30,17,13
30,188,5481,170,96,74
30,188,1093,15,8,7
30,188,647,28,13,15
30,188,857,24,9,15
30,188,649,21,13,8
30,188,856,15,8,7
30,188,836,15,7,8
30,188,1932,202,109,93
30,188,764,27,17,10
30,188,646,22,14,8
30,188,973,27,11,16
30,188,1003,40,25,15
30,188,2532,99,42,57
30,188,537,4,2,2
30,188,3030,74,44,30
30,188,877,7,3,4
30,188,316,14,8,6
30,188,1619,31,14,17
30,188,1915,53,28,25
30,188,999,20,10,10
30,188,2672,56,27,29
30,188,1083,38,19,19
30,188,4371,222,115,107
30,188,2354,81,34,47
30,188,3471,35,13,22
30,188,3034,41,20,21
30,188,1758,25,11,14
30,188,1165,1,1,0
30,188,1360,33,13,20
30,188,995,12,5,7
30,188,5246,24,7,17
30,188,1231,70,34,36
30,188,1289,2,2,0
30,188,218,0,0,0
30,188,1034,36,19,17
30,188,1660,30,17,13
30,188,2853,35,16,19
30,188,6603,193,98,95
30,188,3915,47,22,25
30,188,976,3,1,2
30,188,1008,13,6,7
30,188,5170,41,20,21
30,188,1506,3,0,3
30,188,2407,8,3,5
30,188,796,1,1,0
30,188,1089,4,2,2
30,188,1648,124,64,60
30,188,2568,57,31,26
30,188,1132,3,1,2
30,188,1589,11,7,4
30,188,1276,53,30,23
30,188,1276,39,21,18
30,188,1480,21,7,14
30,189,1151,6,1,5
30,189,1121,8,2,6
30,190,1642,8,1,7
30,190,1627,11,6,5
30,190,2271,15,9,6
30,190,1531,330,185,145
30,190,1322,3,3,0
30,190,1296,6,3,3
30,190,1479,101,53,48
30,190,1092,8,4,4
30,190,673,17,9,8
30,190,571,27,15,12
30,190,622,14,10,4
30,190,1271,9,5,4
30,190,1848,33,17,16
30,190,990,39,12,27
30,190,532,15,7,8
30,190,1002,4,1,3
30,190,1113,3,0,3
30,190,1979,19,9,10
30,190,1171,25,9,16
30,190,1054,28,15,13
30,190,2383,42,18,24
30,190,1345,10,5,5
30,190,1392,8,3,5
30,191,3024,31,14,17
30,191,1584,5,2,3
30,191,2299,3,2,1
30,191,1520,1,1,0
30,191,488,4,1,3
30,191,642,14,8,6
30,191,1294,1,1,0
30,191,218,2,1,1
30,191,329,0,0,0
30,191,552,0,0,0
30,191,331,0,0,0
30,191,455,0,0,0
30,191,1331,0,0,0
30,191,1177,3,1,2
30,191,1376,0,0,0
30,191,942,7,5,2
30,191,1284,0,0,0
30,191,193,0,0,0
30,191,549,5,4,1
30,191,279,8,4,4
30,191,332,1,1,0
30,192,4252,230,119,111
30,192,5727,304,148,156
30,192,1292,59,24,35
30,192,1041,20,9,11
30,192,975,46,18,28
30,192,664,9,5,4
30,192,661,2,1,1
30,192,664,3,2,1
30,192,1349,57,27,30
30,192,1349,21,8,13
30,192,2140,86,43,43
30,192,8918,657,335,322
30,192,8727,274,142,132
30,192,5635,1041,553,488
30,192,807,19,10,9
30,192,822,35,20,15
30,192,859,55,28,27
30,192,701,62,34,28
30,192,1441,8,5,3
30,192,1267,13,5,8
30,192,1276,33,18,15
30,192,1257,42,20,22
30,192,922,27,12,15
30,192,474,50,28,22
30,192,766,55,29,26
30,192,829,30,17,13
30,192,819,12,7,5
30,192,505,4,1,3
30,192,464,5,1,4
30,192,418,31,13,18
30,192,922,10,4,6
30,192,673,20,12,8
30,192,498,11,5,6
30,192,540,46,24,22
30,192,711,8,4,4
30,192,806,21,8,13
30,192,1362,104,57,47
30,192,1017,146,75,71
30,192,394,3,2,1
30,192,484,6,3,3
30,192,897,2,1,1
30,192,830,20,10,10
30,192,6132,241,131,110
30,192,875,41,16,25
30,192,5462,84,46,38
30,192,982,36,22,14
30,192,1319,87,46,41
30,192,701,15,10,5
30,192,1116,30,14,16
30,192,1254,41,18,23
30,192,777,25,10,15
30,192,574,53,32,21
30,192,1035,27,12,15
30,192,590,2,1,1
30,192,186,1,0,1
30,192,124,1,0,1
30,192,423,2,2,0
30,192,791,89,54,35
30,192,893,90,49,41
30,192,951,44,17,27
30,192,896,11,6,5
30,192,1118,30,12,18
30,192,1391,94,53,41
30,192,952,2,1,1
30,192,962,99,51,48
30,192,1139,33,16,17
30,192,1492,35,15,20
30,192,701,2,0,2
30,192,709,14,9,5
30,192,619,13,7,6
30,192,799,15,8,7
30,192,326,0,0,0
30,192,432,5,3,2
30,192,300,7,4,3
30,192,528,21,6,15
30,192,258,5,1,4
30,192,290,25,14,11
30,192,404,9,4,5
30,192,298,6,6,0
30,192,449,5,0,5
30,192,434,1,0,1
30,192,255,2,1,1
30,192,461,9,5,4
30,192,436,0,0,0
30,192,431,6,2,4
30,192,364,5,4,1
30,192,1012,33,18,15
30,192,1113,21,11,10
30,192,1465,32,20,12
30,192,8360,1051,555,496
30,192,2054,82,34,48
30,192,1515,30,14,16
30,192,1383,176,92,84
30,192,1569,21,14,7
30,192,1277,10,5,5
30,192,481,8,6,2
30,192,482,1,1,0
30,192,481,1,1,0
30,192,591,59,26,33
30,192,662,16,7,9
30,192,510,10,5,5
30,192,449,7,3,4
30,192,451,21,12,9
30,192,566,8,5,3
30,192,816,11,7,4
30,192,700,9,7,2
30,192,680,4,2,2
30,192,642,21,8,13
30,192,430,9,5,4
30,192,423,15,6,9
30,192,412,4,2,2
30,192,575,28,12,16
30,192,441,1,1,0
30,192,583,47,29,18
30,192,767,29,16,13
30,192,693,6,4,2
30,192,683,8,3,5
30,192,635,27,13,14
30,192,1764,44,25,19
30,192,1871,27,14,13
30,192,1262,29,15,14
30,192,1823,28,16,12
30,192,1327,69,31,38
30,192,1400,49,27,22
30,192,1181,34,20,14
30,192,1656,41,16,25
30,192,1766,21,9,12
30,192,1449,126,67,59
30,192,1048,17,7,10
30,192,597,115,65,50
30,192,748,70,38,32
30,192,783,24,14,10
30,192,661,12,8,4
30,192,473,9,5,4
30,192,545,13,7,6
30,192,624,13,7,6
30,192,894,26,16,10
30,192,610,21,8,13
30,192,680,47,27,20
30,192,406,9,4,5
30,192,513,11,6,5
30,192,685,1,0,1
30,192,1189,23,9,14
30,192,791,10,7,3
30,192,2784,49,25,24
30,192,1120,8,3,5
30,192,937,33,17,16
30,192,3522,58,27,31
30,192,2398,146,80,66
30,192,1770,15,6,9
30,192,1342,12,5,7
30,192,1320,10,2,8
30,192,1121,38,19,19
30,192,820,59,26,33
30,192,1054,57,33,24
30,192,833,15,10,5
30,192,944,26,14,12
30,192,395,9,5,4
30,192,768,114,53,61
30,192,444,31,18,13
30,192,371,21,12,9
30,192,990,33,15,18
30,192,938,37,17,20
30,192,723,40,16,24
30,192,1623,37,22,15
30,192,19311,1801,934,867
30,192,1201,47,27,20
30,192,1020,59,31,28
30,192,691,13,8,5
30,192,532,8,6,2
30,192,655,15,6,9
30,192,1818,399,212,187
30,192,667,6,5,1
30,192,632,6,4,2
30,192,723,20,10,10
30,192,695,9,6,3
30,192,400,4,4,0
30,192,540,2,0,2
30,192,380,13,4,9
30,192,577,12,6,6
30,192,452,13,8,5
30,192,307,22,14,8
30,192,683,15,7,8
30,192,808,6,3,3
30,192,511,2,1,1
30,192,372,1,1,0
30,192,620,16,11,5
30,192,420,35,21,14
30,192,359,20,13,7
30,192,566,18,7,11
30,192,591,12,6,6
30,192,705,301,173,128
30,192,861,43,20,23
30,192,929,393,199,194
30,192,861,7,4,3
30,192,1207,80,48,32
30,192,764,25,10,15
30,192,978,30,14,16
30,192,808,5,3,2
30,192,638,20,7,13
30,192,1223,13,5,8
30,192,5814,650,357,293
30,192,10097,476,260,216
30,192,686,22,15,7
30,192,802,10,5,5
30,192,661,14,6,8
30,192,896,8,7,1
30,192,722,8,5,3
30,192,571,69,33,36
30,192,720,15,8,7
30,192,489,5,3,2
30,192,547,7,5,2
30,192,612,8,3,5
30,192,559,13,8,5
30,192,572,6,5,1
30,192,740,6,6,0
30,192,605,13,8,5
30,192,687,1,1,0
30,192,683,5,1,4
30,192,434,14,7,7
30,192,555,78,47,31
30,192,920,43,21,22
30,192,1061,46,25,21
30,192,1202,77,47,30
30,192,698,70,38,32
30,192,1256,169,94,75
30,192,1043,29,15,14
30,192,906,20,12,8
30,192,671,4,3,1
30,192,813,5,2,3
30,192,785,10,6,4
30,192,985,43,18,25
30,192,1014,132,67,65
30,192,4583,54,28,26
30,192,1224,10,5,5
30,192,1259,19,9,10
30,192,456,9,3,6
30,192,576,31,19,12
30,192,599,6,2,4
30,192,823,5,1,4
30,192,1041,26,12,14
30,192,1002,33,13,20
30,192,2889,514,249,265
30,192,1648,35,18,17
30,192,980,35,20,15
30,192,798,55,26,29
30,192,636,63,31,32
30,192,1120,117,65,52
30,192,865,23,11,12
30,192,2573,80,38,42
30,192,1434,40,22,18
30,192,1103,29,14,15
30,192,2647,56,30,26
30,192,1470,19,13,6
30,192,1062,12,4,8
30,192,18600,1370,707,663
30,192,20278,569,304,265
30,192,5251,223,121,102
30,192,1692,12,3,9
30,192,843,5,3,2
30,192,865,8,5,3
30,192,1235,23,10,13
30,192,1046,138,70,68
30,192,1537,19,7,12
30,192,677,5,1,4
30,192,1263,2,0,2
30,192,16116,499,234,265
30,192,5784,136,61,75
30,192,2046,29,13,16
30,192,2131,53,28,25
30,192,3224,457,231,226
30,192,6380,145,75,70
30,192,3618,69,29,40
30,192,2882,50,21,29
30,192,1508,91,49,42
30,192,6820,220,111,109
30,192,14530,989,490,499
30,192,24605,1220,640,580
30,192,20822,489,235,254
30,192,1221,6,2,4
30,192,1716,12,6,6
30,193,2189,0,0,0
30,193,2674,77,38,39
30,193,660,0,0,0
30,193,3685,14,5,9
30,193,3105,16,5,11
30,194,2912,267,124,143
30,194,3124,428,218,210
30,194,2333,174,83,91
30,194,3939,140,72,68
30,194,2078,12,6,6
30,194,1384,18,11,7
30,194,1795,65,34,31
30,194,1409,37,15,22
30,194,3734,25,11,14
30,194,1080,5,2,3
30,194,2813,10,5,5
30,194,1380,13,7,6
30,194,1341,6,2,4
30,194,1974,73,33,40
30,194,1310,27,15,12
30,194,1781,4,1,3
30,194,1343,8,4,4
30,194,1653,6,4,2
30,194,2240,62,31,31
30,195,4562,61,29,32
30,195,1826,7,1,6
30,196,977,370,178,192
30,196,853,316,176,140
30,196,1291,652,379,273
30,196,1947,784,423,361
30,196,1332,390,199,191
30,196,1506,174,83,91
30,196,1142,153,82,71
30,196,918,423,223,200
30,196,987,189,98,91
30,196,412,255,130,125
30,196,2018,611,330,281
30,196,1470,427,230,197
30,196,2376,463,242,221
30,196,886,450,234,216
30,197,1683,4,1,3
30,197,1025,1,1,0
30,197,891,19,11,8
30,197,876,0,0,0
30,197,1032,10,4,6
30,197,1781,6,1,5
30,197,1312,2,0,2
30,197,403,5,2,3
30,197,713,15,9,6
30,197,1358,8,3,5
30,198,1821,12,8,4
30,198,1512,4,4,0
30,198,1259,5,1,4
30,198,486,0,0,0
30,198,666,1,0,1
30,198,1028,1,1,0
30,199,4654,27,14,13
30,199,3074,31,17,14
30,199,3578,30,14,16
30,199,1432,3,1,2
30,200,1711,5,3,2
30,200,481,2,1,1
30,200,779,0,0,0
30,200,1167,0,0,0
30,200,2992,3,3,0
30,200,1523,3,2,1
30,200,1650,12,7,5
30,200,791,0,0,0
30,200,1487,14,8,6
30,201,2555,21,11,10
30,201,3062,31,16,15
30,201,1387,4,1,3
30,201,1716,5,2,3
30,201,2260,3,1,2
30,201,765,6,2,4
30,201,1725,248,114,134
30,201,3122,4,1,3
30,201,1395,40,22,18
30,201,767,475,242,233
30,201,1206,2,2,0
30,201,1573,1,1,0
30,201,1157,12,7,5
30,201,1625,3,2,1
30,201,848,419,218,201
30,201,1319,69,36,33
30,201,1721,19,9,10
30,201,882,5,4,1
30,201,2239,558,314,244
30,201,477,9,6,3
30,201,1795,20,10,10
30,201,869,5,1,4
30,201,1274,5,0,5
30,201,2080,4,2,2
30,201,1867,1,0,1
30,201,563,1,0,1
30,201,2776,3,1,2
30,201,1309,8,5,3
30,202,1539,34,16,18
30,202,1592,3,1,2
30,202,1275,7,4,3
30,202,2055,1,1,0
30,202,1521,0,0,0
30,202,2522,3,2,1
30,202,1389,0,0,0
30,202,2852,13,5,8
30,203,1999,28,18,10
30,203,2123,28,14,14
30,203,2317,4,0,4
30,203,2512,10,7,3
30,203,664,0,0,0
30,203,1807,7,5,2
30,203,672,0,0,0
30,203,2426,4,2,2
30,204,1631,5,1,4
30,204,938,8,6,2
30,204,690,20,11,9
30,204,1891,24,11,13
30,204,1026,21,12,9
30,204,3518,126,60,66
30,204,1038,21,8,13
30,204,1923,25,9,16
30,204,1596,31,10,21
30,204,2061,21,11,10
30,204,2737,13,5,8
30,204,1529,12,7,5
30,204,1764,41,25,16
30,204,1125,0,0,0
30,204,1336,0,0,0
30,204,385,1,0,1
30,204,1202,29,19,10
30,204,1121,4,1,3
30,204,837,15,4,11
30,204,1034,15,5,10
30,204,1700,24,15,9
30,204,879,8,4,4
30,204,424,0,0,0
30,204,1060,38,17,21
30,204,1267,4,2,2
30,204,2968,1,0,1
30,204,1404,77,38,39
30,204,1017,30,13,17
30,204,1205,18,9,9
30,204,1167,8,6,2
30,204,921,30,15,15
30,204,240,8,3,5
30,204,1366,14,7,7
30,205,1139,25,11,14
30,205,1874,718,381,337
30,205,1658,34,18,16
30,205,1014,412,212,200
30,205,680,18,11,7
30,205,1191,30,15,15
30,205,1017,14,4,10
30,205,587,0,0,0
30,205,893,42,19,23
30,205,1181,15,7,8
30,205,1152,3,1,2
30,205,602,1,0,1
30,205,1298,11,3,8
30,205,883,0,0,0
30,205,927,7,3,4
30,205,1300,8,6,2
30,205,1288,6,4,2
30,205,3329,85,40,45
30,205,5289,66,29,37
30,205,1752,19,9,10
30,206,1489,14,7,7
30,206,1306,3,3,0
30,206,994,1,0,1
30,206,2554,41,16,25
30,206,1481,3,2,1
30,206,2196,8,4,4
30,206,1174,3,1,2
30,206,973,9,3,6
30,206,899,40,22,18
30,206,1300,27,15,12
30,206,1068,10,5,5
30,206,910,1,0,1
30,206,793,8,4,4
30,206,583,7,3,4
30,206,3548,64,26,38
30,206,614,0,0,0
30,206,759,9,6,3
30,206,1175,9,4,5
30,206,2540,53,29,24
30,206,2306,37,23,14
30,206,1850,12,7,5
30,206,3692,88,42,46
30,206,2138,14,8,6
30,206,1590,1,1,0
30,206,681,7,3,4
30,206,2167,10,6,4
30,206,889,7,4,3
30,206,1305,0,0,0
30,206,1166,3,2,1
30,207,1277,6,2,4
30,207,2270,3,1,2
30,207,1124,4,3,1
30,207,1474,14,5,9
30,207,1731,8,5,3
30,207,1684,18,7,11
30,207,1014,1,0,1
30,207,1473,18,7,11
30,207,316,0,0,0
30,207,629,0,0,0
30,207,473,0,0,0
30,207,1076,1,1,0
30,207,1199,1,0,1
30,207,717,1,1,0
30,207,1077,3,1,2
30,207,1202,2,0,2
30,208,1060,11,4,7
30,208,396,2,1,1
30,209,1339,17,7,10
30,209,1163,3,1,2
30,209,520,1,0,1
30,210,650,9,5,4
30,210,708,1,0,1
30,89,639,5,1,4
30,212,726,0,0,0
30,212,881,1,0,1
30,212,348,0,0,0
30,41,746,3,2,1
30,41,1058,16,9,7
30,41,2674,103,56,47
30,41,1196,21,12,9
30,41,10085,298,149,149
30,41,1461,5,1,4
30,41,1109,15,10,5
30,41,506,11,6,5
30,41,2507,10,5,5
30,41,6001,191,98,93
30,41,1739,6,1,5
30,41,1040,21,12,9
30,41,518,19,10,9
30,41,691,12,8,4
30,41,1011,20,8,12
30,41,844,19,10,9
30,41,1472,40,18,22
30,41,1931,12,6,6
30,41,1389,41,20,21
30,41,1015,22,10,12
30,41,963,10,8,2
30,41,1351,23,14,9
30,192,1287,42,18,24
30,192,1480,76,32,44
30,192,1380,18,10,8
30,192,1472,7,3,4
30,192,1279,10,7,3
30,192,1531,6,2,4
30,192,1692,47,26,21
30,192,1432,30,17,13
30,192,1391,12,9,3
30,192,1210,13,9,4
30,192,1204,15,5,10
30,192,1114,5,2,3
30,158,288,3,1,2
30,158,858,11,5,6
30,158,1128,9,4,5
30,158,877,14,6,8
30,158,804,14,5,9
30,158,444,16,8,8
30,158,390,18,9,9
30,158,430,11,4,7
30,192,934,154,76,78
30,192,936,77,40,37
30,192,1134,31,18,13
30,192,711,39,13,26
30,192,746,66,35,31
30,192,1006,56,32,24
30,192,832,33,21,12
30,192,1173,21,15,6
30,192,1322,51,28,23
30,192,902,46,20,26
30,192,952,44,27,17
30,192,1055,48,25,23
30,192,1287,30,16,14
30,192,1106,19,9,10
30,192,801,22,13,9
30,192,1109,49,22,27
30,192,1203,8,6,2
30,192,1064,98,45,53
30,192,985,119,64,55
30,192,1081,25,8,17
30,192,501,9,5,4
30,192,750,32,21,11
30,192,1244,54,32,22
30,192,1147,10,4,6
30,192,1557,19,11,8
30,192,1088,14,5,9
30,192,1179,74,34,40
30,192,1783,124,60,64
30,192,1209,29,18,11
30,192,1015,35,19,16
30,192,1286,52,27,25
30,192,1474,19,11,8
30,192,890,1,1,0
30,192,1409,25,12,13
30,192,1598,37,14,23
30,192,1202,19,7,12
30,192,1207,44,24,20
30,192,1226,4,1,3
30,192,1649,17,9,8
30,192,6703,163,95,68
30,192,1334,43,25,18
30,192,1364,117,56,61
30,192,944,25,12,13
30,192,847,3,0,3
30,192,2032,26,13,13
30,192,1974,46,24,22
30,192,1572,41,20,21
30,192,1442,209,114,95
30,192,1299,41,20,21
30,192,2446,46,29,17
30,192,1889,19,11,8
30,192,1631,37,19,18
30,192,1383,54,23,31
30,192,1795,6,5,1
30,192,8091,170,88,82
30,192,3467,55,27,28
30,192,2803,89,46,43
30,192,2436,40,19,21
30,192,2151,66,26,40
30,192,1694,44,27,17
30,192,1989,54,23,31
30,192,2143,8,3,5
30,192,2313,73,36,37
30,192,5019,207,94,113
30,192,2159,74,38,36
30,192,2041,155,79,76
30,192,1987,59,25,34
30,192,2483,63,34,29
30,192,2019,60,26,34
30,192,2079,71,35,36
30,41,1446,31,14,17
30,41,1470,40,19,21
30,41,2687,22,13,9
30,41,6029,149,75,74
30,41,2271,54,24,30
30,41,3488,150,77,73
30,41,3279,246,126,120
30,41,3402,43,26,17
30,41,3357,26,11,15
30,41,4131,159,76,83
30,106,2072,7,4,3
30,106,4277,136,68,68
30,106,3335,245,119,126
30,106,4875,281,150,131
30,106,4405,175,94,81
30,106,5845,115,55,60
30,106,7345,114,58,56
30,106,4026,96,43,53
30,106,4837,116,53,63
30,106,4206,86,37,49
30,106,921,12,4,8
30,106,1648,14,9,5
30,125,1810,4,0,4
30,125,1790,7,2,5
30,125,667,1,1,0
30,88,2688,3,1,2
30,88,3001,17,14,3
30,110,2923,10,3,7
30,110,2462,14,8,6
30,182,1247,2,1,1
30,182,3257,485,281,204
30,182,2182,11,7,4
30,182,2297,16,8,8
30,41,2984,102,53,49
30,41,1621,124,64,60
30,41,829,51,27,24
30,41,2903,34,16,18
30,41,1541,30,16,14
30,41,1635,36,21,15
30,41,1795,11,7,4
30,41,2037,4,2,2
30,41,2140,19,9,10
30,41,3106,88,38,50
30,41,2300,73,37,36
30,41,1399,5,3,2
30,41,3273,32,16,16
30,41,3774,40,18,22
30,41,2390,21,8,13
30,41,2793,5,3,2
30,41,1407,2,2,0
30,41,3294,21,11,10
30,41,1367,3,2,1
30,41,1672,8,3,5
30,41,1738,90,49,41
30,41,1456,20,13,7
30,41,2017,16,7,9
30,41,1987,47,26,21
30,41,2073,16,9,7
30,41,3904,107,53,54
30,41,1769,18,8,10
30,41,3029,125,68,57
30,109,582,15,9,6
30,109,711,17,7,10
30,109,0,0,0,0
30,109,3299,41,18,23
30,109,352,0,0,0
30,109,453,4,2,2
30,109,1708,30,16,14
30,109,3618,14,6,8
30,34,2148,14,10,4
30,34,2404,11,5,6
30,142,2080,8,5,3
30,142,1758,18,8,10
30,50,2510,33,15,18
30,50,6244,140,60,80
31,1,2041,47,22,25
31,1,220,0,0,0
31,1,241,0,0,0
31,1,950,312,160,152
31,1,2608,17,10,7
31,1,490,1,0,1
31,2,3048,42,16,26
31,2,2792,12,5,7
31,2,4056,11,7,4
31,2,3179,20,10,10
31,2,984,1,1,0
31,2,1856,7,1,6
31,2,857,24,15,9
31,3,2144,59,27,32
31,3,2641,3,1,2
31,3,2339,17,11,6
31,3,3073,8,4,4
31,3,2088,38,17,21
31,4,1901,21,10,11
31,4,1413,42,22,20
31,4,1038,11,5,6
31,4,887,5,1,4
31,4,940,11,3,8
31,5,1022,324,157,167
31,5,1145,151,75,76
31,6,2255,19,9,10
31,6,2610,7,4,3
31,6,1847,14,5,9
31,6,1281,1,0,1
31,6,496,6,2,4
31,6,674,0,0,0
31,7,1276,37,21,16
31,7,2336,16,7,9
31,7,1726,49,22,27
31,7,2146,50,26,24
31,8,1383,30,15,15
31,8,1220,17,4,13
31,8,447,0,0,0
31,8,1001,29,13,16
31,9,1043,2,1,1
31,9,947,2,1,1
31,9,943,20,11,9
31,9,1136,6,2,4
31,9,173,0,0,0
31,9,213,0,0,0
31,10,1924,13,5,8
31,10,471,108,56,52
31,10,361,0,0,0
31,11,1795,22,10,12
31,11,3969,99,46,53
31,11,928,16,8,8
31,11,1697,18,8,10
31,12,529,0,0,0
31,12,1125,1,0,1
31,12,947,3,2,1
31,12,744,4,1,3
31,12,387,2,1,1
31,13,2150,72,37,35
31,13,1527,23,7,16
31,13,3120,27,15,12
31,13,6132,114,44,70
31,13,219,0,0,0
31,13,3801,78,35,43
31,14,1443,241,114,127
31,14,212,0,0,0
31,15,1718,8,5,3
31,15,2950,80,33,47
31,15,892,9,5,4
31,16,3114,15,4,11
31,17,1804,25,10,15
31,17,1353,117,59,58
31,17,804,2,2,0
31,17,761,3,2,1
31,18,670,0,0,0
31,18,1708,66,34,32
31,18,1007,5,3,2
31,19,5186,907,439,468
31,19,3405,768,369,399
31,19,3101,227,109,118
31,19,5075,215,117,98
31,19,2617,3,2,1
31,19,3132,69,30,39
31,19,2432,26,16,10
31,19,1329,4,2,2
31,19,4320,26,14,12
31,19,1008,0,0,0
31,19,3046,15,8,7
31,19,3424,40,19,21
31,19,1506,52,27,25
31,20,2627,256,117,139
31,20,1869,41,22,19
31,21,2235,24,9,15
31,21,2411,144,63,81
31,21,1900,4,2,2
31,21,1165,0,0,0
31,21,690,204,102,102
31,21,1003,517,239,278
31,22,3036,6,2,4
31,22,637,1,1,0
31,22,878,5,2,3
31,23,1578,13,6,7
31,23,1324,18,6,12
31,23,1960,29,11,18
31,24,1423,3,3,0
31,24,1819,11,7,4
31,25,3074,52,24,28
31,25,2931,238,116,122
31,26,1149,190,92,98
31,26,1120,108,54,54
31,26,1286,191,100,91
31,26,57,0,0,0
31,27,1327,38,18,20
31,27,1873,36,16,20
31,27,1641,13,4,9
31,27,2227,5,3,2
31,27,1277,24,10,14
31,28,1344,24,11,13
31,28,1594,39,16,23
31,29,1305,4,2,2
31,29,1518,19,9,10
31,29,1193,4,1,3
31,29,1272,8,4,4
31,29,943,3,2,1
31,30,899,0,0,0
31,30,957,11,7,4
31,30,1352,36,20,16
31,30,790,1,0,1
31,31,1058,24,10,14
31,31,1296,60,32,28
31,31,459,413,198,215
31,32,2769,377,178,199
31,32,2421,323,150,173
31,32,2066,375,186,189
31,32,2512,8,4,4
31,32,3007,124,66,58
31,32,729,4,1,3
31,32,649,33,13,20
31,32,2618,28,15,13
31,33,2337,16,8,8
31,33,1444,6,4,2
31,33,1916,3,0,3
31,33,2920,1,1,0
31,33,1324,13,5,8
31,33,312,1,1,0
31,33,2362,10,5,5
31,33,4479,38,18,20
31,33,1736,14,7,7
31,33,2425,1,0,1
31,34,732,317,148,169
31,34,1365,71,35,36
31,34,1120,273,128,145
31,34,1188,114,52,62
31,34,2110,33,15,18
31,35,972,9,6,3
31,35,850,3,2,1
31,35,1943,554,285,269
31,35,1400,10,5,5
31,35,1217,1,1,0
31,36,1018,37,20,17
31,36,2014,89,42,47
31,36,1739,115,59,56
31,36,2104,43,26,17
31,36,94,0,0,0
31,36,1104,9,5,4
31,37,2027,88,41,47
31,37,1336,305,162,143
31,37,1838,91,47,44
31,37,55,40,21,19
31,38,4687,38,22,16
31,38,2115,8,4,4
31,38,1609,60,25,35
31,38,1800,31,11,20
31,38,1273,89,40,49
31,38,3521,90,46,44
31,38,3932,123,58,65
31,38,1735,17,9,8
31,38,2123,61,32,29
31,38,2521,25,13,12
31,38,3110,74,37,37
31,38,1223,50,21,29
31,38,856,28,11,17
31,38,202,5,2,3
31,38,4431,14,7,7
31,39,2192,41,19,22
31,39,2003,1,0,1
31,40,2815,30,15,15
31,40,805,3,1,2
31,40,2473,41,24,17
31,40,1452,10,9,1
31,40,2081,45,22,23
31,40,2099,116,57,59
31,40,2191,30,16,14
31,40,1577,6,2,4
31,40,2378,36,19,17
31,40,2342,12,7,5
31,40,1939,3,1,2
31,40,1825,7,1,6
31,40,2316,0,0,0
31,40,723,4,3,1
31,40,1539,4,3,1
31,41,948,1,0,1
31,41,4756,21,11,10
31,41,6496,78,36,42
31,41,20220,514,261,253
31,41,3003,200,98,102
31,41,1314,7,6,1
31,41,2744,49,24,25
31,41,4708,88,36,52
31,41,5754,135,68,67
31,41,6925,1109,563,546
31,41,1791,12,6,6
31,41,6710,69,31,38
31,41,1025,3,2,1
31,41,13983,1067,514,553
31,41,8809,85,40,45
31,41,7813,30,15,15
31,41,33759,1031,520,511
31,41,776,2,2,0
31,41,761,13,6,7
31,41,9657,345,171,174
31,42,1927,68,30,38
31,42,1598,7,2,5
31,42,2028,7,5,2
31,43,3390,15,6,9
31,44,589,2,1,1
31,44,2902,144,70,74
31,44,3706,231,110,121
31,44,333,25,10,15
31,45,2211,4,2,2
31,45,466,0,0,0
31,46,1384,68,35,33
31,46,1846,37,23,14
31,47,2028,28,17,11
31,47,2700,36,21,15
31,47,1047,10,6,4
31,48,3038,118,55,63
31,48,2009,263,127,136
31,48,1530,73,40,33
31,48,2441,77,40,37
31,48,2577,24,12,12
31,48,2836,63,30,33
31,48,2288,5,2,3
31,48,1688,175,84,91
31,48,1767,1,1,0
31,48,483,59,24,35
31,48,1325,3,3,0
31,48,1884,39,17,22
31,48,125,33,14,19
31,49,1606,62,31,31
31,49,2356,573,273,300
31,50,17022,593,315,278
31,50,2318,15,7,8
31,50,5066,43,22,21
31,50,996,10,3,7
31,50,1096,10,6,4
31,50,1260,37,18,19
31,50,3430,24,12,12
31,50,6083,130,59,71
31,50,1419,50,23,27
31,50,5095,78,38,40
31,50,1233,13,6,7
31,50,12768,233,134,99
31,50,8094,210,108,102
31,50,3285,36,19,17
31,50,1532,34,12,22
31,50,2159,28,15,13
31,50,1782,27,13,14
31,50,1197,19,6,13
31,50,926,29,18,11
31,50,1655,20,8,12
31,50,3439,136,84,52
31,50,3572,125,65,60
31,50,4512,162,78,84
31,50,8971,107,56,51
31,50,1234,18,9,9
31,50,1225,5,3,2
31,50,1100,10,3,7
31,50,1559,44,17,27
31,50,1131,8,4,4
31,50,826,8,4,4
31,50,1350,16,9,7
31,50,1365,16,8,8
31,50,1791,11,8,3
31,50,4556,172,85,87
31,50,4798,80,43,37
31,50,1402,26,14,12
31,50,2598,105,60,45
31,50,2140,69,38,31
31,50,1143,42,23,19
31,50,1221,55,24,31
31,50,1824,22,11,11
31,50,887,15,11,4
31,50,1047,37,22,15
31,50,2373,55,29,26
31,50,1880,32,13,19
31,50,970,15,4,11
31,50,1147,21,8,13
31,50,3298,65,33,32
31,50,9845,453,250,203
31,50,1146,71,36,35
31,50,1348,32,15,17
31,50,596,7,3,4
31,50,935,24,11,13
31,50,10358,302,162,140
31,50,1115,16,7,9
31,50,1469,113,62,51
31,50,3760,40,19,21
31,50,907,3,1,2
31,50,1184,15,6,9
31,50,1087,23,12,11
31,50,1048,10,5,5
31,50,1208,19,9,10
31,50,816,6,5,1
31,50,436,3,2,1
31,50,980,51,29,22
31,50,847,22,10,12
31,50,1355,39,22,17
31,50,1921,63,31,32
31,50,1206,46,27,19
31,50,1380,9,5,4
31,50,3402,57,28,29
31,50,1174,27,16,11
31,50,1537,46,24,22
31,50,963,30,15,15
31,50,991,12,3,9
31,50,661,22,11,11
31,50,938,4,2,2
31,50,944,25,14,11
31,50,837,17,13,4
31,50,582,15,7,8
31,50,740,13,3,10
31,50,863,15,8,7
31,50,687,17,9,8
31,50,918,46,29,17
31,50,629,12,5,7
31,50,782,10,9,1
31,50,882,0,0,0
31,50,832,0,0,0
31,50,1039,46,23,23
31,50,1118,11,4,7
31,50,906,10,6,4
31,50,1197,14,10,4
31,50,1002,12,4,8
31,50,800,81,43,38
31,50,840,12,8,4
31,50,751,8,5,3
31,50,940,29,14,15
31,50,800,15,8,7
31,50,490,7,4,3
31,50,774,23,12,11
31,50,1123,10,2,8
31,50,1128,7,3,4
31,50,757,21,10,11
31,50,1229,32,20,12
31,50,1533,18,7,11
31,50,975,23,12,11
31,50,1283,15,10,5
31,50,1246,27,18,9
31,50,1219,27,14,13
31,50,375,4,3,1
31,50,592,41,20,21
31,50,777,10,6,4
31,50,949,20,16,4
31,50,797,22,10,12
31,50,842,26,14,12
31,50,867,37,19,18
31,50,863,21,10,11
31,50,805,5,2,3
31,50,1761,108,56,52
31,50,1024,5,4,1
31,50,1501,10,3,7
31,50,1399,21,12,9
31,50,1241,57,32,25
31,50,1276,10,3,7
31,50,1032,77,35,42
31,50,631,168,92,76
31,50,799,22,8,14
31,50,14475,461,234,227
31,50,1415,40,16,24
31,50,803,4,3,1
31,50,751,8,5,3
31,50,1046,8,3,5
31,50,1770,50,28,22
31,50,1912,143,70,73
31,50,883,53,31,22
31,50,771,13,7,6
31,50,1022,15,7,8
31,50,768,47,22,25
31,50,715,10,5,5
31,50,410,7,4,3
31,50,466,6,2,4
31,50,386,6,2,4
31,50,759,23,9,14
31,50,683,40,20,20
31,50,934,18,7,11
31,50,1110,23,15,8
31,50,1800,120,65,55
31,50,1768,88,44,44
31,50,2470,36,18,18
31,50,2081,39,18,21
31,50,1279,74,37,37
31,50,1216,35,21,14
31,50,930,8,4,4
31,50,1027,45,18,27
31,50,868,16,8,8
31,50,640,29,13,16
31,50,1060,10,7,3
31,50,894,14,9,5
31,50,1261,10,4,6
31,50,1144,6,3,3
31,50,1116,19,11,8
31,50,1172,16,10,6
31,50,795,1,0,1
31,50,1233,11,5,6
31,50,1104,4,1,3
31,50,1259,13,7,6
31,50,981,10,6,4
31,50,932,23,10,13
31,50,781,22,14,8
31,50,435,1,1,0
31,50,435,4,4,0
31,50,591,12,7,5
31,50,236,5,4,1
31,50,599,13,6,7
31,50,869,23,9,14
31,50,589,12,8,4
31,50,756,2,2,0
31,50,953,20,13,7
31,50,959,1,0,1
31,50,1350,16,10,6
31,50,1157,13,8,5
31,50,1815,15,8,7
31,50,925,20,13,7
31,50,1156,1,1,0
31,50,1526,18,8,10
31,50,1740,12,7,5
31,50,1788,30,13,17
31,50,1105,20,10,10
31,50,1091,15,7,8
31,50,838,18,10,8
31,50,1199,2,2,0
31,50,1352,6,2,4
31,50,1287,12,6,6
31,50,1327,10,5,5
31,50,1281,2,0,2
31,50,1206,6,3,3
31,50,1513,33,18,15
31,50,1300,30,15,15
31,50,945,38,21,17
31,50,1153,0,0,0
31,50,1338,77,43,34
31,50,789,130,72,58
31,50,550,10,6,4
31,50,633,15,3,12
31,50,173,0,0,0
31,50,245,11,6,5
31,50,552,13,8,5
31,50,411,11,3,8
31,50,543,26,13,13
31,50,294,4,2,2
31,50,1060,7,3,4
31,50,984,18,8,10
31,50,1110,43,22,21
31,50,1402,28,14,14
31,50,972,36,17,19
31,50,997,15,11,4
31,50,4630,108,53,55
31,50,2193,13,8,5
31,50,16031,551,270,281
31,50,1867,28,18,10
31,50,29438,2555,1316,1239
31,50,4118,169,91,78
31,50,1338,43,24,19
31,50,1017,57,19,38
31,50,1035,12,5,7
31,50,568,2,2,0
31,50,810,52,27,25
31,50,1092,40,15,25
31,50,1014,43,26,17
31,50,813,9,6,3
31,50,1357,4,3,1
31,50,1143,19,6,13
31,50,2431,7,3,4
31,50,1069,26,13,13
31,50,1601,24,9,15
31,50,1993,25,8,17
31,50,1837,18,12,6
31,50,1782,6,3,3
31,50,3637,11,4,7
31,50,1371,6,3,3
31,50,1516,29,14,15
31,50,778,66,35,31
31,50,1081,3,2,1
31,50,1057,5,3,2
31,50,2261,67,30,37
31,50,482,12,6,6
31,50,673,18,7,11
31,50,729,37,20,17
31,50,1245,11,6,5
31,50,1071,1,0,1
31,50,1011,39,21,18
31,50,879,27,10,17
31,50,4186,83,38,45
31,50,921,4,1,3
31,50,13916,165,93,72
31,50,1036,4,0,4
31,50,1855,41,18,23
31,50,1579,59,30,29
31,50,1175,0,0,0
31,50,2061,81,41,40
31,50,1107,14,7,7
31,50,1703,9,3,6
31,50,935,14,7,7
31,50,1617,27,16,11
31,50,1221,25,10,15
31,50,398,15,6,9
31,50,814,57,29,28
31,50,1309,36,20,16
31,50,805,12,6,6
31,50,942,11,5,6
31,50,1637,19,8,11
31,50,1747,3,1,2
31,50,1859,39,15,24
31,50,1428,12,4,8
31,50,2197,12,8,4
31,50,1081,1,1,0
31,50,2569,28,15,13
31,50,1336,16,6,10
31,50,1327,53,34,19
31,50,1243,13,7,6
31,50,1205,25,10,15
31,50,1585,6,1,5
31,50,1431,55,26,29
31,50,1105,5,3,2
31,50,1026,1,1,0
31,50,1065,11,2,9
31,50,1038,51,29,22
31,50,931,23,12,11
31,50,1095,31,20,11
31,50,1104,20,10,10
31,50,1442,9,4,5
31,50,1098,33,22,11
31,50,1048,16,7,9
31,50,1646,17,9,8
31,50,906,16,10,6
31,50,1326,35,18,17
31,50,1199,12,5,7
31,50,1448,87,42,45
31,50,1281,22,9,13
31,50,1169,22,11,11
31,50,1260,23,12,11
31,50,1488,14,6,8
31,50,1112,11,4,7
31,50,1249,25,13,12
31,50,1134,13,6,7
31,50,1146,20,11,9
31,50,1116,8,4,4
31,50,1213,20,9,11
31,50,1494,28,15,13
31,50,1135,8,1,7
31,50,1396,13,3,10
31,50,1425,42,22,20
31,50,1048,56,26,30
31,50,1405,49,25,24
31,50,4054,91,46,45
31,50,1049,47,24,23
31,50,911,55,28,27
31,50,960,76,43,33
31,50,1417,7,4,3
31,50,1490,4,2,2
31,50,1372,12,6,6
31,50,1571,32,16,16
31,50,10421,243,116,127
31,50,1063,60,27,33
31,50,2816,122,73,49
31,50,5604,169,78,91
31,50,794,57,27,30
31,50,689,41,24,17
31,50,327,5,1,4
31,50,190,13,7,6
31,50,541,9,5,4
31,50,781,13,7,6
31,50,1040,22,14,8
31,50,1255,25,7,18
31,50,1246,45,20,25
31,50,570,17,12,5
31,50,524,1,0,1
31,50,673,5,2,3
31,50,1533,4,3,1
31,50,534,9,6,3
31,50,1081,45,17,28
31,50,912,98,42,56
31,50,1291,25,12,13
31,50,1158,24,13,11
31,50,2923,209,105,104
31,50,1096,45,23,22
31,50,605,8,5,3
31,50,1802,1,0,1
31,50,1628,100,51,49
31,50,1546,19,11,8
31,50,1746,29,18,11
31,50,1449,22,13,9
31,50,3226,56,37,19
31,50,1581,2,1,1
31,50,1408,12,8,4
31,50,9108,227,117,110
31,50,2170,41,21,20
31,50,1536,20,10,10
31,50,1570,22,14,8
31,50,1380,17,7,10
31,50,1348,19,9,10
31,50,746,20,14,6
31,50,1444,35,17,18
31,50,1410,56,29,27
31,50,2670,25,14,11
31,50,2012,207,104,103
31,50,1266,34,17,17
31,50,1829,46,21,25
31,50,1896,7,6,1
31,50,26206,1000,498,502
31,50,6303,291,136,155
31,50,3361,73,36,37
31,50,10914,393,199,194
31,50,501,0,0,0
31,50,1060,10,2,8
31,50,2814,49,22,27
31,50,1716,61,32,29
31,50,2109,8,2,6
31,50,2874,13,7,6
31,50,2590,27,14,13
31,50,3115,67,36,31
31,50,5103,111,56,55
31,50,20854,684,326,358
31,50,20208,648,324,324
31,50,6313,119,69,50
31,50,6348,76,33,43
31,50,14132,203,84,119
31,50,17762,614,309,305
31,50,5887,195,110,85
31,50,4592,144,65,79
31,50,774,8,6,2
31,50,3798,133,66,67
31,50,14076,355,187,168
31,50,15804,221,107,114
31,50,865,6,2,4
31,50,3336,29,13,16
31,50,5121,227,116,111
31,50,2411,5,3,2
31,50,1451,3,0,3
31,50,950,1,1,0
31,51,904,18,7,11
31,51,1451,130,69,61
31,51,455,4,1,3
31,51,639,4,2,2
31,52,5053,57,29,28
31,52,4102,43,15,28
31,52,1698,17,12,5
31,52,972,23,14,9
31,52,2379,195,96,99
31,52,1199,4,2,2
31,52,2187,26,10,16
31,52,4341,16,8,8
31,52,2509,7,4,3
31,52,1981,9,3,6
31,52,1019,10,7,3
31,52,671,6,2,4
31,52,219,16,7,9
31,52,1743,10,6,4
31,52,301,1,0,1
31,52,2142,9,5,4
31,52,3207,44,20,24
31,52,922,2,1,1
31,52,1166,5,1,4
31,53,1807,30,15,15
31,53,3686,55,35,20
31,53,2962,79,39,40
31,53,1838,50,21,29
31,53,2281,43,18,25
31,53,316,0,0,0
31,53,845,1,0,1
31,54,954,6,2,4
31,54,1643,229,120,109
31,54,398,19,7,12
31,55,2552,244,119,125
31,55,2862,442,220,222
31,55,1666,65,34,31
31,56,2446,12,5,7
31,56,2764,5,3,2
31,56,2049,16,7,9
31,56,3451,10,6,4
31,56,1734,162,83,79
31,56,2704,8,5,3
31,56,2071,7,6,1
31,56,3071,19,9,10
31,56,1147,2,1,1
31,56,2942,544,280,264
31,56,2118,35,17,18
31,56,2152,12,5,7
31,56,1639,1,0,1
31,56,1489,8,5,3
31,56,1992,12,6,6
31,56,298,1,0,1
31,57,956,38,18,20
31,57,1642,52,26,26
31,57,1609,132,68,64
31,57,1393,41,22,19
31,57,572,92,47,45
31,57,1596,78,37,41
31,58,3485,31,15,16
31,58,3403,85,41,44
31,58,1880,6,5,1
31,58,2053,10,6,4
31,58,1719,12,8,4
31,58,2204,1,0,1
31,58,1075,2,1,1
31,58,1017,8,5,3
31,58,2857,37,18,19
31,58,2159,51,24,27
31,58,442,4,2,2
31,58,239,21,8,13
31,58,283,0,0,0
31,58,719,3,1,2
31,58,551,14,6,8
31,58,1175,21,11,10
31,58,693,0,0,0
31,59,2045,14,9,5
31,59,952,6,2,4
31,59,954,4,1,3
31,59,2689,4,1,3
31,59,1184,11,4,7
31,59,3021,46,24,22
31,59,3597,92,40,52
31,59,3225,90,39,51
31,59,1741,38,21,17
31,59,712,17,8,9
31,59,715,5,2,3
31,59,1021,11,4,7
31,59,1817,27,12,15
31,59,1629,18,11,7
31,59,3453,53,33,20
31,59,2882,50,21,29
31,59,2246,13,6,7
31,59,545,6,3,3
31,59,5365,114,55,59
31,59,3761,77,41,36
31,59,2396,84,43,41
31,59,1358,59,25,34
31,59,2477,16,10,6
31,59,2811,41,23,18
31,59,587,1,1,0
31,59,4428,130,63,67
31,59,2530,31,13,18
31,59,1189,13,8,5
31,59,2756,25,14,11
31,59,1914,54,28,26
31,60,976,15,8,7
31,61,979,163,87,76
31,61,1577,16,8,8
31,61,1399,34,15,19
31,62,1948,523,252,271
31,62,2144,112,53,59
31,62,626,154,66,88
31,63,3370,115,56,59
31,63,977,1,0,1
31,63,1284,14,9,5
31,64,1702,94,52,42
31,65,1017,1,0,1
31,65,1113,26,9,17
31,66,1660,6,4,2
31,66,2139,7,1,6
31,66,423,1,1,0
31,67,2579,67,27,40
31,67,1169,7,3,4
31,67,3164,41,22,19
31,67,2259,42,21,21
31,67,882,20,14,6
31,68,1304,24,9,15
31,68,1287,67,34,33
31,68,610,40,14,26
31,69,1733,7,3,4
31,69,1046,5,4,1
31,69,1291,6,5,1
31,69,1716,33,18,15
31,69,1839,7,5,2
31,69,794,2,1,1
31,69,559,5,2,3
31,70,1775,10,6,4
31,70,2207,13,6,7
31,71,1458,339,155,184
31,71,499,0,0,0
31,72,987,168,82,86
31,72,871,54,24,30
31,73,5844,50,20,30
31,74,1719,24,7,17
31,74,2055,46,24,22
31,75,2801,420,236,184
31,75,4120,15,6,9
31,76,3989,305,158,147
31,76,1729,54,31,23
31,76,2347,21,12,9
31,76,2337,15,9,6
31,76,803,9,5,4
31,76,1384,14,8,6
31,76,556,0,0,0
31,76,2600,91,43,48
31,76,1789,353,161,192
31,76,406,0,0,0
31,77,1790,80,43,37
31,77,893,18,11,7
31,78,937,150,72,78
31,78,592,64,29,35
31,78,352,0,0,0
31,78,1308,0,0,0
31,78,359,216,109,107
31,78,199,196,87,109
31,79,4113,81,45,36
31,79,3167,28,14,14
31,79,2801,7,2,5
31,79,3883,10,2,8
31,79,2158,8,6,2
31,79,2182,17,3,14
31,79,1184,0,0,0
31,79,1593,17,10,7
31,79,990,4,2,2
31,79,2556,9,6,3
31,79,3614,86,47,39
31,79,1264,4,1,3
31,79,2177,4,1,3
31,79,2026,4,2,2
31,79,4702,25,12,13
31,79,596,15,8,7
31,79,2091,2,1,1
31,79,1438,2,1,1
31,79,2282,5,3,2
31,79,223,3,3,0
31,80,3851,91,42,49
31,80,2327,43,19,24
31,80,3001,8,4,4
31,80,1912,212,109,103
31,81,1481,64,28,36
31,81,1306,4,3,1
31,81,217,0,0,0
31,81,246,0,0,0
31,82,1148,53,29,24
31,82,688,89,42,47
31,82,830,429,218,211
31,82,840,262,140,122
31,83,864,17,6,11
31,83,1066,24,10,14
31,84,2466,65,33,32
31,84,1199,9,7,2
31,84,1450,10,7,3
31,84,1420,67,28,39
31,84,251,0,0,0
31,84,257,0,0,0
31,85,2692,18,10,8
31,85,2101,114,58,56
31,85,3058,37,19,18
31,85,2345,3,1,2
31,85,498,0,0,0
31,85,347,0,0,0
31,85,1324,185,82,103
31,85,4205,76,30,46
31,86,573,16,9,7
31,86,1381,8,4,4
31,86,179,0,0,0
31,87,2981,18,5,13
31,87,2482,14,8,6
31,88,698,284,149,135
31,88,1219,151,82,69
31,89,4678,38,20,18
31,89,1798,5,2,3
31,89,2152,21,7,14
31,89,1867,7,3,4
31,89,2296,18,11,7
31,89,3189,13,6,7
31,89,1628,1,1,0
31,89,1485,3,2,1
31,89,2161,6,3,3
31,89,2344,156,79,77
31,89,2418,25,12,13
31,89,2350,76,40,36
31,89,2556,56,20,36
31,89,3045,25,11,14
31,89,3951,22,8,14
31,89,2578,7,4,3
31,90,2451,36,21,15
31,90,3008,20,11,9
31,90,2024,29,10,19
31,91,1205,7,5,2
31,91,727,3,1,2
31,91,3688,40,21,19
31,91,2947,24,8,16
31,91,1793,4,3,1
31,91,709,3,1,2
31,91,1650,3,2,1
31,92,2308,12,6,6
31,92,1874,2,0,2
31,92,923,6,3,3
31,92,2784,0,0,0
31,93,2875,42,25,17
31,93,2659,15,9,6
31,93,1130,3,1,2
31,93,1568,9,6,3
31,93,2438,26,15,11
31,93,1890,10,5,5
31,93,1669,2,0,2
31,93,1197,1,1,0
31,93,2652,0,0,0
31,93,343,0,0,0
31,94,1442,2,0,2
31,94,1346,4,2,2
31,94,739,1,0,1
31,94,1917,5,2,3
31,95,1088,0,0,0
31,95,453,1,1,0
31,95,2625,18,8,10
31,95,591,3,2,1
31,95,386,1,1,0
31,95,546,2,1,1
31,96,1860,12,7,5
31,96,1670,33,18,15
31,96,1199,32,16,16
31,96,3819,66,28,38
31,96,2103,134,64,70
31,96,2439,138,75,63
31,96,2233,213,111,102
31,96,2153,33,13,20
31,96,1876,457,210,247
31,96,1912,36,17,19
31,96,1369,28,13,15
31,96,753,5,3,2
31,96,571,6,3,3
31,96,1501,349,190,159
31,96,3935,114,58,56
31,96,3873,94,51,43
31,96,1564,46,22,24
31,96,1801,49,29,20
31,96,1292,88,45,43
31,96,768,13,8,5
31,96,2180,81,42,39
31,96,3024,87,43,44
31,96,2205,80,37,43
31,96,2262,167,91,76
31,96,3333,156,80,76
31,96,1393,47,25,22
31,96,1820,3,0,3
31,96,2489,16,6,10
31,96,1393,48,23,25
31,96,1644,66,32,34
31,96,276,6,2,4
31,96,335,0,0,0
31,96,1541,664,301,363
31,96,854,22,13,9
31,96,2319,110,54,56
31,96,557,5,1,4
31,96,1909,4,1,3
31,96,1735,12,3,9
31,96,3334,20,8,12
31,96,2794,5,2,3
31,96,4354,19,9,10
31,97,1084,0,0,0
31,97,1140,99,42,57
31,97,1277,14,4,10
31,97,175,0,0,0
31,98,2790,132,70,62
31,98,3143,10,7,3
31,98,2838,21,8,13
31,98,3009,45,22,23
31,98,708,0,0,0
31,98,1158,5,2,3
31,98,911,32,17,15
31,98,789,15,5,10
31,99,1661,33,13,20
31,99,1874,16,8,8
31,99,654,0,0,0
31,100,3284,95,45,50
31,100,765,92,46,46
31,101,5414,54,22,32
31,101,6460,164,84,80
31,101,1151,38,16,22
31,101,1451,15,10,5
31,101,1676,8,1,7
31,101,3684,36,19,17
31,101,2023,9,6,3
31,101,5633,40,24,16
31,101,4039,26,16,10
31,101,2268,64,28,36
31,101,6224,28,13,15
31,101,1414,66,32,34
31,101,3365,44,22,22
31,101,1647,8,3,5
31,101,13946,253,119,134
31,101,2571,30,12,18
31,101,3394,36,14,22
31,101,475,0,0,0
31,101,983,5,3,2
31,101,1318,4,2,2
31,102,3835,177,93,84
31,102,4735,150,88,62
31,102,2546,18,10,8
31,102,1372,7,2,5
31,102,2102,0,0,0
31,102,5926,80,44,36
31,102,7715,158,72,86
31,102,1600,18,10,8
31,102,3214,19,10,9
31,102,926,3,1,2
31,102,422,2,0,2
31,102,1383,19,7,12
31,102,2043,20,13,7
31,102,1573,53,25,28
31,102,770,16,8,8
31,102,1536,9,4,5
31,102,4063,388,190,198
31,102,3211,195,105,90
31,102,1382,31,12,19
31,102,1495,31,17,14
31,102,1799,32,17,15
31,102,3424,39,25,14
31,102,3488,38,19,19
31,102,5247,33,17,16
31,102,3384,262,130,132
31,102,1164,2,1,1
31,102,2097,27,14,13
31,102,1057,18,3,15
31,102,1519,1,0,1
31,102,2030,136,72,64
31,102,3967,19,8,11
31,102,2849,97,51,46
31,102,1183,720,357,363
31,103,1354,238,123,115
31,103,2097,231,117,114
31,104,1456,44,23,21
31,104,1854,75,35,40
31,104,1901,26,13,13
31,104,935,21,8,13
31,104,991,1,1,0
31,104,296,2,0,2
31,104,1097,5,3,2
31,104,2698,1,1,0
31,104,1862,37,18,19
31,104,478,0,0,0
31,104,2739,299,134,165
31,105,3258,107,52,55
31,106,983,129,65,64
31,106,904,23,12,11
31,106,338,5,2,3
31,50,1593,122,64,58
31,50,1242,56,31,25
31,50,1357,52,31,21
31,50,1773,17,10,7
31,50,1052,36,21,15
31,50,1164,103,56,47
31,50,1165,34,17,17
31,50,1088,38,21,17
31,50,968,15,8,7
31,50,893,57,28,29
31,50,1319,62,35,27
31,50,1233,70,44,26
31,50,1110,50,25,25
31,50,1099,35,19,16
31,50,1294,31,15,16
31,50,1075,12,8,4
31,50,1133,38,19,19
31,50,1125,19,7,12
31,50,1588,22,14,8
31,50,1032,51,29,22
31,50,1211,2,2,0
31,50,1436,27,12,15
31,50,2377,55,25,30
31,50,1876,8,4,4
31,50,697,30,11,19
31,50,736,13,4,9
31,50,948,4,3,1
31,50,767,4,2,2
31,50,1313,9,4,5
31,50,898,6,1,5
31,50,868,9,3,6
31,50,1430,6,1,5
31,50,815,52,28,24
31,50,1053,7,5,2
31,50,611,20,12,8
31,50,1151,10,6,4
31,50,934,25,13,12
31,50,806,25,10,15
31,50,971,9,4,5
31,50,932,45,22,23
31,50,956,38,18,20
31,50,1375,8,5,3
31,50,1005,62,34,28
31,50,1284,67,37,30
31,50,1306,5,1,4
31,50,326,4,4,0
31,50,1013,31,15,16
31,50,2066,663,329,334
31,50,9295,233,129,104
31,50,4107,184,94,90
31,50,10004,237,113,124
31,50,1179,87,43,44
31,50,3843,34,18,16
31,50,1960,79,40,39
31,50,12616,419,218,201
31,50,1880,26,15,11
31,50,1950,33,16,17
31,50,2628,99,47,52
31,50,2490,171,73,98
31,50,2099,46,27,19
31,50,1781,71,37,34
31,50,2777,60,26,34
31,50,3217,97,47,50
31,50,2746,183,96,87
31,50,4295,309,162,147
31,50,5456,240,132,108
31,50,2140,127,68,59
31,50,2986,228,122,106
31,50,2985,74,35,39
31,50,2199,274,136,138
31,50,1958,82,39,43
31,41,5,0,0,0
31,50,16,0,0,0
31,50,1290,12,5,7
32,1,534,2,2,0
32,1,641,2,2,0
32,1,1045,2,1,1
32,1,481,0,0,0
32,1,376,0,0,0
32,1,723,1,0,1
32,1,241,0,0,0
32,1,842,1,1,0
32,1,234,0,0,0
32,1,476,1,1,0
32,1,664,0,0,0
32,2,722,11,5,6
32,2,993,2,0,2
32,2,129,0,0,0
32,2,1468,21,9,12
32,2,646,11,5,6
32,2,357,1,0,1
32,2,540,4,3,1
32,2,90,0,0,0
32,3,920,0,0,0
32,3,297,0,0,0
32,3,421,1,1,0
32,3,261,0,0,0
32,3,151,0,0,0
32,3,95,1,1,0
32,3,61,0,0,0
32,3,71,1,1,0
32,4,456,0,0,0
32,4,725,0,0,0
32,4,559,0,0,0
32,4,639,0,0,0
32,4,715,0,0,0
32,4,456,0,0,0
32,4,277,4,2,2
32,4,459,2,0,2
32,4,212,1,0,1
32,5,5992,43,14,29
32,5,2837,32,20,12
32,5,812,4,1,3
32,5,1085,35,9,26
32,5,2145,37,15,22
32,5,1345,177,89,88
32,5,836,12,7,5
32,5,889,5,4,1
32,5,7258,93,39,54
32,5,650,7,3,4
32,5,1187,102,53,49
32,5,890,21,8,13
32,5,702,3,3,0
32,5,3038,25,11,14
32,5,6529,24,4,20
32,5,2371,4,3,1
32,5,2582,21,10,11
32,5,2222,5,4,1
32,5,1708,0,0,0
32,5,562,0,0,0
32,5,120,0,0,0
32,6,1319,12,6,6
32,6,739,6,1,5
32,6,814,1,0,1
32,6,1398,0,0,0
32,6,429,0,0,0
32,6,1051,0,0,0
32,6,646,1,0,1
32,6,264,2,1,1
32,6,922,1,1,0
32,6,571,0,0,0
32,6,102,0,0,0
32,7,933,4,1,3
32,7,695,3,2,1
32,7,479,16,8,8
32,7,1755,19,13,6
32,7,910,1,0,1
32,7,751,0,0,0
32,7,1347,6,5,1
32,7,977,4,2,2
32,7,522,0,0,0
32,7,384,0,0,0
32,7,1070,10,2,8
32,7,4,0,0,0
32,7,199,0,0,0
32,7,173,2,0,2
32,7,81,3,1,2
32,7,238,0,0,0
32,7,296,0,0,0
32,7,112,0,0,0
32,7,293,6,4,2
32,7,165,0,0,0
32,7,326,1,0,1
32,7,141,0,0,0
32,7,365,0,0,0
32,8,1315,3,2,1
32,8,1502,7,3,4
32,8,2047,7,4,3
32,8,1194,4,3,1
32,8,1143,2,0,2
32,8,2307,0,0,0
32,8,463,3,2,1
32,8,573,0,0,0
32,8,477,0,0,0
32,8,1922,1,1,0
32,8,0,0,0,0
32,9,642,6,5,1
32,9,902,25,16,9
32,9,744,1,0,1
32,9,393,1,0,1
32,9,436,0,0,0
32,9,821,6,2,4
32,9,376,0,0,0
32,9,301,0,0,0
32,9,386,0,0,0
32,9,552,0,0,0
32,9,583,1,1,0
32,9,582,0,0,0
32,9,160,0,0,0
32,9,511,1,1,0
32,9,630,0,0,0
32,9,339,0,0,0
32,9,478,0,0,0
32,9,182,0,0,0
32,9,440,0,0,0
32,9,291,1,1,0
32,9,337,0,0,0
32,10,5439,17,9,8
32,10,4855,29,15,14
32,10,6608,73,44,29
32,10,858,1,0,1
32,10,5161,49,21,28
32,10,10506,117,51,66
32,10,1464,8,1,7
32,10,1214,10,4,6
32,10,928,2,2,0
32,10,1180,1,0,1
32,10,792,0,0,0
32,10,1348,0,0,0
32,10,1101,0,0,0
32,10,4499,20,11,9
32,10,1503,6,4,2
32,10,982,12,8,4
32,10,1136,2,1,1
32,10,920,6,5,1
32,10,543,3,2,1
32,10,2075,9,5,4
32,10,4654,72,34,38
32,10,3335,14,5,9
32,10,2921,8,4,4
32,10,455,0,0,0
32,10,648,4,3,1
32,10,395,1,1,0
32,10,574,4,3,1
32,10,851,0,0,0
32,10,5408,27,13,14
32,10,1455,7,3,4
32,10,659,0,0,0
32,10,745,5,3,2
32,10,713,59,31,28
32,10,636,1,0,1
32,10,783,12,6,6
32,10,1002,3,1,2
32,10,1393,8,3,5
32,10,743,0,0,0
32,10,1048,7,4,3
32,10,821,0,0,0
32,10,605,1,1,0
32,10,616,14,10,4
32,10,826,5,2,3
32,10,513,4,3,1
32,10,524,0,0,0
32,10,1093,7,2,5
32,10,872,3,3,0
32,10,694,0,0,0
32,10,446,1,1,0
32,10,352,0,0,0
32,10,403,0,0,0
32,10,840,2,0,2
32,10,609,0,0,0
32,10,456,0,0,0
32,10,1058,0,0,0
32,10,2747,1,1,0
32,10,885,1,0,1
32,10,840,3,0,3
32,10,2004,1,1,0
32,10,13996,41,19,22
32,10,1298,5,4,1
32,10,1445,10,5,5
32,10,917,14,6,8
32,10,570,1,0,1
32,10,515,6,5,1
32,10,727,1,1,0
32,10,450,2,0,2
32,10,453,1,0,1
32,10,666,0,0,0
32,10,791,1,1,0
32,10,629,5,5,0
32,10,727,1,0,1
32,10,816,1,1,0
32,10,726,0,0,0
32,10,795,2,0,2
32,10,5928,139,69,70
32,10,1001,1,1,0
32,10,4056,33,12,21
32,10,5677,25,7,18
32,10,977,3,0,3
32,10,642,1,1,0
32,10,904,3,0,3
32,10,534,3,1,2
32,10,664,0,0,0
32,10,368,6,2,4
32,10,652,4,3,1
32,10,522,0,0,0
32,10,290,1,1,0
32,10,214,0,0,0
32,10,368,2,1,1
32,10,806,9,6,3
32,10,441,1,1,0
32,10,498,0,0,0
32,10,2301,5,3,2
32,10,2065,2,1,1
32,10,1169,2,1,1
32,10,1190,3,2,1
32,10,1602,29,12,17
32,10,910,8,1,7
32,10,606,1,0,1
32,10,794,1,1,0
32,10,405,1,0,1
32,10,694,2,0,2
32,10,235,12,2,10
32,10,837,3,3,0
32,10,1332,3,0,3
32,10,361,0,0,0
32,10,483,0,0,0
32,10,962,0,0,0
32,10,593,4,2,2
32,10,716,0,0,0
32,10,1256,0,0,0
32,10,311,2,1,1
32,10,505,2,1,1
32,10,2213,1,0,1
32,10,1845,0,0,0
32,10,1039,4,3,1
32,10,1285,6,2,4
32,10,773,134,59,75
32,10,311,40,18,22
32,10,160,10,5,5
32,10,772,12,3,9
32,10,454,1,0,1
32,10,240,0,0,0
32,10,368,3,2,1
32,10,856,2,0,2
32,10,519,3,2,1
32,10,167,2,0,2
32,10,340,115,53,62
32,10,822,119,55,64
32,10,1786,10,6,4
32,10,1197,4,0,4
32,10,2921,45,25,20
32,10,1382,2,0,2
32,10,613,0,0,0
32,10,1416,19,10,9
32,10,2827,30,17,13
32,10,1838,4,0,4
32,10,225,2,1,1
32,10,1450,5,1,4
32,10,591,2,1,1
32,10,2119,17,7,10
32,10,1381,1,1,0
32,10,656,3,0,3
32,10,1158,2,0,2
32,10,546,11,6,5
32,10,571,1,1,0
32,10,1432,2,1,1
32,10,530,1,1,0
32,10,909,2,1,1
32,10,228,1,1,0
32,10,107,0,0,0
32,10,299,4,2,2
32,10,561,0,0,0
32,10,1740,2,0,2
32,10,637,158,74,84
32,10,2449,20,10,10
32,10,902,3,2,1
32,10,822,10,6,4
32,10,726,2,2,0
32,10,336,0,0,0
32,10,507,0,0,0
32,10,555,1,0,1
32,10,421,0,0,0
32,10,1879,90,42,48
32,10,367,1,0,1
32,10,1530,25,15,10
32,10,1812,2,2,0
32,10,682,0,0,0
32,10,410,1,0,1
32,10,611,1,1,0
32,10,401,12,9,3
32,10,348,2,1,1
32,10,891,4,1,3
32,10,775,24,11,13
32,10,592,5,3,2
32,10,346,7,3,4
32,10,452,0,0,0
32,10,177,0,0,0
32,10,149,3,3,0
32,10,542,2,1,1
32,10,3700,14,6,8
32,10,168,0,0,0
32,10,746,2,0,2
32,10,163,1,1,0
32,10,363,0,0,0
32,10,527,0,0,0
32,10,223,0,0,0
32,10,151,0,0,0
32,10,489,1,0,1
32,10,118,0,0,0
32,10,339,0,0,0
32,10,353,0,0,0
32,10,288,2,1,1
32,10,190,0,0,0
32,10,157,3,2,1
32,10,381,4,1,3
32,10,485,6,4,2
32,10,830,22,13,9
32,10,457,45,20,25
32,10,236,0,0,0
32,10,1395,17,11,6
32,10,280,2,0,2
32,10,201,3,0,3
32,10,167,0,0,0
32,11,518,5,2,3
32,11,695,0,0,0
32,11,571,2,1,1
32,11,476,6,3,3
32,11,546,0,0,0
32,11,90,0,0,0
32,11,385,0,0,0
32,11,80,0,0,0
32,12,640,0,0,0
32,12,334,0,0,0
32,12,693,3,2,1
32,12,424,0,0,0
32,12,200,0,0,0
32,12,1143,0,0,0
32,12,502,0,0,0
32,12,281,2,1,1
32,12,1187,2,1,1
32,12,795,0,0,0
32,12,763,4,3,1
32,12,202,0,0,0
32,12,254,0,0,0
32,12,304,0,0,0
32,12,236,0,0,0
32,12,661,7,6,1
32,13,1944,8,3,5
32,13,1283,2,0,2
32,13,1397,2,1,1
32,13,488,3,1,2
32,13,1183,3,1,2
32,13,193,2,0,2
32,13,164,0,0,0
32,14,1434,7,5,2
32,14,1043,8,5,3
32,14,718,7,1,6
32,14,1099,3,3,0
32,14,710,5,2,3
32,14,857,0,0,0
32,14,252,14,7,7
32,14,681,1,0,1
32,14,546,2,1,1
32,14,308,2,2,0
32,14,301,1,1,0
32,14,599,24,12,12
32,14,446,11,4,7
32,14,322,1,1,0
32,14,237,0,0,0
32,14,122,0,0,0
32,14,643,6,0,6
32,14,203,0,0,0
32,14,269,0,0,0
32,14,421,13,6,7
32,14,403,0,0,0
32,14,394,0,0,0
32,14,969,26,15,11
32,14,741,5,3,2
32,14,312,0,0,0
32,14,458,5,2,3
32,14,900,1,0,1
32,14,1023,6,3,3
32,14,791,1,0,1
32,14,403,3,2,1
32,14,138,1,1,0
32,14,107,0,0,0
32,14,143,0,0,0
32,14,301,0,0,0
32,14,123,0,0,0
32,14,285,1,0,1
32,14,143,3,2,1
32,14,203,1,1,0
32,14,174,2,0,2
32,14,555,7,2,5
32,14,252,2,1,1
32,14,159,1,1,0
32,15,716,0,0,0
32,15,256,2,1,1
32,15,388,3,1,2
32,15,104,0,0,0
32,15,115,2,1,1
32,16,1028,6,5,1
32,16,1759,0,0,0
32,16,862,0,0,0
32,16,1239,1,0,1
32,16,442,0,0,0
32,16,2317,5,2,3
32,16,1053,25,9,16
32,16,697,15,7,8
32,16,412,3,1,2
32,16,1589,5,3,2
32,16,726,0,0,0
32,16,845,5,1,4
32,16,1774,4,2,2
32,16,1126,0,0,0
32,16,743,39,22,17
32,16,888,26,15,11
32,16,1252,0,0,0
32,16,686,3,2,1
32,16,433,0,0,0
32,16,946,1,0,1
32,16,657,1,0,1
32,16,440,0,0,0
32,16,645,2,2,0
32,16,897,115,62,53
32,17,2351,12,8,4
32,17,865,3,2,1
32,17,577,5,2,3
32,17,3198,38,14,24
32,17,1944,13,4,9
32,17,1863,0,0,0
32,17,1735,1,1,0
32,17,2602,133,67,66
32,17,2850,22,9,13
32,17,2489,5,3,2
32,17,27818,261,130,131
32,17,3209,8,3,5
32,17,1617,22,12,10
32,17,899,8,4,4
32,17,1054,34,21,13
32,17,969,10,7,3
32,17,631,11,4,7
32,17,812,3,1,2
32,17,624,1,0,1
32,17,568,4,1,3
32,17,1003,13,5,8
32,17,751,3,1,2
32,17,462,8,5,3
32,17,668,1,0,1
32,17,516,3,2,1
32,17,740,5,3,2
32,17,899,21,12,9
32,17,689,21,10,11
32,17,510,6,2,4
32,17,862,0,0,0
32,17,779,1,0,1
32,17,4878,159,71,88
32,17,827,3,2,1
32,17,977,4,1,3
32,17,4246,34,17,17
32,17,842,41,23,18
32,17,957,59,33,26
32,17,462,3,1,2
32,17,713,18,14,4
32,17,824,2,0,2
32,17,2608,36,20,16
32,17,1392,36,14,22
32,17,1271,2,0,2
32,17,761,0,0,0
32,17,1206,0,0,0
32,17,564,0,0,0
32,17,1123,1,0,1
32,17,12412,199,112,87
32,17,1107,15,10,5
32,17,1593,4,1,3
32,17,4572,21,14,7
32,17,635,0,0,0
32,17,1039,4,1,3
32,17,975,0,0,0
32,17,1555,2,0,2
32,17,974,0,0,0
32,57,788,1,1,0
32,17,1222,0,0,0
32,17,1129,66,34,32
32,17,1611,0,0,0
32,17,2748,8,5,3
32,17,3858,3,0,3
32,17,865,0,0,0
32,17,1237,4,1,3
32,17,3112,11,6,5
32,57,774,34,15,19
32,57,1253,6,3,3
32,57,4157,5,2,3
32,57,2403,7,6,1
32,57,2582,24,13,11
32,57,2642,17,10,7
32,57,2471,4,3,1
32,57,1476,3,1,2
32,57,1730,1,0,1
32,17,1435,2,0,2
32,17,1913,48,27,21
32,17,1467,8,4,4
32,17,2207,12,6,6
32,17,3022,20,9,11
32,17,8855,48,15,33
32,17,2042,13,8,5
32,17,724,2,0,2
32,17,1507,2,2,0
32,17,2341,10,6,4
32,17,519,1,0,1
32,17,385,0,0,0
32,17,464,0,0,0
32,57,179,0,0,0
32,17,16606,171,87,84
32,17,5739,107,58,49
32,18,969,44,22,22
32,18,236,1,1,0
32,18,753,10,5,5
32,18,344,0,0,0
32,18,150,0,0,0
32,18,377,0,0,0
32,18,331,5,1,4
32,18,380,8,5,3
32,18,254,1,1,0
32,18,278,1,1,0
32,18,98,1,0,1
32,18,259,46,20,26
32,18,121,0,0,0
32,19,2157,35,17,18
32,19,1331,29,14,15
32,19,972,0,0,0
32,19,1731,0,0,0
32,19,734,1,0,1
32,19,638,3,1,2
32,19,1527,14,8,6
32,19,2441,16,10,6
32,19,676,1,1,0
32,19,543,2,1,1
32,19,449,2,1,1
32,19,367,1,1,0
32,19,741,2,1,1
32,19,778,1,0,1
32,19,1065,1,0,1
32,19,428,0,0,0
32,19,350,0,0,0
32,19,755,15,9,6
32,19,191,2,1,1
32,19,564,5,3,2
32,19,602,4,1,3
32,19,284,0,0,0
32,19,452,1,1,0
32,19,286,1,1,0
32,19,405,11,3,8
32,19,431,6,3,3
32,19,205,1,0,1
32,19,462,0,0,0
32,19,23,0,0,0
32,19,1785,2,1,1
32,19,105,0,0,0
32,19,388,0,0,0
32,19,102,0,0,0
32,19,119,2,1,1
32,19,917,2,0,2
32,19,267,0,0,0
32,20,5061,11,6,5
32,20,694,4,2,2
32,20,1866,2,2,0
32,20,2558,22,11,11
32,20,1001,10,5,5
32,20,1471,5,3,2
32,20,996,1,1,0
32,20,720,0,0,0
32,20,517,1,1,0
32,20,645,1,1,0
32,20,691,2,1,1
32,20,3588,21,8,13
32,20,629,1,1,0
32,20,611,4,2,2
32,20,275,3,1,2
32,20,268,6,5,1
32,20,499,1,0,1
32,20,406,1,0,1
32,20,612,0,0,0
32,20,528,0,0,0
32,20,724,0,0,0
32,20,1431,7,4,3
32,20,2184,12,7,5
32,20,1096,18,8,10
32,20,829,1,0,1
32,20,563,2,2,0
32,20,550,0,0,0
32,20,539,2,2,0
32,20,296,7,4,3
32,20,529,5,3,2
32,20,452,15,7,8
32,20,510,2,1,1
32,20,648,9,5,4
32,20,744,38,18,20
32,20,788,13,7,6
32,20,450,1,1,0
32,20,694,5,1,4
32,20,1532,14,9,5
32,20,690,2,2,0
32,20,1199,31,18,13
32,20,709,4,2,2
32,20,1330,0,0,0
32,20,2295,8,4,4
32,20,1159,2,1,1
32,20,838,0,0,0
32,20,628,4,3,1
32,20,708,3,1,2
32,20,488,0,0,0
32,20,654,0,0,0
32,20,228,0,0,0
32,20,389,0,0,0
32,20,531,3,0,3
32,20,92,0,0,0
32,20,226,1,0,1
32,20,221,0,0,0
32,20,179,0,0,0
32,20,299,0,0,0
32,20,171,0,0,0
32,20,146,0,0,0
32,20,175,0,0,0
32,20,160,0,0,0
32,20,98,1,1,0
32,20,204,0,0,0
32,20,254,2,0,2
32,20,409,0,0,0
32,20,346,0,0,0
32,20,200,0,0,0
32,20,115,0,0,0
32,20,362,0,0,0
32,20,146,0,0,0
32,20,277,0,0,0
32,20,111,0,0,0
32,20,370,0,0,0
32,20,495,0,0,0
32,20,106,0,0,0
32,20,451,2,0,2
32,20,153,2,0,2
32,20,178,0,0,0
32,20,257,0,0,0
32,20,231,0,0,0
32,20,205,4,2,2
32,20,260,6,3,3
32,20,78,4,3,1
32,20,296,2,1,1
32,20,271,0,0,0
32,20,250,1,0,1
32,20,515,0,0,0
32,20,124,0,0,0
32,20,75,0,0,0
32,20,207,0,0,0
32,20,386,1,0,1
32,20,254,0,0,0
32,20,199,0,0,0
32,20,60,0,0,0
32,20,188,0,0,0
32,21,764,0,0,0
32,21,413,1,0,1
32,21,714,0,0,0
32,21,496,0,0,0
32,21,157,0,0,0
32,21,533,0,0,0
32,21,197,0,0,0
32,21,281,6,3,3
32,21,643,0,0,0
32,21,298,0,0,0
32,22,2310,10,5,5
32,22,1328,24,15,9
32,22,1071,5,2,3
32,22,1390,9,4,5
32,22,751,2,1,1
32,22,663,8,5,3
32,22,799,4,1,3
32,22,1146,5,2,3
32,22,757,19,14,5
32,22,1319,1,0,1
32,22,1023,0,0,0
32,22,613,1,1,0
32,22,790,5,4,1
32,22,1143,3,1,2
32,22,364,1,1,0
32,22,839,2,0,2
32,22,386,8,2,6
32,22,405,157,79,78
32,22,613,0,0,0
32,22,643,0,0,0
32,22,219,0,0,0
32,22,894,0,0,0
32,22,340,109,61,48
32,23,1680,1,1,0
32,23,822,0,0,0
32,23,725,2,1,1
32,23,695,0,0,0
32,23,518,4,1,3
32,23,862,4,3,1
32,23,562,4,2,2
32,23,1140,2,0,2
32,23,807,1,0,1
32,23,637,0,0,0
32,23,1001,0,0,0
32,23,876,2,0,2
32,23,124,0,0,0
32,23,310,0,0,0
32,23,763,3,2,1
32,23,145,0,0,0
32,23,311,1,0,1
32,23,99,0,0,0
32,23,174,0,0,0
32,24,3021,965,484,481
32,24,3118,125,63,62
32,24,1199,31,16,15
32,24,1230,123,65,58
32,24,787,2,1,1
32,24,3272,163,88,75
32,24,3624,45,21,24
32,24,1257,37,22,15
32,24,853,0,0,0
32,24,809,2,0,2
32,24,5070,111,62,49
32,24,854,12,5,7
32,24,1209,22,12,10
32,24,1167,22,10,12
32,24,1237,1,0,1
32,24,1165,1,1,0
32,24,1849,22,14,8
32,24,2019,1,0,1
32,24,2673,65,29,36
32,24,2377,3,2,1
32,24,854,0,0,0
32,24,506,0,0,0
32,24,759,2,2,0
32,24,2171,5,3,2
32,24,1582,1,1,0
32,24,1638,4,2,2
32,24,1375,0,0,0
32,24,1274,5,2,3
32,24,1546,1,0,1
32,24,2876,418,224,194
32,24,441,0,0,0
32,25,1087,3,1,2
32,25,1892,139,68,71
32,25,467,1,0,1
32,25,952,44,27,17
32,25,2633,6,2,4
32,25,554,1,0,1
32,25,1185,4,2,2
32,25,103,1,1,0
32,25,762,0,0,0
32,25,830,1,1,0
32,25,611,0,0,0
32,25,1615,4,2,2
32,25,494,0,0,0
32,26,1451,0,0,0
32,26,296,0,0,0
32,26,546,6,3,3
32,26,619,0,0,0
32,26,178,0,0,0
32,26,297,1,1,0
32,26,259,0,0,0
32,26,274,1,0,1
32,26,512,1,0,1
32,26,675,5,3,2
32,26,353,0,0,0
32,26,1282,19,10,9
32,26,495,12,6,6
32,26,817,10,3,7
32,26,369,0,0,0
32,26,195,0,0,0
32,26,325,0,0,0
32,26,499,4,1,3
32,26,514,2,0,2
32,26,313,0,0,0
32,26,464,0,0,0
32,26,290,0,0,0
32,26,178,1,0,1
32,26,233,1,0,1
32,26,186,0,0,0
32,26,191,0,0,0
32,26,289,1,0,1
32,26,180,0,0,0
32,26,1119,5,2,3
32,26,157,0,0,0
32,26,153,152,80,72
32,26,221,125,56,69
32,26,280,4,1,3
32,26,178,0,0,0
32,26,135,0,0,0
32,26,202,0,0,0
32,26,204,0,0,0
32,26,633,1,1,0
32,26,330,0,0,0
32,26,116,0,0,0
32,26,134,0,0,0
32,26,321,1,0,1
32,26,175,0,0,0
32,26,159,4,2,2
32,26,169,0,0,0
32,26,220,0,0,0
32,26,99,0,0,0
32,26,107,0,0,0
32,26,281,0,0,0
32,27,1036,0,0,0
32,27,568,0,0,0
32,27,161,0,0,0
32,27,374,1,1,0
32,27,306,0,0,0
32,27,170,0,0,0
32,27,121,0,0,0
32,28,629,10,5,5
32,28,977,43,24,19
32,28,235,3,1,2
32,28,201,0,0,0
32,28,76,1,0,1
32,28,70,1,0,1
32,28,263,12,7,5
32,29,1114,42,17,25
32,29,922,19,9,10
32,29,1519,23,14,9
32,29,527,2,2,0
32,29,614,7,5,2
32,29,721,13,7,6
32,29,2153,107,53,54
32,29,1195,15,10,5
32,29,682,8,2,6
32,29,636,2,1,1
32,29,1483,1,0,1
32,29,2049,13,9,4
32,29,1234,0,0,0
32,29,417,2,1,1
32,29,506,1,0,1
32,29,622,0,0,0
32,29,1120,3,1,2
32,29,627,2,1,1
32,29,158,0,0,0
32,29,4608,11,6,5
32,29,718,0,0,0
32,30,431,0,0,0
32,30,419,0,0,0
32,30,1061,0,0,0
32,30,194,0,0,0
32,30,197,0,0,0
32,30,144,0,0,0
32,31,846,2,1,1
32,31,729,4,2,2
32,31,1663,16,9,7
32,31,390,7,4,3
32,31,834,3,2,1
32,31,357,0,0,0
32,31,200,1,0,1
32,31,406,0,0,0
32,31,144,0,0,0
32,31,109,0,0,0
32,31,217,2,1,1
32,31,494,2,1,1
32,31,598,4,1,3
32,31,196,0,0,0
32,31,224,7,4,3
32,31,367,1,0,1
32,31,102,0,0,0
32,31,231,2,0,2
32,31,132,0,0,0
32,31,229,5,4,1
32,31,214,2,1,1
32,32,1339,3,3,0
32,32,1229,4,3,1
32,32,1909,7,4,3
32,32,1636,1,1,0
32,32,1484,10,4,6
32,32,308,5,2,3
32,32,1255,2,0,2
32,32,2659,7,3,4
32,32,1390,3,2,1
32,33,683,1,1,0
32,33,650,0,0,0
32,33,516,1,1,0
32,33,624,3,1,2
32,33,554,2,1,1
32,33,116,0,0,0
32,33,312,0,0,0
32,33,352,0,0,0
32,33,313,0,0,0
32,33,412,0,0,0
32,34,2413,9,5,4
32,34,1672,8,4,4
32,34,976,0,0,0
32,34,1290,3,2,1
32,34,3055,2,2,0
32,34,594,0,0,0
32,34,663,3,2,1
32,34,583,1,0,1
32,34,1612,2,1,1
32,34,1187,4,2,2
32,34,527,1,0,1
32,34,641,7,2,5
32,34,907,1,0,1
32,34,2311,0,0,0
32,34,1123,4,3,1
32,34,333,0,0,0
32,34,137,2,1,1
32,34,960,0,0,0
32,34,680,0,0,0
32,34,117,0,0,0
32,34,85,0,0,0
32,34,210,1,1,0
32,34,62,0,0,0
32,34,245,0,0,0
32,34,140,1,1,0
32,34,418,6,4,2
32,34,409,0,0,0
32,34,463,0,0,0
32,34,187,0,0,0
32,34,532,25,2,23
32,34,308,1,0,1
32,34,303,0,0,0
32,34,732,0,0,0
32,34,629,2,1,1
32,34,133,0,0,0
32,34,174,4,2,2
32,34,220,1,1,0
32,34,84,0,0,0
32,34,143,0,0,0
32,34,27,0,0,0
32,34,73,0,0,0
32,34,111,0,0,0
32,34,263,0,0,0
32,34,233,0,0,0
32,35,929,0,0,0
32,35,873,1,1,0
32,35,1045,3,2,1
32,35,758,0,0,0
32,35,1193,0,0,0
32,35,1411,1,1,0
32,35,1398,2,1,1
32,35,457,0,0,0
32,35,1494,0,0,0
32,35,776,0,0,0
32,35,1567,3,2,1
32,35,1236,2,0,2
32,35,1043,2,0,2
32,35,1281,1,1,0
32,35,569,0,0,0
32,35,241,22,14,8
32,36,3082,60,31,29
32,36,1410,4,2,2
32,36,1816,13,5,8
32,36,476,6,3,3
32,36,484,2,0,2
32,36,4106,34,14,20
32,36,1459,7,3,4
32,36,1731,5,3,2
32,36,831,14,5,9
32,36,853,3,3,0
32,36,1091,10,3,7
32,36,2308,2,1,1
32,36,1110,0,0,0
32,36,1725,5,3,2
32,36,721,0,0,0
32,36,1795,22,9,13
32,36,505,10,4,6
32,36,430,0,0,0
32,36,1181,52,30,22
32,36,553,1,0,1
32,36,1552,1,0,1
32,36,2029,1,0,1
32,36,1044,10,6,4
32,36,661,17,11,6
32,36,1086,8,3,5
32,36,224,3,0,3
32,36,289,2,1,1
32,36,730,2,0,2
32,36,803,0,0,0
32,36,414,0,0,0
32,36,1512,4,2,2
32,36,1616,15,8,7
32,36,590,0,0,0
32,36,543,1,0,1
32,36,602,37,15,22
32,36,332,1,1,0
32,36,351,1,1,0
32,36,844,0,0,0
32,36,262,0,0,0
32,36,565,0,0,0
32,36,284,0,0,0
32,36,287,2,2,0
32,37,1286,1,1,0
32,37,958,3,1,2
32,37,1637,24,11,13
32,37,244,0,0,0
32,37,1188,0,0,0
32,37,425,3,2,1
32,37,2637,26,15,11
32,37,1607,12,7,5
32,37,1180,7,3,4
32,37,2269,1,1,0
32,37,1393,1,0,1
32,37,1273,0,0,0
32,37,544,0,0,0
32,37,672,0,0,0
32,38,1414,1,0,1
32,38,1227,0,0,0
32,38,1111,5,3,2
32,38,3252,9,4,5
32,38,431,6,5,1
32,38,924,0,0,0
32,38,959,3,1,2
32,38,560,7,4,3
32,38,305,0,0,0
32,38,291,0,0,0
32,38,397,0,0,0
32,38,324,0,0,0
32,38,1690,2,2,0
32,38,704,0,0,0
32,38,1005,2,1,1
32,38,1674,11,5,6
32,38,949,1,1,0
32,38,1842,1,1,0
32,38,604,0,0,0
32,38,928,0,0,0
32,38,839,0,0,0
32,38,1913,2,2,0
32,38,1117,0,0,0
32,38,693,0,0,0
32,38,1024,6,2,4
32,38,1624,0,0,0
32,38,1373,3,2,1
32,38,1707,0,0,0
32,38,312,1,1,0
32,38,1174,0,0,0
32,38,839,4,2,2
32,38,698,2,2,0
32,38,292,0,0,0
32,38,2110,0,0,0
32,38,596,0,0,0
32,38,785,9,5,4
32,38,845,0,0,0
32,38,1096,1,0,1
32,38,331,0,0,0
32,38,353,0,0,0
32,38,1246,8,4,4
32,38,711,1,1,0
32,38,628,2,0,2
32,38,842,3,2,1
32,38,2297,10,7,3
32,38,914,1,0,1
32,38,337,0,0,0
32,38,145,0,0,0
32,38,662,2,1,1
32,38,660,0,0,0
32,38,843,0,0,0
32,38,504,0,0,0
32,38,374,1,1,0
32,38,584,3,0,3
32,38,767,2,2,0
32,38,568,0,0,0
32,38,862,3,1,2
32,38,754,0,0,0
32,38,754,1,0,1
32,38,618,0,0,0
32,38,477,2,1,1
32,38,932,7,3,4
32,38,293,0,0,0
32,38,364,2,0,2
32,38,720,0,0,0
32,38,932,0,0,0
32,38,487,1,0,1
32,38,564,0,0,0
32,38,364,0,0,0
32,38,311,0,0,0
32,38,1129,1,1,0
32,38,570,3,1,2
32,38,254,0,0,0
32,38,164,0,0,0
32,38,888,1,0,1
32,38,204,0,0,0
32,38,522,0,0,0
32,38,455,0,0,0
32,38,708,2,1,1
32,38,491,0,0,0
32,38,349,2,0,2
32,38,384,0,0,0
32,38,381,1,0,1
32,38,451,0,0,0
32,38,503,0,0,0
32,38,382,0,0,0
32,38,349,1,0,1
32,38,458,0,0,0
32,38,327,0,0,0
32,38,345,1,1,0
32,38,428,2,1,1
32,38,357,0,0,0
32,38,211,0,0,0
32,38,648,0,0,0
32,38,352,3,2,1
32,39,1224,27,9,18
32,39,912,4,3,1
32,39,871,5,3,2
32,39,1081,9,4,5
32,39,892,2,1,1
32,39,494,0,0,0
32,39,865,19,12,7
32,39,670,5,3,2
32,39,1936,15,6,9
32,39,501,0,0,0
32,39,2334,28,11,17
32,39,2264,6,3,3
32,39,1688,18,6,12
32,39,1068,2,1,1
32,39,571,1,0,1
32,39,613,13,6,7
32,39,378,1,1,0
32,39,782,42,8,34
32,39,811,7,4,3
32,39,868,1,1,0
32,39,1365,8,4,4
32,39,991,2,2,0
32,39,1654,17,11,6
32,39,1476,4,1,3
32,39,620,2,1,1
32,39,917,1,1,0
32,39,594,1,1,0
32,39,790,2,0,2
32,39,781,0,0,0
32,39,688,1,0,1
32,39,576,0,0,0
32,39,533,0,0,0
32,39,714,6,2,4
32,39,2048,7,3,4
32,39,1041,0,0,0
32,39,720,0,0,0
32,39,990,7,5,2
32,39,754,8,4,4
32,39,1169,0,0,0
32,39,1306,29,16,13
32,39,1863,7,4,3
32,39,652,13,7,6
32,39,1575,9,5,4
32,39,894,1,0,1
32,39,1258,3,2,1
32,39,531,2,2,0
32,39,845,5,2,3
32,39,570,1,0,1
32,39,921,27,11,16
32,39,896,1,0,1
32,39,327,0,0,0
32,39,376,0,0,0
32,39,466,1,1,0
32,39,650,0,0,0
32,39,380,0,0,0
32,39,741,5,3,2
32,39,873,0,0,0
32,39,1053,1,0,1
32,39,328,4,2,2
32,39,1101,29,10,19
32,39,406,6,3,3
32,39,500,0,0,0
32,40,1813,4,2,2
32,40,1195,3,2,1
32,40,795,0,0,0
32,40,714,0,0,0
32,40,912,2,0,2
32,40,813,2,1,1
32,40,542,0,0,0
32,40,337,1,0,1
32,40,1071,1,0,1
32,40,812,9,6,3
32,40,1062,2,1,1
32,40,536,0,0,0
32,40,1003,1,0,1
32,40,1086,2,0,2
32,40,1198,0,0,0
32,40,598,1,1,0
32,40,255,1,1,0
32,40,880,2,1,1
32,40,1108,34,17,17
32,40,447,0,0,0
32,40,426,1,1,0
32,40,663,1,0,1
32,40,1585,4,1,3
32,40,777,1,0,1
32,40,400,0,0,0
32,40,573,1,0,1
32,40,245,0,0,0
32,41,511,0,0,0
32,41,487,0,0,0
32,41,149,0,0,0
32,41,795,0,0,0
32,41,435,0,0,0
32,41,132,0,0,0
32,42,1743,13,9,4
32,42,4639,15,7,8
32,42,1930,11,4,7
32,42,1358,7,4,3
32,42,975,10,4,6
32,42,580,3,1,2
32,42,1064,2,1,1
32,42,1352,1,0,1
32,42,975,1,0,1
32,42,758,6,4,2
32,42,647,1,0,1
32,42,774,0,0,0
32,42,1016,0,0,0
32,42,1244,4,2,2
32,42,1145,0,0,0
32,42,1712,3,2,1
32,42,2229,4,1,3
32,42,1020,2,0,2
32,42,466,1,0,1
32,42,540,0,0,0
32,42,1264,1,1,0
32,42,788,5,3,2
32,42,546,3,2,1
32,42,664,0,0,0
32,42,907,0,0,0
32,42,964,6,4,2
32,42,1175,4,2,2
32,42,989,3,2,1
32,42,527,1,1,0
32,42,566,2,2,0
32,42,775,0,0,0
32,42,254,9,3,6
32,42,714,0,0,0
32,42,1676,5,2,3
32,42,1073,17,10,7
32,42,414,0,0,0
32,42,970,5,5,0
32,42,955,1,0,1
32,42,505,0,0,0
32,42,435,2,1,1
32,42,803,1,1,0
32,42,232,0,0,0
32,42,924,0,0,0
32,42,196,0,0,0
32,42,386,220,109,111
32,42,601,126,60,66
32,42,503,2,0,2
32,42,223,0,0,0
32,42,337,1,1,0
32,42,1234,3,2,1
32,42,661,0,0,0
32,42,514,1,1,0
32,42,542,0,0,0
32,42,593,0,0,0
32,42,495,8,5,3
32,42,701,2,1,1
32,42,827,1,1,0
32,42,466,0,0,0
32,42,125,1,1,0
32,42,331,0,0,0
32,42,521,1,1,0
32,42,255,7,5,2
32,42,379,79,40,39
32,42,454,2,0,2
32,42,132,0,0,0
32,42,220,0,0,0
32,42,522,0,0,0
32,42,214,1,1,0
32,42,452,1,1,0
32,42,164,1,0,1
32,42,278,1,0,1
32,42,347,1,1,0
32,42,565,0,0,0
32,42,915,4,2,2
32,42,293,0,0,0
32,42,384,0,0,0
32,42,651,0,0,0
32,42,324,1,0,1
32,42,706,1,1,0
32,42,194,0,0,0
32,42,354,5,1,4
32,42,310,0,0,0
32,42,197,0,0,0
32,42,368,0,0,0
32,42,470,1,0,1
32,42,274,0,0,0
32,42,155,0,0,0
32,42,94,0,0,0
32,42,265,0,0,0
32,42,177,0,0,0
32,43,442,0,0,0
32,43,504,2,2,0
32,43,117,0,0,0
32,43,302,0,0,0
32,44,263,7,5,2
32,44,1954,3,3,0
32,44,925,2,1,1
32,44,729,10,5,5
32,44,2406,51,24,27
32,44,1309,4,2,2
32,44,560,1,1,0
32,44,347,2,1,1
32,44,2429,17,9,8
32,44,1054,12,7,5
32,44,360,0,0,0
32,44,378,0,0,0
32,44,562,5,3,2
32,44,800,0,0,0
32,44,697,3,1,2
32,44,488,1,0,1
32,44,232,0,0,0
32,44,300,0,0,0
32,44,60,0,0,0
32,44,242,0,0,0
32,44,173,0,0,0
32,44,325,1,1,0
32,45,527,1,1,0
32,45,424,0,0,0
32,45,578,1,1,0
32,45,440,4,2,2
32,45,715,1,0,1
32,45,609,4,1,3
32,45,446,0,0,0
32,45,329,2,2,0
32,45,556,8,6,2
32,45,107,3,2,1
32,45,233,0,0,0
32,45,1564,1,1,0
32,45,139,0,0,0
32,45,186,0,0,0
32,45,93,0,0,0
32,45,121,0,0,0
32,45,785,3,3,0
32,45,183,3,2,1
32,45,288,0,0,0
32,46,516,16,7,9
32,46,328,10,6,4
32,46,694,11,7,4
32,46,142,0,0,0
32,46,124,0,0,0
32,46,186,1,1,0
32,46,254,0,0,0
32,46,126,1,0,1
32,46,609,0,0,0
32,46,495,0,0,0
32,46,202,1,1,0
32,46,203,0,0,0
32,46,205,9,6,3
32,46,274,1,0,1
32,46,489,1,0,1
32,46,327,1,0,1
32,46,198,2,1,1
32,46,385,2,0,2
32,46,76,0,0,0
32,46,69,1,0,1
32,46,199,2,0,2
32,46,60,0,0,0
32,46,120,0,0,0
32,46,209,0,0,0
32,47,1054,0,0,0
32,47,533,0,0,0
32,47,950,2,0,2
32,47,992,5,1,4
32,58,1003,3,2,1
32,58,442,2,2,0
32,58,571,3,0,3
32,58,143,0,0,0
32,58,136,1,0,1
32,47,218,0,0,0
32,47,201,0,0,0
32,47,386,1,0,1
32,47,208,0,0,0
32,47,269,0,0,0
32,47,365,0,0,0
32,58,284,0,0,0
32,58,186,0,0,0
32,47,176,0,0,0
32,48,1524,14,4,10
32,48,2402,12,6,6
32,48,872,1,0,1
32,48,170,0,0,0
32,48,950,3,2,1
32,48,618,3,0,3
32,48,531,2,0,2
32,48,776,1,0,1
32,48,1154,0,0,0
32,48,606,8,7,1
32,48,1008,3,0,3
32,48,600,1,1,0
32,48,1980,88,46,42
32,48,3752,36,19,17
32,48,1682,5,2,3
32,48,32,0,0,0
32,48,304,0,0,0
32,48,545,1,0,1
32,48,228,0,0,0
32,48,263,0,0,0
32,48,205,1,0,1
32,48,309,0,0,0
32,48,533,2,1,1
32,48,916,10,3,7
32,48,95,0,0,0
32,48,654,1,0,1
32,48,1034,7,2,5
32,48,215,0,0,0
32,48,172,1,0,1
32,48,540,0,0,0
32,48,143,0,0,0
32,48,96,0,0,0
32,48,254,0,0,0
32,48,103,1,0,1
32,48,160,1,1,0
32,48,231,0,0,0
32,48,274,0,0,0
32,48,1169,1,0,1
32,48,202,1,1,0
32,49,860,2,1,1
32,49,1209,2,2,0
32,49,1349,6,2,4
32,49,804,7,6,1
32,49,433,16,8,8
32,49,438,46,27,19
32,49,1554,9,5,4
32,49,664,44,27,17
32,49,678,15,8,7
32,49,864,0,0,0
32,49,2865,36,22,14
32,49,539,3,3,0
32,49,262,0,0,0
32,49,1537,2,0,2
32,49,513,0,0,0
32,49,245,0,0,0
32,49,383,8,5,3
32,49,120,0,0,0
32,49,383,0,0,0
32,49,234,0,0,0
32,49,277,3,1,2
32,49,278,1,1,0
32,49,181,2,2,0
32,49,465,0,0,0
32,49,163,0,0,0
32,49,742,3,1,2
32,49,256,0,0,0
32,49,262,3,2,1
32,49,67,0,0,0
32,49,391,12,4,8
32,49,277,4,2,2
32,49,254,0,0,0
32,49,848,1,0,1
32,49,441,4,2,2
32,49,569,0,0,0
32,49,479,0,0,0
32,49,872,0,0,0
32,49,1427,2,0,2
32,49,171,0,0,0
32,49,156,3,1,2
32,49,83,0,0,0
32,49,339,0,0,0
32,49,222,1,1,0
32,49,271,2,1,1
32,49,369,0,0,0
32,49,177,1,1,0
32,49,272,0,0,0
32,49,266,0,0,0
32,49,734,1,0,1
32,49,167,0,0,0
32,49,350,0,0,0
32,49,91,0,0,0
32,49,399,1,1,0
32,49,423,0,0,0
32,49,1103,4,2,2
32,49,222,0,0,0
32,49,264,4,0,4
32,49,248,1,1,0
32,49,297,0,0,0
32,49,345,0,0,0
32,49,182,0,0,0
32,49,93,0,0,0
32,49,277,0,0,0
32,49,114,0,0,0
32,49,167,1,0,1
32,49,143,0,0,0
32,49,328,0,0,0
32,50,1267,3,2,1
32,50,1792,14,8,6
32,50,1399,17,10,7
32,50,1471,5,2,3
32,50,346,0,0,0
32,50,1391,10,5,5
32,50,2107,10,4,6
32,50,1585,3,3,0
32,51,784,3,1,2
32,51,865,6,3,3
32,51,1149,1,0,1
32,51,3228,4,0,4
32,51,1662,2,0,2
32,51,2289,4,1,3
32,51,2034,7,3,4
32,51,473,0,0,0
32,51,171,0,0,0
32,51,955,2,1,1
32,51,259,0,0,0
32,51,205,0,0,0
32,51,449,1,0,1
32,51,806,1,0,1
32,51,303,0,0,0
32,51,713,2,2,0
32,51,122,0,0,0
32,51,217,0,0,0
32,51,646,4,1,3
32,51,494,7,4,3
32,51,585,3,1,2
32,51,340,0,0,0
32,51,617,0,0,0
32,51,495,0,0,0
32,51,735,5,4,1
32,51,553,8,4,4
32,51,756,0,0,0
32,51,747,3,0,3
32,51,1272,6,2,4
32,51,1280,6,0,6
32,51,1173,2,1,1
32,51,2901,1,1,0
32,51,774,0,0,0
32,51,414,0,0,0
32,51,591,2,1,1
32,51,132,1,1,0
32,51,275,0,0,0
32,51,210,1,0,1
32,51,171,6,3,3
32,51,136,0,0,0
32,51,264,2,1,1
32,51,682,1,1,0
32,51,277,0,0,0
32,51,615,1,1,0
32,51,499,1,0,1
32,51,186,0,0,0
32,51,138,0,0,0
32,52,2002,1,1,0
32,52,1674,11,5,6
32,52,1545,5,2,3
32,52,2319,0,0,0
32,52,671,0,0,0
32,52,1001,4,1,3
32,52,1602,2,2,0
32,52,894,2,0,2
32,52,1600,8,2,6
32,52,1087,0,0,0
32,52,640,2,1,1
32,52,530,5,2,3
32,52,2060,85,31,54
32,52,346,3,2,1
32,52,1371,22,11,11
32,52,185,0,0,0
32,53,1382,1,1,0
32,53,1450,14,11,3
32,53,1328,21,10,11
32,53,1659,10,3,7
32,53,1319,19,10,9
32,53,1845,2,2,0
32,53,1066,0,0,0
32,53,551,0,0,0
32,53,729,0,0,0
32,53,750,0,0,0
32,53,438,6,4,2
32,53,681,7,4,3
32,54,1337,0,0,0
32,54,1566,1,0,1
32,54,1999,3,1,2
32,54,593,1,1,0
32,54,1478,0,0,0
32,54,426,4,1,3
32,54,492,0,0,0
32,54,920,0,0,0
32,54,623,4,2,2
32,54,820,167,80,87
32,54,754,1,0,1
32,54,857,7,5,2
32,54,1368,0,0,0
32,54,1829,16,8,8
32,54,474,2,1,1
32,54,595,0,0,0
32,54,407,1,0,1
32,54,318,0,0,0
32,54,274,1,0,1
32,54,174,0,0,0
32,54,299,0,0,0
32,54,493,1,1,0
32,54,651,0,0,0
32,54,712,9,4,5
32,55,2136,19,9,10
32,55,900,16,9,7
32,55,986,7,4,3
32,55,1739,16,4,12
32,55,543,5,2,3
32,55,1115,12,6,6
32,55,1494,15,10,5
32,55,720,3,1,2
32,55,725,0,0,0
32,55,1749,3,1,2
32,55,977,7,4,3
32,55,431,4,1,3
32,55,1555,16,11,5
32,55,1255,6,2,4
32,55,789,0,0,0
32,55,669,0,0,0
32,55,923,7,2,5
32,55,637,0,0,0
32,55,723,6,5,1
32,55,738,0,0,0
32,55,268,0,0,0
32,55,311,0,0,0
32,55,835,4,3,1
32,55,207,0,0,0
32,55,428,0,0,0
32,55,317,4,3,1
32,55,421,1,0,1
32,55,656,39,22,17
32,55,1045,1,0,1
32,55,291,1,0,1
32,55,390,0,0,0
32,55,535,1,0,1
32,55,542,0,0,0
32,55,317,1,0,1
32,55,450,0,0,0
32,55,572,1,0,1
32,55,228,10,4,6
32,55,139,0,0,0
32,55,177,1,0,1
32,55,203,5,1,4
32,55,232,0,0,0
32,55,196,0,0,0
32,55,311,0,0,0
32,55,427,0,0,0
32,55,221,1,0,1
32,55,187,0,0,0
32,55,134,0,0,0
32,55,171,1,0,1
32,55,120,0,0,0
32,55,400,0,0,0
32,55,88,0,0,0
32,56,731,3,0,3
32,56,1359,44,20,24
32,56,1444,8,1,7
32,56,992,9,3,6
32,56,748,3,2,1
32,56,590,8,2,6
32,56,1167,9,5,4
32,56,942,10,8,2
32,56,637,3,0,3
32,56,497,2,1,1
32,56,577,0,0,0
32,56,580,13,5,8
32,56,570,5,3,2
32,56,965,3,0,3
32,56,337,0,0,0
32,56,250,17,9,8
32,56,756,5,4,1
32,56,1645,10,2,8
32,56,1040,9,5,4
32,56,3115,54,28,26
32,56,1304,4,2,2
32,56,874,0,0,0
32,56,399,3,3,0
32,56,453,6,3,3
32,56,255,3,3,0
32,56,355,1,1,0
32,56,639,10,6,4
32,56,577,0,0,0
32,56,1002,8,2,6
32,56,2943,57,30,27
32,56,528,1,1,0
32,56,791,17,12,5
32,56,785,6,5,1
32,56,597,6,5,1
32,56,599,18,10,8
32,56,1514,58,32,26
32,56,465,3,2,1
32,56,1159,13,6,7
32,56,945,5,4,1
32,56,625,3,1,2
32,56,624,1,1,0
32,56,547,8,2,6
32,56,189,2,2,0
32,56,245,4,3,1
32,56,310,0,0,0
32,56,517,0,0,0
32,56,838,10,6,4
32,56,1374,79,45,34
32,56,6476,305,164,141
32,56,1283,21,9,12
32,56,1079,9,3,6
32,56,1188,3,2,1
32,56,954,3,1,2
32,56,942,1,0,1
32,56,636,7,4,3
32,56,711,5,5,0
32,56,515,1,0,1
32,56,380,7,5,2
32,56,518,2,1,1
32,56,3647,35,13,22
32,56,1532,7,1,6
32,56,811,1,1,0
32,56,1327,2,1,1
32,56,641,49,28,21
32,56,673,34,16,18
32,56,613,0,0,0
32,56,1016,3,1,2
32,56,644,5,3,2
32,56,766,4,1,3
32,56,1019,31,15,16
32,56,856,1,1,0
32,56,980,63,33,30
32,56,1132,2,1,1
32,56,904,34,19,15
32,56,888,15,8,7
32,56,2804,21,11,10
32,56,1150,12,3,9
32,56,1225,6,1,5
32,56,710,4,3,1
32,56,690,8,6,2
32,56,824,4,2,2
32,56,889,30,16,14
32,56,703,3,0,3
32,56,799,11,4,7
32,56,1072,0,0,0
32,56,1312,1,1,0
32,56,1243,6,2,4
32,56,5781,90,48,42
32,56,2356,13,5,8
32,56,689,0,0,0
32,56,1773,23,12,11
32,56,866,6,3,3
32,56,966,3,2,1
32,56,741,5,2,3
32,56,721,1,0,1
32,56,550,2,1,1
32,56,1822,7,4,3
32,56,17384,124,45,79
32,56,15225,250,132,118
32,56,454,0,0,0
32,56,768,1,0,1
32,56,979,3,3,0
32,56,4113,30,14,16
32,56,3259,22,3,19
32,56,518,0,0,0
32,56,1186,6,3,3
32,56,641,2,2,0
32,56,691,3,1,2
32,56,957,2,1,1
32,56,304,0,0,0
32,56,138,0,0,0
32,17,2138,35,20,15
32,17,1527,62,33,29
32,17,812,45,27,18
32,17,1183,17,9,8
32,17,1612,14,5,9
32,17,922,5,4,1
32,17,1681,1,1,0
32,17,954,7,1,6
32,17,1275,122,59,63
32,17,1765,94,47,47
32,17,1231,14,4,10
32,17,1277,50,21,29
32,17,863,0,0,0
32,17,1037,13,4,9
32,17,1073,48,20,28
32,17,471,7,4,3
32,17,1150,21,9,12
32,17,1180,46,24,22
32,17,965,2,0,2
32,17,607,3,2,1
32,17,835,43,23,20
32,17,1016,2,1,1
32,17,1836,170,95,75
32,17,1354,27,15,12
32,17,1027,8,4,4
32,17,1589,109,50,59
32,17,269,17,8,9
32,39,2915,26,17,9
32,39,3868,52,24,28
